CustomerKey,Recency,Frequency,Monetary,R_Score,F_Score,M_Score,RFM_Score,RFM_Segment
11000,271,8,8248.99,2,5,5,12,Loyal
11001,50,11,6383.879999999999,5,5,5,15,Champions
11002,340,4,8114.039999999999,1,4,5,10,Loyal
11003,264,9,8139.29,2,5,5,12,Loyal
11004,273,6,8196.01,2,5,5,12,Loyal
11005,272,6,8121.33,2,5,5,12,Loyal
11006,260,5,8119.03,2,5,5,12,Loyal
11007,316,8,8211.0,1,5,5,11,Loyal
11008,333,7,8106.3099999999995,1,5,5,11,Loyal
11009,265,5,8091.33,2,5,5,12,Loyal
11010,251,4,8088.039999999999,2,4,5,11,Loyal
11011,316,4,8133.039999999999,1,4,5,10,Loyal
11012,106,5,81.26,4,5,2,11,Loyal
11013,8,5,113.96000000000001,5,5,3,13,Recent Customer
11014,274,6,138.45,2,5,3,10,Loyal
11015,376,3,2500.97,1,3,4,8,Potential
11016,354,3,2332.2799999999997,1,3,4,8,Potential
11017,107,4,6434.3099999999995,4,4,5,13,Champions
11018,97,7,6533.28,4,5,5,14,Champions
11019,17,33,882.7,5,5,3,13,Recent Customer
11020,396,2,2316.97,1,1,4,6,At Risk
11021,371,3,2371.9599999999996,1,3,4,8,Potential
11022,374,2,2322.2799999999997,1,1,4,6,At Risk
11023,15,6,122.24000000000001,5,5,3,13,Recent Customer
11024,187,6,56.510000000000005,3,5,2,10,Loyal
11025,96,6,6576.799999999999,4,5,5,14,Champions
11026,106,7,6575.79,4,5,5,14,Champions
11027,97,9,6591.57,4,5,5,14,Champions
11028,114,5,6474.62,4,5,5,14,Champions
11029,79,7,6565.29,4,5,5,14,Champions
11030,81,4,6471.32,4,4,5,13,Champions
11031,77,6,6478.599999999999,4,5,5,14,Champions
11032,82,10,6525.5599999999995,4,5,5,14,Champions
11033,85,7,6495.289999999999,4,5,5,14,Champions
11034,80,4,6491.32,4,4,5,13,Champions
11035,75,5,6451.3099999999995,4,5,5,14,Champions
11036,372,2,2354.9799999999996,1,1,4,6,At Risk
11037,374,7,2374.23,1,5,4,10,Loyal
11038,78,3,6437.33,4,3,5,12,Loyal
11039,79,9,6636.58,4,5,5,14,Champions
11040,301,3,2350.9599999999996,1,3,4,8,Potential
11041,380,3,2380.47,1,3,4,8,Potential
11042,104,3,3112.3299999999995,4,3,4,11,Loyal
11043,164,3,47.980000000000004,3,3,2,8,Potential
11044,82,7,6515.299999999999,4,5,5,14,Champions
11045,92,4,114.96000000000001,4,4,3,11,Loyal
11046,78,6,6616.8099999999995,4,5,5,14,Champions
11047,71,4,6582.33,5,4,5,14,Champions
11048,35,8,6498.24,5,5,5,15,Champions
11049,92,5,81.26,4,5,2,11,Loyal
11050,71,6,5007.3,5,5,5,15,Champions
11051,28,5,123.95000000000002,5,5,3,13,Recent Customer
11052,247,7,8131.32,2,5,5,12,Loyal
11053,377,2,2329.9799999999996,1,1,4,6,At Risk
11054,244,6,8223.02,2,5,5,12,Loyal
11055,236,8,8168.009999999999,2,5,5,12,Loyal
11056,243,8,8207.5,2,5,5,12,Loyal
11057,253,4,8088.039999999999,2,4,5,11,Loyal
11058,239,6,8248.02,2,5,5,12,Loyal
11059,319,7,116.93,1,5,3,9,Potential
11060,218,6,8153.0199999999995,2,5,5,12,Loyal
11061,229,6,8129.0199999999995,2,5,5,12,Loyal
11062,387,3,2351.9599999999996,1,3,4,8,Potential
11063,382,5,2372.95,1,5,4,10,Loyal
11064,369,2,2304.9799999999996,1,1,4,6,At Risk
11065,19,5,202.57,5,5,3,13,Recent Customer
11066,132,5,81.26,4,5,2,11,Loyal
11067,17,6,105.75,5,5,3,13,Recent Customer
11068,113,9,113.36,4,5,3,12,Loyal
11069,239,3,8104.049999999999,2,3,5,10,Loyal
11070,217,10,8165.549999999999,2,5,5,12,Loyal
11071,59,7,110.23,5,5,3,13,Champions
11072,228,7,8194.0,2,5,5,12,Loyal
11073,161,10,191.9,3,5,3,11,Loyal
11074,247,7,94.19,2,5,3,10,Loyal
11075,219,5,8068.03,2,5,5,12,Loyal
11076,222,4,8159.039999999999,2,4,5,11,Loyal
11077,231,5,8169.029999999999,2,5,5,12,Loyal
11078,1,31,913.27,5,5,3,13,Recent Customer
11079,28,5,57.95,5,5,2,12,Recent Customer
11080,220,7,8204.02,2,5,5,12,Loyal
11081,291,5,104.26,1,5,3,9,Potential
11082,84,6,3110.8099999999995,4,5,4,13,Champions
11083,82,5,3137.3199999999997,4,5,4,13,Champions
11084,69,5,3078.6099999999997,5,5,4,14,Champions
11085,21,5,128.96,5,5,3,13,Recent Customer
11086,39,6,153.45,5,5,3,13,Champions
11087,173,4,200.28,3,4,3,10,Loyal
11088,78,7,3176.7799999999997,4,5,4,13,Champions
11089,72,7,3188.2799999999997,5,5,4,14,Champions
11090,69,6,6704.08,5,5,5,15,Champions
11091,21,59,1189.33,5,5,4,14,Recent Customer
11092,222,5,8110.0199999999995,2,5,5,12,Loyal
11093,235,7,8180.0,2,5,5,12,Loyal
11094,18,8,235.89,5,5,3,13,Recent Customer
11095,218,7,8158.009999999999,2,5,5,12,Loyal
11096,183,4,8063.039999999999,3,4,5,12,Loyal
11097,189,5,8099.029999999999,3,5,5,13,Champions
11098,105,4,88.96,4,4,2,10,Loyal
11099,212,9,8215.99,2,5,5,12,Loyal
11100,175,7,8172.509999999999,3,5,5,13,Champions
11101,214,7,8262.519999999999,2,5,5,12,Loyal
11102,51,5,102.91,5,5,3,13,Champions
11103,237,8,8182.5,2,5,5,12,Loyal
11104,228,6,8173.029999999999,2,5,5,12,Loyal
11105,238,5,8095.99,2,5,5,12,Loyal
11106,228,3,8079.049999999999,2,3,5,10,Loyal
11107,222,6,8171.01,2,5,5,12,Loyal
11108,220,5,8124.039999999999,2,5,5,12,Loyal
11109,219,8,8245.01,2,5,5,12,Loyal
11110,162,5,8093.03,3,5,5,13,Champions
11111,160,8,8137.0,3,5,5,13,Champions
11112,149,6,8295.02,3,5,5,13,Champions
11113,283,7,109.88,2,5,3,10,Loyal
11114,34,7,122.89,5,5,3,13,Champions
11115,27,6,113.71000000000001,5,5,3,13,Recent Customer
11116,105,7,148.7,4,5,3,12,Loyal
11117,218,8,8184.99,2,5,5,12,Loyal
11118,3,8,123.8,5,5,3,13,Recent Customer
11119,67,4,85.22,5,4,2,11,Loyal
11120,132,10,8242.49,4,5,5,14,Champions
11121,86,6,58.16,4,5,2,11,Loyal
11122,160,3,42.93,3,3,2,8,Potential
11123,4,8,149.84,5,5,3,13,Recent Customer
11124,225,6,8129.0199999999995,2,5,5,12,Loyal
11125,210,7,79.69,2,5,2,9,Potential
11126,87,8,4972.37,4,5,5,14,Champions
11127,120,3,43.980000000000004,4,3,2,9,Potential
11128,170,7,143.94,3,5,3,11,Loyal
11129,385,2,5873.26,1,1,5,7,Potential
11130,51,2,37.29,5,1,1,7,Potential
11131,6,9,165.91,5,5,3,13,Recent Customer
11132,295,6,2371.9399999999996,1,5,4,10,Loyal
11133,30,4,71.96000000000001,5,4,2,11,Recent Customer
11134,87,3,4911.83,4,3,5,12,Loyal
11135,286,3,2334.9699999999993,2,3,4,9,Potential
11136,391,3,2380.47,1,3,4,8,Potential
11137,9,5,202.57,5,5,3,13,Recent Customer
11138,29,4,78.97,5,4,2,11,Recent Customer
11139,104,3,83.97,4,3,2,9,Potential
11140,316,2,39.99,1,1,2,4,At Risk
11141,123,5,113.96000000000001,4,5,3,12,Loyal
11142,16,36,980.77,5,5,3,13,Recent Customer
11143,41,5,48.56,5,5,2,12,Loyal
11144,369,3,2399.97,1,3,4,8,Potential
11145,369,3,2309.9699999999993,1,3,4,8,Potential
11146,136,7,112.93,3,5,3,11,Loyal
11147,105,7,8195.5,4,5,5,14,Champions
11148,57,6,126.24000000000001,5,5,3,13,Champions
11149,61,4,41.26,5,4,2,11,Loyal
11150,198,8,192.42000000000002,3,5,3,11,Loyal
11151,101,6,8087.3099999999995,4,5,5,14,Champions
11152,385,1,2294.99,1,1,4,6,At Risk
11153,306,5,109.77,1,5,3,9,Potential
11154,384,1,2319.99,1,1,4,6,At Risk
11155,388,1,2319.99,1,1,4,6,At Risk
11156,386,4,2389.97,1,4,4,9,Potential
11157,140,3,41.28,3,3,2,8,Potential
11158,375,3,2395.9599999999996,1,3,4,8,Potential
11159,83,5,48.56,4,5,2,11,Loyal
11160,342,2,2322.2799999999997,1,1,4,6,At Risk
11161,79,6,93.95,4,5,3,12,Loyal
11162,345,2,2329.9799999999996,1,1,4,6,At Risk
11163,177,4,46.27,3,4,2,9,Potential
11164,177,6,144.76,3,5,3,11,Loyal
11165,238,3,102.49,2,3,3,8,Potential
11166,54,5,87.96000000000001,5,5,2,12,Loyal
11167,62,4,3126.33,5,4,4,13,Champions
11168,74,7,3136.5899999999997,4,5,4,13,Champions
11169,127,5,81.26,4,5,2,11,Loyal
11170,31,7,157.23000000000002,5,5,3,13,Champions
11171,83,8,6716.549999999999,4,5,5,14,Champions
11172,18,7,128.94,5,5,3,13,Recent Customer
11173,36,3,102.49,5,3,3,11,Loyal
11174,188,5,48.56,3,5,2,10,Loyal
11175,87,8,6710.549999999999,4,5,5,14,Champions
11176,2,60,1320.01,5,5,4,14,Recent Customer
11177,107,6,135.25,4,5,3,12,Loyal
11178,248,6,144.76,2,5,3,10,Loyal
11179,20,6,125.44,5,5,3,13,Recent Customer
11180,126,6,138.45,4,5,3,12,Loyal
11181,202,3,41.28,3,3,2,8,Potential
11182,24,5,81.26,5,5,2,12,Recent Customer
11183,230,4,46.27,2,4,2,8,Potential
11184,112,5,68.25,4,5,2,11,Loyal
11185,3,68,1616.31,5,5,4,14,Recent Customer
11186,22,3,41.28,5,3,2,10,Recent Customer
11187,176,4,107.48,3,4,3,10,Loyal
11188,8,5,81.26,5,5,2,12,Recent Customer
11189,358,6,5944.219999999999,1,5,5,11,Loyal
11190,13,4,46.27,5,4,2,11,Recent Customer
11191,84,7,6743.58,4,5,5,14,Champions
11192,126,5,113.96000000000001,4,5,3,12,Loyal
11193,164,3,41.28,3,3,2,8,Potential
11194,52,6,105.75,5,5,3,13,Champions
11195,99,6,105.75,4,5,3,12,Loyal
11196,127,4,162.28,4,4,3,11,Loyal
11197,193,6,207.56,3,5,3,11,Loyal
11198,350,4,98.47,1,4,3,8,Potential
11199,104,6,131.75,4,5,3,12,Loyal
11200,9,55,1463.3799999999999,5,5,4,14,Recent Customer
11201,142,6,180.94,3,5,3,11,Loyal
11202,130,3,73.98,4,3,2,9,Potential
11203,49,32,801.77,5,5,3,13,Champions
11204,80,4,77.27000000000001,4,4,2,10,Loyal
11205,113,2,37.29,4,1,1,6,At Risk
11206,244,4,77.27000000000001,2,4,2,8,Potential
11207,103,4,77.27000000000001,4,4,2,10,Loyal
11208,134,7,134.23000000000002,3,5,3,11,Loyal
11209,7,2,37.29,5,1,1,7,Recent Customer
11210,145,5,70.75999999999999,3,5,2,10,Loyal
11211,22,33,793.55,5,5,3,13,Recent Customer
11212,12,33,827.19,5,5,3,13,Recent Customer
11213,142,4,77.27000000000001,3,4,2,9,Potential
11214,71,4,162.28,5,4,3,12,Loyal
11215,45,32,1155.52,5,5,4,14,Champions
11216,358,5,5948.24,1,5,5,11,Loyal
11217,349,3,5953.25,1,3,5,9,Potential
11218,25,3,39.58,5,3,1,9,Recent Customer
11219,5,3,39.58,5,3,1,9,Recent Customer
11220,47,4,50.230000000000004,5,4,2,11,Loyal
11221,104,4,46.27,4,4,2,10,Loyal
11222,62,6,207.95999999999998,5,5,3,13,Champions
11223,23,56,1205.3799999999999,5,5,4,14,Recent Customer
11224,57,5,6685.59,5,5,5,15,Champions
11225,145,5,73.25,3,5,2,10,Loyal
11226,304,2,37.29,1,1,1,3,At Risk
11227,353,5,5910.219999999999,1,5,5,11,Loyal
11228,12,4,77.27000000000001,5,4,2,11,Recent Customer
11229,4,5,81.26,5,5,2,12,Recent Customer
11230,51,5,54.220000000000006,5,5,2,12,Loyal
11231,78,4,64.26,4,4,2,10,Loyal
11232,77,3,39.58,4,3,1,8,Potential
11233,235,7,179.43,2,5,3,10,Loyal
11234,132,4,76.27000000000001,4,4,2,10,Loyal
11235,24,6,138.45,5,5,3,13,Recent Customer
11236,23,5,113.96000000000001,5,5,3,13,Recent Customer
11237,65,6,10566.38,5,5,5,15,Champions
11238,274,9,7542.7699999999995,2,5,5,12,Loyal
11239,246,11,7511.549999999999,2,5,5,12,Loyal
11240,261,13,7586.23,2,5,5,12,Loyal
11241,92,25,11469.1882,4,5,5,14,Champions
11242,56,12,11068.0082,5,5,5,15,Champions
11243,234,12,7164.25,2,5,5,12,Loyal
11244,194,12,7175.75,3,5,5,13,Champions
11245,49,9,10580.349999999999,5,5,5,15,Champions
11246,40,7,10575.33,5,5,5,15,Champions
11247,165,12,7131.509999999999,3,5,5,13,Champions
11248,199,3,38.47,3,3,1,7,Potential
11249,136,11,9890.269999999999,3,5,5,13,Champions
11250,176,11,7116.25,3,5,5,13,Champions
11251,103,4,2318.9599999999996,4,4,4,12,Loyal
11252,42,7,6685.5599999999995,5,5,5,15,Champions
11253,57,30,696.61,5,5,3,13,Champions
11254,46,9,203.92,5,5,3,13,Champions
11255,304,5,113.96000000000001,1,5,3,9,Potential
11256,105,5,81.26,4,5,2,11,Loyal
11257,46,6,6677.379999999999,5,5,5,15,Champions
11258,198,4,49.230000000000004,3,4,2,9,Potential
11259,40,5,6770.599999999999,5,5,5,15,Champions
11260,220,5,81.26,2,5,2,9,Potential
11261,37,4,6650.599999999999,5,4,5,14,Champions
11262,7,63,1126.82,5,5,3,13,Recent Customer
11263,50,9,6754.0599999999995,5,5,5,15,Champions
11264,60,8,3182.2699999999995,5,5,4,14,Champions
11265,391,3,2351.9599999999996,1,3,4,8,Potential
11266,374,5,5922.23,1,5,5,11,Loyal
11267,387,5,5943.23,1,5,5,11,Loyal
11268,74,5,98.25,4,5,3,12,Loyal
11269,141,3,42.28,3,3,2,8,Potential
11270,387,5,5984.219999999999,1,5,5,11,Loyal
11271,372,5,5973.24,1,5,5,11,Loyal
11272,381,4,5975.23,1,4,5,10,Loyal
11273,251,8,273.23,2,5,3,10,Loyal
11274,339,4,5888.24,1,4,5,10,Loyal
11275,382,4,5955.23,1,4,5,10,Loyal
11276,7,57,988.3199999999999,5,5,3,13,Recent Customer
11277,13,65,1434.99,5,5,4,14,Recent Customer
11278,391,3,5908.25,1,3,5,9,Potential
11279,221,4,44.57,2,4,2,8,Potential
11280,174,4,77.27000000000001,3,4,2,9,Potential
11281,383,5,5921.19,1,5,5,11,Loyal
11282,392,6,5998.73,1,5,5,11,Loyal
11283,154,4,44.57,3,4,2,9,Potential
11284,272,5,55.48,2,5,2,9,Potential
11285,95,5,127.76,4,5,3,12,Loyal
11286,374,5,5954.219999999999,1,5,5,11,Loyal
11287,1,62,1167.07,5,5,4,14,Recent Customer
11288,161,4,77.27000000000001,3,4,2,9,Potential
11289,378,5,5905.48,1,5,5,11,Loyal
11290,367,3,5933.25,1,3,5,9,Potential
11291,375,2,5873.26,1,1,5,7,Potential
11292,394,5,5910.219999999999,1,5,5,11,Loyal
11293,320,5,85.22,1,5,2,8,Potential
11294,26,3,42.28,5,3,2,10,Recent Customer
11295,385,5,6058.25,1,5,5,11,Loyal
11296,365,4,5897.53,1,4,5,10,Loyal
11297,343,5,5948.24,1,5,5,11,Loyal
11298,342,5,5922.23,1,5,5,11,Loyal
11299,339,4,6015.24,1,4,5,10,Loyal
11300,29,67,1500.52,5,5,4,14,Recent Customer
11301,110,5,131.26,4,5,3,12,Loyal
11302,361,5,5938.19,1,5,5,11,Loyal
11303,340,3,5875.549999999999,1,3,5,9,Potential
11304,282,5,122.21000000000001,2,5,3,10,Loyal
11305,178,4,77.27000000000001,3,4,2,9,Potential
11306,144,3,42.28,3,3,2,8,Potential
11307,355,5,5964.219999999999,1,5,5,11,Loyal
11308,14,4,94.26,5,4,3,12,Recent Customer
11309,24,3,42.28,5,3,2,10,Recent Customer
11310,36,4,77.27000000000001,5,4,2,11,Loyal
11311,138,4,77.27000000000001,3,4,2,9,Potential
11312,241,3,42.28,2,3,2,7,Potential
11313,64,4,44.57,5,4,2,11,Loyal
11314,57,4,47.53,5,4,2,11,Loyal
11315,43,3,42.28,5,3,2,10,Loyal
11316,382,2,2349.9799999999996,1,1,4,6,At Risk
11317,345,2,5873.26,1,1,5,7,Potential
11318,82,4,44.57,4,4,2,10,Loyal
11319,339,4,5930.23,1,4,5,10,Loyal
11320,163,5,72.21,3,5,2,10,Loyal
11321,246,2,37.29,2,1,1,4,At Risk
11322,253,4,44.57,2,4,2,8,Potential
11323,364,6,6074.539999999999,1,5,5,11,Loyal
11324,358,4,5945.23,1,4,5,10,Loyal
11325,363,7,6044.2,1,5,5,11,Loyal
11326,343,5,5948.24,1,5,5,11,Loyal
11327,362,5,5915.539999999999,1,5,5,11,Loyal
11328,297,4,4718.04,1,4,5,10,Loyal
11329,353,2,5898.26,1,1,5,7,Potential
11330,7,57,1136.35,5,5,3,13,Recent Customer
11331,5,58,1329.31,5,5,4,14,Recent Customer
11332,388,3,5754.969999999999,1,3,5,9,Potential
11333,199,6,8163.3099999999995,3,5,5,13,Champions
11334,186,6,8154.0199999999995,3,5,5,13,Champions
11335,390,4,5744.25,1,4,5,10,Loyal
11336,389,5,4441.379599999999,1,5,5,11,Loyal
11337,194,8,8161.999999999999,3,5,5,13,Champions
11338,395,5,5744.949999999999,1,5,5,11,Loyal
11339,369,3,4379.0782,1,3,5,9,Potential
11340,392,5,4413.0581999999995,1,5,5,11,Loyal
11341,194,8,8192.0,3,5,5,13,Champions
11342,201,3,48.970000000000006,3,3,2,8,Potential
11343,189,9,8221.99,3,5,5,13,Champions
11344,190,7,8119.8099999999995,3,5,5,13,Champions
11345,394,3,4404.0882,1,3,5,9,Potential
11346,352,7,4503.048199999999,1,5,5,11,Loyal
11347,319,2,13.98,1,1,1,3,At Risk
11348,304,3,67.97,1,3,2,6,At Risk
11349,16,3,67.97,5,3,2,10,Recent Customer
11350,358,3,38.47,1,3,1,5,At Risk
11351,154,5,8068.03,3,5,5,13,Champions
11352,273,2,13.98,2,1,1,4,At Risk
11353,174,6,8078.0199999999995,3,5,5,13,Champions
11354,57,3,22.97,5,3,1,9,Potential
11355,125,2,13.98,4,1,1,6,At Risk
11356,90,8,5069.29,4,5,5,14,Champions
11357,92,5,4943.8,4,5,5,14,Champions
11358,76,8,5034.78,4,5,5,14,Champions
11359,56,8,4960.07,5,5,5,15,Champions
11360,38,6,5025.799999999999,5,5,5,15,Champions
11361,66,4,114.96000000000001,5,4,3,12,Loyal
11362,127,3,77.27,4,3,2,9,Potential
11363,42,5,5035.8099999999995,5,5,5,15,Champions
11364,34,4,4921.82,5,4,5,14,Champions
11365,38,7,5024.79,5,5,5,15,Champions
11366,167,3,77.27,3,3,2,8,Potential
11367,65,4,86.25999999999999,5,4,2,11,Loyal
11368,59,11,5106.24,5,5,5,15,Champions
11369,33,4,118.96000000000001,5,4,3,12,Loyal
11370,120,3,79.97,4,3,2,9,Potential
11371,32,2,74.98,5,1,2,8,Potential
11372,46,5,4965.8099999999995,5,5,5,15,Champions
11373,155,3,38.47,3,3,1,7,Potential
11374,289,3,68.97,1,3,2,6,At Risk
11375,104,2,13.98,4,1,1,6,At Risk
11376,106,2,78.48,4,1,2,7,Potential
11377,335,3,83.97,1,3,2,6,At Risk
11378,349,4,4436.3895999999995,1,4,5,10,Loyal
11379,337,4,4426.0581999999995,1,4,5,10,Loyal
11380,360,6,5837.91,1,5,5,11,Loyal
11381,164,5,8161.0199999999995,3,5,5,13,Champions
11382,347,2,4344.0882,1,1,5,7,Potential
11383,28,3,48.970000000000006,5,3,2,10,Recent Customer
11384,180,3,48.970000000000006,3,3,2,8,Potential
11385,207,2,13.98,2,1,1,4,At Risk
11386,88,3,68.97,4,3,2,9,Potential
11387,303,6,6958.799999999999,1,5,5,11,Loyal
11388,278,7,6986.749999999999,2,5,5,12,Loyal
11389,73,3,68.97,5,3,2,10,Loyal
11390,83,3,48.970000000000006,4,3,2,9,Potential
11391,95,2,33.98,4,1,1,6,At Risk
11392,306,1,28.99,1,1,1,3,At Risk
11393,197,2,13.98,3,1,1,5,At Risk
11394,180,7,8161.969999999999,3,5,5,13,Champions
11395,343,3,5729.969999999999,1,3,5,9,Potential
11396,95,1,28.99,4,1,1,6,At Risk
11397,206,3,38.47,3,3,1,7,Potential
11398,180,4,8114.039999999999,3,4,5,12,Loyal
11399,291,2,13.98,1,1,1,3,At Risk
11400,194,8,6967.78,3,5,5,13,Champions
11401,327,6,5020.8696,1,5,5,11,Loyal
11402,302,10,5059.3296,1,5,5,11,Loyal
11403,246,9,5033.1395999999995,2,5,5,12,Loyal
11404,353,2,33.98,1,1,1,3,At Risk
11405,304,1,53.99,1,1,2,4,At Risk
11406,354,6,4415.0382,1,5,5,11,Loyal
11407,220,1,53.99,2,1,2,5,At Risk
11408,330,3,34.47,1,3,1,5,At Risk
11409,366,5,4444.0682,1,5,5,11,Loyal
11410,359,5,4464.0682,1,5,5,11,Loyal
11411,178,3,38.47,3,3,1,7,Potential
11412,110,11,9879.96,4,5,5,14,Champions
11413,146,11,7189.749999999999,3,5,5,13,Champions
11414,136,10,7191.7699999999995,3,5,5,13,Champions
11415,166,2,13.98,3,1,1,5,At Risk
11416,269,5,4928.0582,2,5,5,12,Loyal
11417,45,17,11248.4582,5,5,5,15,Champions
11418,43,2,39.980000000000004,5,1,1,7,Potential
11419,216,6,231.75,2,5,3,10,Loyal
11420,61,17,11200.7696,5,5,5,15,Champions
11421,112,4,9780.04,4,4,5,13,Champions
11422,87,10,7075.2699999999995,4,5,5,14,Champions
11423,101,10,9904.97,4,5,5,14,Champions
11424,283,2,43.980000000000004,2,1,2,5,At Risk
11425,39,15,10528.6282,5,5,5,15,Champions
11426,295,1,34.99,1,1,1,3,At Risk
11427,101,9,9917.99,4,5,5,14,Champions
11428,99,12,9954.26,4,5,5,14,Champions
11429,36,17,10468.3796,5,5,5,15,Champions
11430,316,2,84.98,1,1,2,4,At Risk
11431,121,11,9912.98,4,5,5,14,Champions
11432,35,16,9330.1996,5,5,5,15,Champions
11433,137,12,12909.6682,3,5,5,13,Champions
11434,198,4,70.46,3,4,2,9,Potential
11435,25,1,34.99,5,1,1,7,Recent Customer
11436,224,4,81.76,2,4,2,8,Potential
11437,41,1,53.99,5,1,2,8,Potential
11438,358,1,34.99,1,1,1,3,At Risk
11439,101,14,12489.1696,4,5,5,14,Champions
11440,308,2,78.48,1,1,2,4,At Risk
11441,21,2,43.980000000000004,5,1,2,8,Recent Customer
11442,122,1,34.99,4,1,1,6,At Risk
11443,120,8,8235.0,4,5,5,14,Champions
11444,241,5,8136.0199999999995,2,5,5,12,Loyal
11445,215,5,8098.029999999999,2,5,5,12,Loyal
11446,222,7,8237.009999999998,2,5,5,12,Loyal
11447,243,6,8078.0199999999995,2,5,5,12,Loyal
11448,222,7,8132.009999999999,2,5,5,12,Loyal
11449,219,7,8130.32,2,5,5,12,Loyal
11450,226,9,8173.26,2,5,5,12,Loyal
11451,238,9,8249.49,2,5,5,12,Loyal
11452,231,5,8183.039999999999,2,5,5,12,Loyal
11453,224,6,8176.98,2,5,5,12,Loyal
11454,225,4,8089.039999999999,2,4,5,11,Loyal
11455,243,5,8142.029999999999,2,5,5,12,Loyal
11456,243,11,8224.46,2,5,5,12,Loyal
11457,242,10,8211.48,2,5,5,12,Loyal
11458,11,7,96.89,5,5,3,13,Recent Customer
11459,225,5,8141.33,2,5,5,12,Loyal
11460,233,6,8137.5199999999995,2,5,5,12,Loyal
11461,192,4,8089.039999999999,3,4,5,12,Loyal
11462,188,5,8116.33,3,5,5,13,Champions
11463,47,4,47.92,5,4,2,11,Loyal
11464,212,7,8128.509999999999,2,5,5,12,Loyal
11465,200,4,8158.039999999999,3,4,5,12,Loyal
11466,161,7,90.19,3,5,2,10,Loyal
11467,27,5,55.87,5,5,2,12,Recent Customer
11468,161,4,6959.82,3,4,5,12,Loyal
11469,173,2,25.479999999999997,3,1,1,5,At Risk
11470,342,2,4344.0882,1,1,5,7,Potential
11471,257,1,53.99,2,1,2,5,At Risk
11472,95,6,8165.82,4,5,5,14,Champions
11473,241,2,62.980000000000004,2,1,2,5,At Risk
11474,125,3,49.97,4,3,2,9,Potential
11475,281,4,69.46000000000001,2,4,2,8,Potential
11476,89,1,53.99,4,1,2,7,Potential
11477,126,1,34.99,4,1,1,6,At Risk
11478,285,1,53.99,2,1,2,5,At Risk
11479,250,9,4970.6096,2,5,5,12,Loyal
11480,188,7,4935.3596,3,5,5,13,Champions
11481,283,6,4978.048199999999,2,5,5,12,Loyal
11482,141,5,8143.03,3,5,5,13,Champions
11483,194,4,4966.3895999999995,3,4,5,12,Loyal
11484,305,6,4985.3796,1,5,5,11,Loyal
11485,139,7,7048.299999999999,3,5,5,13,Champions
11486,66,1,34.99,5,1,1,7,Potential
11487,45,1,53.99,5,1,2,8,Potential
11488,152,5,8090.33,3,5,5,13,Champions
11489,123,7,8127.509999999999,4,5,5,14,Champions
11490,300,1,53.99,1,1,2,4,At Risk
11491,144,7,8158.009999999999,3,5,5,13,Champions
11492,344,3,4404.0782,1,3,5,9,Potential
11493,139,6,6958.799999999999,3,5,5,13,Champions
11494,121,5,6973.8099999999995,4,5,5,14,Champions
11495,95,2,13.98,4,1,1,6,At Risk
11496,85,7,7013.789999999999,4,5,5,14,Champions
11497,86,1,34.99,4,1,1,6,At Risk
11498,20,30,561.53,5,5,3,13,Recent Customer
11499,214,6,192.21,2,5,3,10,Loyal
11500,19,30,654.27,5,5,3,13,Recent Customer
11501,7,33,872.25,5,5,3,13,Recent Customer
11502,2,43,1026.29,5,5,3,13,Recent Customer
11503,52,3,61.779999999999994,5,3,2,10,Loyal
11504,271,4,44.57,2,4,2,8,Potential
11505,36,36,846.77,5,5,3,13,Champions
11506,7,36,748.6,5,5,3,13,Recent Customer
11507,9,31,653.06,5,5,3,13,Recent Customer
11508,260,4,77.27000000000001,2,4,2,8,Potential
11509,184,3,196.29,3,3,3,9,Potential
11510,34,16,258.15,5,5,3,13,Champions
11511,322,1,35.0,1,1,1,3,At Risk
11512,32,1,2319.99,5,1,4,10,Loyal
11513,235,5,863.95,2,5,3,10,Loyal
11514,219,2,39.99,2,1,2,5,At Risk
11515,284,4,5930.23,2,4,5,11,Loyal
11516,227,5,5915.539999999999,2,5,5,12,Loyal
11517,159,5,101.75999999999999,3,5,3,11,Loyal
11518,79,6,82.2,4,5,2,11,Loyal
11519,18,36,757.27,5,5,3,13,Recent Customer
11520,10,32,822.97,5,5,3,13,Recent Customer
11521,83,4,44.57,4,4,2,10,Loyal
11522,362,4,5888.24,1,4,5,10,Loyal
11523,348,3,2376.9599999999996,1,3,4,8,Potential
11524,104,3,42.28,4,3,2,9,Potential
11525,341,4,5935.549999999999,1,4,5,10,Loyal
11526,360,3,2376.9599999999996,1,3,4,8,Potential
11527,89,3,39.58,4,3,1,8,Potential
11528,344,6,5959.71,1,5,5,11,Loyal
11529,359,6,5944.21,1,5,5,11,Loyal
11530,30,26,573.8,5,5,3,13,Recent Customer
11531,355,3,5875.549999999999,1,3,5,9,Potential
11532,33,4,44.57,5,4,2,11,Loyal
11533,19,2,37.29,5,1,1,7,Recent Customer
11534,349,4,5919.73,1,4,5,10,Loyal
11535,320,6,5919.209999999999,1,5,5,11,Loyal
11536,314,5,5915.539999999999,1,5,5,11,Loyal
11537,311,2,5873.26,1,1,5,7,Potential
11538,334,3,5895.24,1,3,5,9,Potential
11539,310,6,5997.73,1,5,5,11,Loyal
11540,314,5,5958.18,1,5,5,11,Loyal
11541,291,5,5973.24,1,5,5,11,Loyal
11542,263,3,34.47,2,3,1,6,At Risk
11543,39,1,53.99,5,1,2,8,Potential
11544,154,2,88.98,3,1,2,6,At Risk
11545,200,1,53.99,3,1,2,6,At Risk
11546,323,5,4460.379599999999,1,5,5,11,Loyal
11547,185,5,4976.3796,3,5,5,13,Champions
11548,79,9,7068.2699999999995,4,5,5,14,Champions
11549,48,9,7023.7699999999995,5,5,5,15,Champions
11550,319,5,5241.428199999999,1,5,5,11,Loyal
11551,334,1,53.99,1,1,2,4,At Risk
11552,23,1,34.99,5,1,1,7,Recent Customer
11553,160,1,21.49,3,1,1,5,At Risk
11554,266,1,34.99,2,1,1,4,At Risk
11555,266,1,34.99,2,1,1,4,At Risk
11556,39,1,21.49,5,1,1,7,Potential
11557,174,1,21.49,3,1,1,5,At Risk
11558,60,1,21.49,5,1,1,7,Potential
11559,61,1,34.99,5,1,1,7,Potential
11560,57,1,53.99,5,1,2,8,Potential
11561,324,2,4344.0882,1,1,5,7,Potential
11562,217,2,84.98,2,1,2,5,At Risk
11563,208,1,53.99,2,1,2,5,At Risk
11564,317,2,4369.0882,1,1,5,7,Potential
11565,143,1,34.99,3,1,1,5,At Risk
11566,22,58,1006.83,5,5,3,13,Recent Customer
11567,320,1,53.99,1,1,2,4,At Risk
11568,131,5,6789.4596,4,5,5,14,Champions
11569,70,1,34.99,5,1,1,7,Potential
11570,321,2,4391.4096,1,1,5,7,Potential
11571,315,4,4390.6796,1,4,5,10,Loyal
11572,327,6,4450.3696,1,5,5,11,Loyal
11573,186,1,34.99,3,1,1,5,At Risk
11574,320,1,34.99,1,1,1,3,At Risk
11575,135,7,6806.118199999999,3,5,5,13,Champions
11576,312,3,4486.4096,1,3,5,9,Potential
11577,323,2,4344.0882,1,1,5,7,Potential
11578,323,4,4406.3895999999995,1,4,5,10,Loyal
11579,182,2,43.980000000000004,3,1,2,6,At Risk
11580,288,1,34.99,2,1,1,4,At Risk
11581,68,11,237.19000000000003,5,5,3,13,Champions
11582,312,3,4379.0782,1,3,5,9,Potential
11583,296,4,4381.3895999999995,1,4,5,10,Loyal
11584,135,1,8.99,3,1,1,5,At Risk
11585,19,1,49.99,5,1,2,8,Recent Customer
11586,93,1,8.99,4,1,1,6,At Risk
11587,295,5,4540.3782,1,5,5,11,Loyal
11588,262,2,4369.0882,2,1,5,8,Potential
11589,239,2,14.98,2,1,1,4,At Risk
11590,251,4,4384.0682,2,4,5,11,Loyal
11591,251,3,5895.24,2,3,5,10,Loyal
11592,262,3,5875.549999999999,2,3,5,10,Loyal
11593,224,3,5908.25,2,3,5,10,Loyal
11594,165,2,88.98,3,1,2,6,At Risk
11595,30,1,34.99,5,1,1,7,Recent Customer
11596,120,3,49.970000000000006,4,3,2,9,Potential
11597,24,1,34.99,5,1,1,7,Recent Customer
11598,311,5,4548.6996,1,5,5,11,Loyal
11599,231,6,5957.219999999999,2,5,5,12,Loyal
11600,268,1,34.99,2,1,1,4,At Risk
11601,236,6,5932.219999999999,2,5,5,12,Loyal
11602,203,1,34.99,3,1,1,5,At Risk
11603,113,5,6767.138199999999,4,5,5,14,Champions
11604,105,7,6786.1182,4,5,5,14,Champions
11605,335,2,4344.0882,1,1,5,7,Potential
11606,215,5,5922.23,2,5,5,12,Loyal
11607,233,4,5913.24,2,4,5,11,Loyal
11608,47,1,34.99,5,1,1,7,Potential
11609,67,9,6872.1082,5,5,5,15,Champions
11610,89,6,6786.4396,4,5,5,14,Champions
11611,214,2,5873.26,2,1,5,8,Potential
11612,72,6,6795.118199999999,5,5,5,15,Champions
11613,280,4,4381.3895999999995,2,4,5,11,Loyal
11614,299,5,4438.0581999999995,1,5,5,11,Loyal
11615,291,7,5205.7096,1,5,5,11,Loyal
11616,289,10,5253.6496,1,5,5,11,Loyal
11617,297,4,5935.549999999999,1,4,5,10,Loyal
11618,354,4,2369.9599999999996,1,4,4,9,Potential
11619,58,29,634.84,5,5,3,13,Champions
11620,186,4,44.57,3,4,2,9,Potential
11621,91,6,123.24,4,5,3,12,Loyal
11622,228,5,133.75,2,5,3,10,Loyal
11623,278,5,5948.24,2,5,5,12,Loyal
11624,280,2,5898.26,2,1,5,8,Potential
11625,281,4,5913.25,2,4,5,11,Loyal
11626,297,4,5958.74,1,4,5,10,Loyal
11627,81,4,50.230000000000004,4,4,2,10,Loyal
11628,304,3,5875.549999999999,1,3,5,9,Potential
11629,286,4,5930.23,2,4,5,11,Loyal
11630,277,3,5933.26,2,3,5,10,Loyal
11631,35,33,707.5,5,5,3,13,Champions
11632,26,34,1002.09,5,5,3,13,Recent Customer
11633,15,4,77.27000000000001,5,4,2,11,Recent Customer
11634,278,3,39.58,2,3,1,6,At Risk
11635,130,3,42.28,4,3,2,9,Potential
11636,11,4,77.27000000000001,5,4,2,11,Recent Customer
11637,348,3,39.58,1,3,1,5,At Risk
11638,102,4,77.27000000000001,4,4,2,10,Loyal
11639,21,5,127.26,5,5,3,13,Recent Customer
11640,31,15,409.12,5,5,3,13,Champions
11641,164,11,303.2,3,5,3,11,Loyal
11642,5,15,481.87,5,5,3,13,Recent Customer
11643,209,5,100.22,2,5,3,10,Loyal
11644,24,3,42.28,5,3,2,10,Recent Customer
11645,26,5,153.46,5,5,3,13,Recent Customer
11646,188,3,113.47999999999999,3,3,3,9,Potential
11647,348,5,2365.9399999999996,1,5,4,10,Loyal
11648,149,2,88.99000000000001,3,1,2,6,At Risk
11649,281,3,91.28,2,3,2,7,Potential
11650,43,4,128.97,5,4,3,12,Loyal
11651,103,8,226.43,4,5,3,12,Loyal
11652,42,14,310.93,5,5,3,13,Champions
11653,109,5,178.96,4,5,3,12,Loyal
11654,280,4,5955.23,2,4,5,11,Loyal
11655,58,4,50.230000000000004,5,4,2,11,Loyal
11656,17,4,77.27000000000001,5,4,2,11,Recent Customer
11657,1,5,178.96,5,5,3,13,Recent Customer
11658,189,5,111.96000000000001,3,5,3,11,Loyal
11659,23,10,235.01,5,5,3,13,Recent Customer
11660,166,15,324.72,3,5,3,11,Loyal
11661,46,11,287.7,5,5,3,13,Champions
11662,207,4,100.27000000000001,2,4,3,9,Potential
11663,348,5,5948.24,1,5,5,11,Loyal
11664,342,5,5948.24,1,5,5,11,Loyal
11665,349,4,5930.23,1,4,5,10,Loyal
11666,356,5,5948.24,1,5,5,11,Loyal
11667,41,3,91.28,5,3,2,10,Loyal
11668,25,4,128.97,5,4,3,12,Recent Customer
11669,163,6,113.21000000000001,3,5,3,11,Loyal
11670,133,4,100.27000000000001,4,4,3,11,Loyal
11671,296,4,5970.23,1,4,5,10,Loyal
11672,133,3,113.47999999999999,4,3,3,10,Loyal
11673,332,6,191.95000000000002,1,5,3,9,Potential
11674,164,4,96.27000000000001,3,4,3,10,Loyal
11675,354,2,5898.26,1,1,5,7,Potential
11676,51,3,91.28,5,3,2,10,Loyal
11677,60,10,298.21,5,5,3,13,Champions
11678,358,3,5900.549999999999,1,3,5,9,Potential
11679,61,4,145.96,5,4,3,12,Loyal
11680,10,3,93.98,5,3,3,11,Recent Customer
11681,65,5,137.96,5,5,3,13,Champions
11682,51,4,252.98000000000002,5,4,3,12,Loyal
11683,356,5,5897.23,1,5,5,11,Loyal
11684,48,3,93.98,5,3,3,11,Loyal
11685,47,5,110.92,5,5,3,13,Champions
11686,280,4,128.97,2,4,3,9,Potential
11687,222,3,97.98,2,3,3,8,Potential
11688,349,5,5967.23,1,5,5,11,Loyal
11689,149,2,88.99000000000001,3,1,2,6,At Risk
11690,278,4,5904.23,2,4,5,11,Loyal
11691,255,4,119.96000000000001,2,4,3,9,Potential
11692,11,3,93.98,5,3,3,11,Recent Customer
11693,366,1,2294.99,1,1,4,6,At Risk
11694,123,4,128.97,4,4,3,11,Loyal
11695,163,4,128.97,3,4,3,10,Loyal
11696,275,2,5873.26,2,1,5,8,Potential
11697,117,5,152.96,4,5,3,12,Loyal
11698,15,7,255.94,5,5,3,13,Recent Customer
11699,173,5,122.25,3,5,3,11,Loyal
11700,234,5,137.96,2,5,3,10,Loyal
11701,270,4,128.97,2,4,3,9,Potential
11702,76,4,96.27000000000001,4,4,3,11,Loyal
11703,74,4,100.27000000000001,4,4,3,11,Loyal
11704,196,3,93.98,3,3,3,9,Potential
11705,247,5,5940.539999999999,2,5,5,12,Loyal
11706,117,2,88.99000000000001,4,1,2,7,Potential
11707,250,5,6025.219999999999,2,5,5,12,Loyal
11708,246,4,5908.5,2,4,5,11,Loyal
11709,107,12,325.89,4,5,3,12,Loyal
11710,48,3,97.98,5,3,3,11,Loyal
11711,3,55,1103.78,5,5,3,13,Recent Customer
11712,92,8,127.8,4,5,3,12,Loyal
11713,69,6,191.95000000000002,5,5,3,13,Champions
11714,260,3,93.98,2,3,3,8,Potential
11715,30,4,143.97,5,4,3,12,Recent Customer
11716,16,4,96.27000000000001,5,4,3,12,Recent Customer
11717,32,5,192.47,5,5,3,13,Champions
11718,314,4,100.27000000000001,1,4,3,8,Potential
11719,131,11,287.2,4,5,3,12,Loyal
11720,189,6,117.95,3,5,3,11,Loyal
11721,104,5,105.26,4,5,3,12,Loyal
11722,81,5,153.46,4,5,3,12,Loyal
11723,26,9,192.53,5,5,3,13,Recent Customer
11724,46,13,210.09,5,5,3,13,Champions
11725,272,5,123.91,2,5,3,10,Loyal
11726,53,7,223.44,5,5,3,13,Champions
11727,270,4,5962.24,2,4,5,11,Loyal
11728,84,4,109.97,4,4,3,11,Loyal
11729,18,5,159.96,5,5,3,13,Recent Customer
11730,21,5,134.45999999999998,5,5,3,13,Recent Customer
11731,178,5,121.45,3,5,3,11,Loyal
11732,167,5,173.47,3,5,3,11,Loyal
11733,22,4,194.98000000000002,5,4,3,12,Recent Customer
11734,206,4,135.78,3,4,3,10,Loyal
11735,38,4,109.97,5,4,3,12,Loyal
11736,56,5,166.45,5,5,3,13,Champions
11737,196,4,77.27000000000001,3,4,2,9,Potential
11738,33,13,331.68,5,5,3,13,Champions
11739,288,6,4758.03,2,5,5,12,Loyal
11740,11,14,384.09000000000003,5,5,3,13,Recent Customer
11741,343,4,6079.24,1,4,5,10,Loyal
11742,252,5,5915.539999999999,2,5,5,12,Loyal
11743,258,2,5898.26,2,1,5,8,Potential
11744,155,3,72.28,3,3,2,8,Potential
11745,270,5,5948.23,2,5,5,12,Loyal
11746,81,4,77.27000000000001,4,4,2,10,Loyal
11747,108,4,115.96000000000001,4,4,3,11,Loyal
11748,89,8,131.54,4,5,3,12,Loyal
11749,29,4,47.92,5,4,2,11,Recent Customer
11750,120,6,8148.0199999999995,4,5,5,14,Champions
11751,196,6,8215.02,3,5,5,13,Champions
11752,54,8,137.87,5,5,3,13,Champions
11753,106,4,47.92,4,4,2,10,Loyal
11754,183,5,8163.529999999999,3,5,5,13,Champions
11755,165,5,46.25,3,5,2,10,Loyal
11756,96,6,8078.0199999999995,4,5,5,14,Champions
11757,63,5,58.05,5,5,2,12,Loyal
11758,66,5,58.05,5,5,2,12,Loyal
11759,204,3,8054.049999999999,3,3,5,11,Loyal
11760,71,9,274.92,5,5,3,13,Champions
11761,184,8,8149.49,3,5,5,13,Champions
11762,207,7,8228.01,2,5,5,12,Loyal
11763,78,7,76.64999999999999,4,5,2,11,Loyal
11764,206,6,8129.0199999999995,3,5,5,13,Champions
11765,187,5,8143.03,3,5,5,13,Champions
11766,203,11,8280.48,3,5,5,13,Champions
11767,201,7,8319.509999999998,3,5,5,13,Champions
11768,199,4,8139.039999999999,3,4,5,12,Loyal
11769,133,17,478.95,4,5,3,12,Loyal
11770,100,4,77.27000000000001,4,4,2,10,Loyal
11771,189,3,94.47999999999999,3,3,3,9,Potential
11772,259,4,5913.24,2,4,5,11,Loyal
11773,274,4,5983.74,2,4,5,11,Loyal
11774,230,3,5900.549999999999,2,3,5,10,Loyal
11775,240,4,5913.25,2,4,5,11,Loyal
11776,240,4,6079.24,2,4,5,11,Loyal
11777,221,5,5915.53,2,5,5,12,Loyal
11778,214,2,5873.26,2,1,5,8,Potential
11779,220,2,5873.26,2,1,5,8,Potential
11780,225,5,5973.24,2,5,5,12,Loyal
11781,51,5,134.46,5,5,3,13,Champions
11782,135,6,151.75,3,5,3,11,Loyal
11783,263,4,109.97,2,4,3,9,Potential
11784,43,12,272.69,5,5,3,13,Champions
11785,151,3,74.98,3,3,2,8,Potential
11786,6,4,126.96000000000001,5,4,3,12,Recent Customer
11787,85,4,109.97,4,4,3,11,Loyal
11788,162,5,255.27,3,5,3,11,Loyal
11789,276,3,72.28,2,3,2,7,Potential
11790,252,5,146.95000000000002,2,5,3,10,Loyal
11791,59,3,119.98,5,3,3,11,Loyal
11792,213,3,119.98,2,3,3,8,Potential
11793,353,4,101.96000000000001,1,4,3,8,Potential
11794,1,4,77.27000000000001,5,4,2,11,Recent Customer
11795,65,3,74.98,5,3,2,10,Loyal
11796,244,7,5995.2,2,5,5,12,Loyal
11797,214,6,5972.73,2,5,5,12,Loyal
11798,232,3,5953.25,2,3,5,10,Loyal
11799,234,5,5921.19,2,5,5,12,Loyal
11800,169,4,77.27000000000001,3,4,2,9,Potential
11801,29,3,87.28,5,3,2,10,Recent Customer
11802,59,12,215.29,5,5,3,13,Champions
11803,67,6,229.95,5,5,3,13,Champions
11804,170,5,133.96,3,5,3,11,Loyal
11805,85,4,128.97,4,4,3,11,Loyal
11806,118,4,96.27000000000001,4,4,3,11,Loyal
11807,139,5,153.46,3,5,3,11,Loyal
11808,96,14,610.19,4,5,3,12,Loyal
11809,233,4,5929.23,2,4,5,11,Loyal
11810,219,5,5973.24,2,5,5,12,Loyal
11811,226,2,5898.26,2,1,5,8,Potential
11812,225,3,5900.549999999999,2,3,5,10,Loyal
11813,215,3,5953.25,2,3,5,10,Loyal
11814,143,5,101.26,3,5,3,11,Loyal
11815,339,5,5948.24,1,5,5,11,Loyal
11816,343,3,5933.25,1,3,5,9,Potential
11817,351,2,5898.26,1,1,5,7,Potential
11818,364,5,5954.219999999999,1,5,5,11,Loyal
11819,13,4,96.27000000000001,5,4,3,12,Recent Customer
11820,54,10,232.70999999999998,5,5,3,13,Champions
11821,148,7,151.43,3,5,3,11,Loyal
11822,156,3,87.28,3,3,2,8,Potential
11823,6,16,262.42,5,5,3,13,Recent Customer
11824,20,11,240.01,5,5,3,13,Recent Customer
11825,351,3,5900.549999999999,1,3,5,9,Potential
11826,348,2,5898.26,1,1,5,7,Potential
11827,51,15,512.47,5,5,3,13,Champions
11828,285,3,93.98,2,3,3,8,Potential
11829,222,6,130.94,2,5,3,10,Loyal
11830,364,4,5930.23,1,4,5,10,Loyal
11831,353,3,5933.25,1,3,5,9,Potential
11832,142,4,124.97,3,4,3,10,Loyal
11833,62,11,240.01,5,5,3,13,Champions
11834,350,3,5908.25,1,3,5,9,Potential
11835,256,7,4772.3,2,5,5,12,Loyal
11836,282,2,69.99000000000001,2,1,2,5,At Risk
11837,343,5,5923.23,1,5,5,11,Loyal
11838,154,6,135.21,3,5,3,11,Loyal
11839,231,4,5955.23,2,4,5,11,Loyal
11840,270,3,87.28,2,3,2,7,Potential
11841,84,13,307.97,4,5,3,12,Loyal
11842,56,4,98.97,5,4,3,12,Loyal
11843,327,5,116.75999999999999,1,5,3,9,Potential
11844,18,4,124.97,5,4,3,12,Recent Customer
11845,51,11,197.2,5,5,3,13,Champions
11846,203,2,84.99000000000001,3,1,2,6,At Risk
11847,75,4,124.97,4,4,3,11,Loyal
11848,54,4,92.27,5,4,3,12,Loyal
11849,18,5,257.97,5,5,3,13,Recent Customer
11850,240,5,149.46,2,5,3,10,Loyal
11851,55,2,84.99000000000001,5,1,2,8,Potential
11852,149,4,124.97,3,4,3,10,Loyal
11853,223,3,89.98,2,3,2,7,Potential
11854,228,8,5985.2,2,5,5,12,Loyal
11855,140,3,89.98,3,3,2,8,Potential
11856,29,5,133.96,5,5,3,13,Recent Customer
11857,55,4,124.97,5,4,3,12,Loyal
11858,201,2,84.99000000000001,3,1,2,6,At Risk
11859,59,3,72.28,5,3,2,10,Loyal
11860,78,2,69.99000000000001,4,1,2,7,Potential
11861,38,13,286.3,5,5,3,13,Champions
11862,98,5,209.23,4,5,3,12,Loyal
11863,147,3,47.940000000000005,3,3,2,8,Potential
11864,237,3,47.940000000000005,2,3,2,7,Potential
11865,115,4,114.92,4,4,3,11,Loyal
11866,277,2,42.95,2,1,2,5,At Risk
11867,98,4,82.93,4,4,2,10,Loyal
11868,43,11,247.01000000000002,5,5,3,13,Champions
11869,13,14,269.08,5,5,3,13,Recent Customer
11870,12,5,242.27,5,5,3,13,Recent Customer
11871,245,2,69.99000000000001,2,1,2,5,At Risk
11872,218,5,5948.24,2,5,5,12,Loyal
11873,237,5,5923.23,2,5,5,12,Loyal
11874,11,5,72.21,5,5,2,12,Recent Customer
11875,2,11,292.7,5,5,3,13,Recent Customer
11876,127,4,82.93,4,4,2,10,Loyal
11877,32,2,42.95,5,1,2,8,Potential
11878,48,4,82.93,5,4,2,11,Loyal
11879,88,5,107.42,4,5,3,12,Loyal
11880,87,4,50.230000000000004,4,4,2,10,Loyal
11881,43,7,148.4,5,5,3,13,Champions
11882,201,3,47.940000000000005,3,3,2,8,Potential
11883,76,4,77.27000000000001,4,4,2,10,Loyal
11884,31,4,109.97,5,4,3,12,Loyal
11885,359,3,5900.549999999999,1,3,5,9,Potential
11886,226,4,5897.53,2,4,5,11,Loyal
11887,216,4,82.93,2,4,2,8,Potential
11888,317,3,2376.9599999999996,1,3,4,8,Potential
11889,331,4,50.230000000000004,1,4,2,7,Potential
11890,208,6,130.44,2,5,3,10,Loyal
11891,213,4,109.97,2,4,3,9,Potential
11892,191,5,8119.03,3,5,5,13,Champions
11893,190,5,8123.03,3,5,5,13,Champions
11894,207,9,8223.0,2,5,5,12,Loyal
11895,188,5,8149.039999999999,3,5,5,13,Champions
11896,202,6,8117.969999999999,3,5,5,13,Champions
11897,107,6,8203.02,4,5,5,14,Champions
11898,190,6,8179.029999999999,3,5,5,13,Champions
11899,205,7,8189.5,3,5,5,13,Champions
11900,202,7,8257.01,3,5,5,13,Champions
11901,81,7,8248.01,4,5,5,14,Champions
11902,31,6,63.04,5,5,2,12,Loyal
11903,200,4,8108.039999999999,3,4,5,12,Loyal
11904,212,7,8214.5,2,5,5,12,Loyal
11905,207,7,8155.98,2,5,5,12,Loyal
11906,201,7,8150.999999999999,3,5,5,13,Champions
11907,193,5,8135.33,3,5,5,13,Champions
11908,159,3,8079.049999999999,3,3,5,11,Loyal
11909,181,7,8105.3099999999995,3,5,5,13,Champions
11910,179,5,8113.03,3,5,5,13,Champions
11911,39,4,62.459999999999994,5,4,2,11,Loyal
11912,68,6,8095.32,5,5,5,15,Champions
11913,34,4,41.26,5,4,2,11,Loyal
11914,159,8,8165.96,3,5,5,13,Champions
11915,158,8,8142.999999999999,3,5,5,13,Champions
11916,161,7,8178.509999999999,3,5,5,13,Champions
11917,163,6,8121.33,3,5,5,13,Champions
11918,65,8,8204.99,5,5,5,15,Champions
11919,39,8,8171.5199999999995,5,5,5,15,Champions
11920,49,7,8156.32,5,5,5,15,Champions
11921,67,5,63.24,5,5,2,12,Loyal
11922,98,12,275.5,4,5,3,12,Loyal
11923,20,2,42.95,5,1,2,8,Recent Customer
11924,224,5,5897.23,2,5,5,12,Loyal
11925,224,5,5968.23,2,5,5,12,Loyal
11926,225,3,47.940000000000005,2,3,2,7,Potential
11927,1,3,51.94,5,3,2,10,Recent Customer
11928,47,3,47.940000000000005,5,3,2,10,Loyal
11929,43,8,4965.78,5,5,5,15,Champions
11930,44,5,5035.8099999999995,5,5,5,15,Champions
11931,87,7,234.44,4,5,3,12,Loyal
11932,188,6,136.25,3,5,3,11,Loyal
11933,216,3,5933.26,2,3,5,10,Loyal
11934,233,5,5994.719999999999,2,5,5,12,Loyal
11935,237,1,35.0,2,1,1,4,At Risk
11936,299,3,42.28,1,3,2,6,At Risk
11937,211,4,5888.24,2,4,5,11,Loyal
11938,20,2,42.95,5,1,2,8,Recent Customer
11939,224,5,5976.74,2,5,5,12,Loyal
11940,35,2,69.99000000000001,5,1,2,8,Potential
11941,88,5,108.96000000000001,4,5,3,12,Loyal
11942,41,7,4792.29,5,5,5,15,Champions
11943,47,7,4734.29,5,5,5,15,Champions
11944,40,9,4776.2699999999995,5,5,5,15,Champions
11945,123,4,5910.549999999999,4,4,5,13,Champions
11946,38,5,4697.3099999999995,5,5,5,15,Champions
11947,33,6,4747.3,5,5,5,15,Champions
11948,115,4,82.25999999999999,4,4,2,10,Loyal
11949,127,2,69.99000000000001,4,1,2,7,Potential
11950,83,4,109.97,4,4,3,11,Loyal
11951,78,8,63.52,4,5,2,11,Loyal
11952,175,7,8169.0,3,5,5,13,Champions
11953,135,6,65.25,3,5,2,10,Loyal
11954,225,4,5910.549999999999,2,4,5,11,Loyal
11955,215,3,5953.25,2,3,5,10,Loyal
11956,242,2,5873.26,2,1,5,8,Potential
11957,21,6,91.25,5,5,2,12,Recent Customer
11958,80,5,159.96,4,5,3,12,Loyal
11959,80,4,138.48000000000002,4,4,3,11,Loyal
11960,185,3,74.98,3,3,2,8,Potential
11961,113,3,72.28,4,3,2,9,Potential
11962,166,4,102.97,3,4,3,10,Loyal
11963,159,5,8068.03,3,5,5,13,Champions
11964,173,6,8173.529999999999,3,5,5,13,Champions
11965,59,6,118.74000000000001,5,5,3,13,Champions
11966,42,4,55.76,5,4,2,11,Loyal
11967,175,6,8153.0199999999995,3,5,5,13,Champions
11968,165,3,8079.049999999999,3,3,5,11,Loyal
11969,166,6,8173.0199999999995,3,5,5,13,Champions
11970,130,4,109.97,4,4,3,11,Loyal
11971,65,5,134.46,5,5,3,13,Champions
11972,38,6,65.25,5,5,2,12,Loyal
11973,325,5,88.96,1,5,2,8,Potential
11974,55,6,113.44999999999999,5,5,3,13,Champions
11975,107,6,208.96,4,5,3,12,Loyal
11976,157,6,8087.3099999999995,3,5,5,13,Champions
11977,167,8,8212.5,3,5,5,13,Champions
11978,77,3,74.98,4,3,2,9,Potential
11979,266,8,4813.76,2,5,5,12,Loyal
11980,62,5,108.46,5,5,3,13,Champions
11981,1,6,119.76,5,5,3,13,Recent Customer
11982,119,5,105.26,4,5,3,12,Loyal
11983,342,2,5873.26,1,1,5,7,Potential
11984,268,6,4730.32,2,5,5,12,Loyal
11985,24,3,89.98,5,3,2,10,Recent Customer
11986,155,11,8245.23,3,5,5,13,Champions
11987,80,8,279.23,4,5,3,12,Loyal
11988,176,6,8078.0199999999995,3,5,5,13,Champions
11989,176,5,8139.53,3,5,5,13,Champions
11990,160,7,8164.009999999999,3,5,5,13,Champions
11991,41,6,8128.0199999999995,5,5,5,15,Champions
11992,49,5,8123.03,5,5,5,15,Champions
11993,37,7,8131.32,5,5,5,15,Champions
11994,159,5,8169.029999999999,3,5,5,13,Champions
11995,50,7,8249.009999999998,5,5,5,15,Champions
11996,180,11,7058.699999999999,3,5,5,13,Champions
11997,168,7,7029.779999999999,3,5,5,13,Champions
11998,154,7,6962.099999999999,3,5,5,13,Champions
11999,180,9,7043.2699999999995,3,5,5,13,Champions
12000,167,8,8183.0,3,5,5,13,Champions
12001,168,7,8113.009999999999,3,5,5,13,Champions
12002,179,6,8145.33,3,5,5,13,Champions
12003,172,8,8256.5,3,5,5,13,Champions
12004,174,4,8114.039999999999,3,4,5,12,Loyal
12005,165,6,6984.8099999999995,3,5,5,13,Champions
12006,184,6,144.74,3,5,3,11,Loyal
12007,130,8,7023.779999999999,4,5,5,14,Champions
12008,9,5,80.25,5,5,2,12,Recent Customer
12009,169,7,8195.5,3,5,5,13,Champions
12010,176,8,8203.5,3,5,5,13,Champions
12011,45,6,4735.8099999999995,5,5,5,15,Champions
12012,170,4,73.96000000000001,3,4,2,9,Potential
12013,326,3,3949.9699999999993,1,3,5,9,Potential
12014,245,3,3949.9699999999993,2,3,5,10,Loyal
12015,282,3,61.970000000000006,2,3,2,7,Potential
12016,242,4,5913.24,2,4,5,11,Loyal
12017,315,3,2339.9699999999993,1,3,4,8,Potential
12018,127,6,6011.74,4,5,5,14,Champions
12019,126,3,74.98,4,3,2,9,Potential
12020,109,3,804.47,4,3,3,10,Loyal
12021,261,5,4043.4599999999996,2,5,5,12,Loyal
12022,149,6,136.25,3,5,3,11,Loyal
12023,118,3,5933.26,4,3,5,12,Loyal
12024,165,4,83.97,3,4,2,9,Potential
12025,230,4,5910.549999999999,2,4,5,11,Loyal
12026,242,5,5976.74,2,5,5,12,Loyal
12027,187,4,5913.24,3,4,5,12,Loyal
12028,125,2,39.99,4,1,2,7,Potential
12029,180,4,54.97,3,4,2,9,Potential
12030,187,4,5970.23,3,4,5,12,Loyal
12031,84,1,769.49,4,1,3,8,Potential
12032,343,4,614.96,1,4,3,8,Potential
12033,200,4,5949.23,3,4,5,12,Loyal
12034,9,6,74.53999999999999,5,5,2,12,Recent Customer
12035,260,6,81.24000000000001,2,5,2,9,Potential
12036,113,5,69.55,4,5,2,11,Loyal
12037,142,8,7107.099999999999,3,5,5,13,Champions
12038,3,5,91.75,5,5,2,12,Recent Customer
12039,176,9,8213.0,3,5,5,13,Champions
12040,23,4,51.27,5,4,2,11,Recent Customer
12041,212,6,5998.23,2,5,5,12,Loyal
12042,201,4,5975.23,3,4,5,12,Loyal
12043,47,4,103.97,5,4,3,12,Loyal
12044,59,5,105.95,5,5,3,13,Champions
12045,88,3,65.97,4,3,2,9,Potential
12046,286,2,43.99,2,1,2,5,At Risk
12047,104,2,43.99,4,1,2,7,Potential
12048,64,5,133.96,5,5,3,13,Champions
12049,81,6,171.44,4,5,3,12,Loyal
12050,357,6,6023.73,1,5,5,11,Loyal
12051,243,3,89.98,2,3,2,7,Potential
12052,354,4,5935.549999999999,1,4,5,10,Loyal
12053,364,5,5973.24,1,5,5,11,Loyal
12054,43,11,402.53000000000003,5,5,3,13,Champions
12055,13,8,104.19,5,5,3,13,Recent Customer
12056,26,11,253.9,5,5,3,13,Recent Customer
12057,206,3,87.28,3,3,2,8,Potential
12058,360,4,5936.2,1,4,5,10,Loyal
12059,341,4,5930.23,1,4,5,10,Loyal
12060,218,5,4811.54,2,5,5,12,Loyal
12061,122,10,140.17000000000002,4,5,3,12,Loyal
12062,16,3,87.28,5,3,2,10,Recent Customer
12063,77,2,84.99000000000001,4,1,2,7,Potential
12064,62,5,122.42,5,5,3,13,Champions
12065,303,4,92.27,1,4,3,8,Potential
12066,133,2,84.99000000000001,4,1,2,7,Potential
12067,187,5,133.96,3,5,3,11,Loyal
12068,64,3,93.98,5,3,3,11,Loyal
12069,336,4,5897.53,1,4,5,10,Loyal
12070,34,2,84.99000000000001,5,1,2,8,Potential
12071,346,5,5973.24,1,5,5,11,Loyal
12072,323,6,5951.179999999999,1,5,5,11,Loyal
12073,279,5,133.96,2,5,3,10,Loyal
12074,95,13,261.38,4,5,3,12,Loyal
12075,188,3,5933.26,3,3,5,11,Loyal
12076,320,2,5873.26,1,1,5,7,Potential
12077,11,9,174.68,5,5,3,13,Recent Customer
12078,209,4,5975.23,2,4,5,11,Loyal
12079,211,8,6008.2,2,5,5,12,Loyal
12080,304,2,2354.99,1,1,4,6,At Risk
12081,266,3,2366.9599999999996,2,3,4,9,Potential
12082,310,4,5913.24,1,4,5,10,Loyal
12083,333,3,5993.26,1,3,5,9,Potential
12084,194,6,5985.21,3,5,5,13,Champions
12085,158,5,108.46000000000001,3,5,3,11,Loyal
12086,260,1,2294.99,2,1,4,7,Potential
12087,14,4,92.27,5,4,3,12,Recent Customer
12088,4,6,170.94,5,5,3,13,Recent Customer
12089,224,4,4710.03,2,4,5,11,Loyal
12090,266,3,2350.9599999999996,2,3,4,9,Potential
12091,149,4,83.97,3,4,2,9,Potential
12092,240,4,51.27,2,4,2,8,Potential
12093,7,3,46.28,5,3,2,10,Recent Customer
12094,188,6,5962.5199999999995,3,5,5,13,Champions
12095,179,4,56.93,3,4,2,9,Potential
12096,193,3,5900.549999999999,3,3,5,11,Loyal
12097,10,10,238.2,5,5,3,13,Recent Customer
12098,49,4,83.97,5,4,2,11,Loyal
12099,85,2,43.99,4,1,2,7,Potential
12100,134,4,129.47,3,4,3,10,Loyal
12101,237,4,92.27,2,4,3,9,Potential
12102,335,4,5903.19,1,4,5,10,Loyal
12103,314,6,5997.73,1,5,5,11,Loyal
12104,327,3,5908.25,1,3,5,9,Potential
12105,331,3,5993.26,1,3,5,9,Potential
12106,109,7,169.54,4,5,3,12,Loyal
12107,184,8,222.23000000000002,3,5,3,11,Loyal
12108,205,5,5946.2,3,5,5,13,Champions
12109,200,4,5930.23,3,4,5,12,Loyal
12110,186,4,5888.24,3,4,5,12,Loyal
12111,128,4,194.98000000000002,4,4,3,11,Loyal
12112,317,4,5930.23,1,4,5,10,Loyal
12113,242,5,4737.53,2,5,5,12,Loyal
12114,215,5,4719.02,2,5,5,12,Loyal
12115,222,3,89.98,2,3,2,7,Potential
12116,313,3,5933.25,1,3,5,9,Potential
12117,42,3,159.99,5,3,3,11,Loyal
12118,185,8,6004.2,3,5,5,13,Champions
12119,85,4,162.28,4,4,3,11,Loyal
12120,184,3,5908.26,3,3,5,11,Loyal
12121,184,5,5946.2,3,5,5,13,Champions
12122,232,5,4814.04,2,5,5,12,Loyal
12123,70,12,5837.8382,5,5,5,15,Champions
12124,114,12,13195.64,4,5,5,14,Champions
12125,73,10,8595.409599999999,5,5,5,15,Champions
12126,167,4,81.76,3,4,2,9,Potential
12127,80,1,34.99,4,1,1,6,At Risk
12128,56,9,8681.108199999999,5,5,5,15,Champions
12129,35,9,8557.4096,5,5,5,15,Champions
12130,76,10,7987.9096,4,5,5,14,Champions
12131,111,11,13265.99,4,5,5,14,Champions
12132,104,14,13294.27,4,5,5,14,Champions
12133,59,10,5830.6796,5,5,5,15,Champions
12134,112,5,97.45,4,5,3,12,Loyal
12135,212,2,84.99000000000001,2,1,2,5,At Risk
12136,6,10,181.71,5,5,3,13,Recent Customer
12137,263,4,92.27,2,4,3,9,Potential
12138,151,5,119.91,3,5,3,11,Loyal
12139,40,4,102.93,5,4,3,12,Loyal
12140,92,10,118.17,4,5,3,12,Loyal
12141,325,5,5979.219999999999,1,5,5,11,Loyal
12142,333,6,5945.209999999999,1,5,5,11,Loyal
12143,316,3,5993.26,1,3,5,9,Potential
12144,85,4,50.230000000000004,4,4,2,10,Loyal
12145,29,5,132.92000000000002,5,5,3,13,Recent Customer
12146,82,6,227.42000000000002,4,5,3,12,Loyal
12147,77,13,271.45,4,5,3,12,Loyal
12148,30,4,82.93,5,4,2,11,Recent Customer
12149,21,4,82.93,5,4,2,11,Recent Customer
12150,147,2,42.95,3,1,2,6,At Risk
12151,329,3,5895.24,1,3,5,9,Potential
12152,328,5,5937.73,1,5,5,11,Loyal
12153,331,5,5938.23,1,5,5,11,Loyal
12154,190,5,4798.53,3,5,5,13,Champions
12155,309,4,5930.23,1,4,5,10,Loyal
12156,331,3,5920.24,1,3,5,9,Potential
12157,61,2,42.95,5,1,2,8,Potential
12158,48,11,202.2,5,5,3,13,Champions
12159,14,12,258.89,5,5,3,13,Recent Customer
12160,327,4,5945.23,1,4,5,10,Loyal
12161,65,4,206.94,5,4,3,12,Loyal
12162,310,4,5913.24,1,4,5,10,Loyal
12163,331,4,5944.73,1,4,5,10,Loyal
12164,334,3,5908.26,1,3,5,9,Potential
12165,208,13,280.64,2,5,3,10,Loyal
12166,79,9,162.22,4,5,3,12,Loyal
12167,322,4,5975.23,1,4,5,10,Loyal
12168,159,4,72.88,3,4,2,9,Potential
12169,317,5,5948.24,1,5,5,11,Loyal
12170,327,3,5908.26,1,3,5,9,Potential
12171,328,4,5983.74,1,4,5,10,Loyal
12172,317,4,5930.23,1,4,5,10,Loyal
12173,330,4,5929.23,1,4,5,10,Loyal
12174,313,2,5873.26,1,1,5,7,Potential
12175,70,2,155.0,5,1,3,9,Potential
12176,15,4,162.28,5,4,3,12,Recent Customer
12177,195,8,4811.5,3,5,5,13,Champions
12178,333,3,5933.25,1,3,5,9,Potential
12179,205,4,5913.24,3,4,5,12,Loyal
12180,209,4,5930.23,2,4,5,11,Loyal
12181,323,4,5958.74,1,4,5,10,Loyal
12182,99,6,87.25,4,5,2,11,Loyal
12183,204,10,228.42000000000002,3,5,3,11,Loyal
12184,317,3,5875.549999999999,1,3,5,9,Potential
12185,289,4,50.230000000000004,1,4,2,7,Potential
12186,327,4,5913.24,1,4,5,10,Loyal
12187,324,3,5908.25,1,3,5,9,Potential
12188,325,3,5933.25,1,3,5,9,Potential
12189,318,4,5950.23,1,4,5,10,Loyal
12190,331,5,5890.53,1,5,5,11,Loyal
12191,123,5,245.47,4,5,3,12,Loyal
12192,38,3,159.99,5,3,3,11,Loyal
12193,206,6,4833.03,3,5,5,13,Champions
12194,265,4,82.93,2,4,2,8,Potential
12195,186,5,124.41,3,5,3,11,Loyal
12196,16,8,159.93,5,5,3,13,Recent Customer
12197,267,3,47.940000000000005,2,3,2,7,Potential
12198,204,7,5969.7,3,5,5,13,Champions
12199,77,4,194.98000000000002,4,4,3,11,Loyal
12200,326,4,5935.549999999999,1,4,5,10,Loyal
12201,173,5,58.18,3,5,2,10,Loyal
12202,117,13,171.47,4,5,3,12,Loyal
12203,24,12,200.19,5,5,3,13,Recent Customer
12204,221,7,119.93,2,5,3,10,Loyal
12205,30,4,51.27,5,4,2,11,Recent Customer
12206,327,3,5908.25,1,3,5,9,Potential
12207,293,3,5875.549999999999,1,3,5,9,Potential
12208,288,5,5954.219999999999,2,5,5,12,Loyal
12209,283,3,5908.25,2,3,5,10,Loyal
12210,79,6,6825.4496,4,5,5,14,Champions
12211,198,3,5908.25,3,3,5,11,Loyal
12212,206,2,5898.26,3,1,5,9,Potential
12213,303,5,4419.0581999999995,1,5,5,11,Loyal
12214,43,8,6803.9182,5,5,5,15,Champions
12215,39,9,6890.729600000001,5,5,5,15,Champions
12216,43,9,6955.4096,5,5,5,15,Champions
12217,206,2,5873.26,3,1,5,9,Potential
12218,279,5,4472.3696,2,5,5,12,Loyal
12219,186,5,5967.23,3,5,5,13,Champions
12220,184,4,5950.23,3,4,5,12,Loyal
12221,193,4,5968.25,3,4,5,12,Loyal
12222,53,8,6909.0982,5,5,5,15,Champions
12223,174,1,34.99,3,1,1,5,At Risk
12224,75,2,84.98,4,1,2,7,Potential
12225,259,4,4381.3895999999995,2,4,5,11,Loyal
12226,272,5,4368.0581999999995,2,5,5,12,Loyal
12227,275,2,43.980000000000004,2,1,2,5,At Risk
12228,253,3,4401.3996,2,3,5,10,Loyal
12229,251,4,4415.6796,2,4,5,11,Loyal
12230,229,4,4401.0581999999995,2,4,5,11,Loyal
12231,221,3,4354.0782,2,3,5,10,Loyal
12232,233,3,4376.3996,2,3,5,10,Loyal
12233,12,1,34.99,5,1,1,7,Recent Customer
12234,278,1,34.99,2,1,1,4,At Risk
12235,207,4,62.760000000000005,2,4,2,8,Potential
12236,200,1,34.99,3,1,1,5,At Risk
12237,241,5,4470.3895999999995,2,5,5,12,Loyal
12238,204,1,34.99,3,1,1,5,At Risk
12239,43,8,6901.4196,5,5,5,15,Champions
12240,240,2,3964.9799999999996,2,1,5,8,Potential
12241,223,4,3989.46,2,4,5,11,Loyal
12242,232,3,3948.9699999999993,2,3,5,10,Loyal
12243,224,2,3914.9799999999996,2,1,5,8,Potential
12244,257,4,114.96000000000001,2,4,3,9,Potential
12245,230,4,3967.2599999999998,2,4,5,11,Loyal
12246,227,5,3947.25,2,5,5,12,Loyal
12247,271,3,77.27,2,3,2,7,Potential
12248,203,2,3939.9799999999996,3,1,5,9,Potential
12249,100,4,114.96000000000001,4,4,3,11,Loyal
12250,203,2,3964.9799999999996,3,1,5,9,Potential
12251,194,3,3924.9699999999993,3,3,5,11,Loyal
12252,188,5,3938.95,3,5,5,13,Champions
12253,197,6,4066.9299999999994,3,5,5,13,Champions
12254,184,5,5968.23,3,5,5,13,Champions
12255,193,3,5883.25,3,3,5,11,Loyal
12256,166,3,5953.25,3,3,5,11,Loyal
12257,55,1,49.99,5,1,2,8,Potential
12258,120,1,49.99,4,1,2,7,Potential
12259,224,5,86.75,2,5,2,9,Potential
12260,184,5,241.76,3,5,3,11,Loyal
12261,161,5,5973.24,3,5,5,13,Champions
12262,304,5,119.45000000000002,1,5,3,9,Potential
12263,33,8,6829.3796,5,5,5,15,Champions
12264,249,7,5662.8982,2,5,5,12,Loyal
12265,176,5,5964.219999999999,3,5,5,13,Champions
12266,233,3,4401.3996,2,3,5,10,Loyal
12267,166,2,5873.26,3,1,5,9,Potential
12268,288,1,49.99,2,1,2,5,At Risk
12269,216,2,43.980000000000004,2,1,2,5,At Risk
12270,203,4,4454.5682,3,4,5,12,Loyal
12271,256,7,5683.1795999999995,2,5,5,12,Loyal
12272,296,5,5139.7296,1,5,5,11,Loyal
12273,181,1,49.99,3,1,2,6,At Risk
12274,114,1,34.99,4,1,1,6,At Risk
12275,183,5,4435.379599999999,3,5,5,13,Champions
12276,197,5,4416.379599999999,3,5,5,13,Champions
12277,249,8,5666.5196,2,5,5,12,Loyal
12278,221,1,49.99,2,1,2,5,At Risk
12279,169,4,5974.23,3,4,5,12,Loyal
12280,169,5,5923.23,3,5,5,13,Champions
12281,301,7,5169.3582,1,5,5,11,Loyal
12282,297,3,5111.4382,1,3,5,9,Potential
12283,263,6,5582.9082,2,5,5,12,Loyal
12284,253,5,5625.249599999999,2,5,5,12,Loyal
12285,168,4,5968.25,3,4,5,12,Loyal
12286,286,9,5254.878199999999,2,5,5,12,Loyal
12287,248,10,5720.3682,2,5,5,12,Loyal
12288,20,5,147.96,5,5,3,13,Recent Customer
12289,252,8,5645.8582,2,5,5,12,Loyal
12290,178,2,5873.26,3,1,5,9,Potential
12291,70,11,8067.8996,5,5,5,15,Champions
12292,83,6,5027.8582,4,5,5,14,Champions
12293,110,4,86.76,4,4,2,10,Loyal
12294,166,2,75.48,3,1,2,6,At Risk
12295,125,9,174.17000000000002,4,5,3,12,Loyal
12296,96,12,13164.64,4,5,5,14,Champions
12297,81,11,8022.5782,4,5,5,14,Champions
12298,49,10,8053.4096,5,5,5,15,Champions
12299,81,7,4977.3596,4,5,5,14,Champions
12300,104,10,13242.699999999999,4,5,5,14,Champions
12301,70,13,13295.380000000001,5,5,5,15,Champions
12302,34,12,8091.8895999999995,5,5,5,15,Champions
12303,119,3,84.47,4,3,2,9,Potential
12304,32,5,123.45,5,5,3,13,Champions
12305,92,4,4940.3895999999995,4,4,5,13,Champions
12306,235,3,74.97,2,3,2,7,Potential
12307,73,11,13173.189999999999,5,5,5,15,Champions
12308,71,14,13269.27,5,5,5,15,Champions
12309,260,4,102.25999999999999,2,4,3,9,Potential
12310,99,4,103.96000000000001,4,4,3,11,Loyal
12311,39,7,116.43,5,5,3,13,Champions
12312,93,1,34.99,4,1,1,6,At Risk
12313,14,2,43.980000000000004,5,1,2,8,Recent Customer
12314,32,8,7997.9196,5,5,5,15,Champions
12315,321,6,6803.128199999999,1,5,5,11,Loyal
12316,316,6,6799.4496,1,5,5,11,Loyal
12317,311,9,6823.4196,1,5,5,11,Loyal
12318,327,4,6808.1482,1,4,5,10,Loyal
12319,57,3,79.47,5,3,2,10,Loyal
12320,95,4,77.96000000000001,4,4,2,10,Loyal
12321,69,15,13215.65,5,5,5,15,Champions
12322,38,1,49.99,5,1,2,8,Potential
12323,259,11,10836.9,2,5,5,12,Loyal
12324,76,4,66.26,4,4,2,10,Loyal
12325,34,5,132.95000000000002,5,5,3,13,Champions
12326,60,2,63.980000000000004,5,1,2,8,Potential
12327,207,2,13.98,2,1,1,4,At Risk
12328,314,8,6792.1082,1,5,5,11,Loyal
12329,125,4,118.96000000000001,4,4,3,11,Loyal
12330,36,10,7933.4096,5,5,5,15,Champions
12331,330,1,49.99,1,1,2,4,At Risk
12332,219,10,10789.53,2,5,5,12,Loyal
12333,238,11,10829.22,2,5,5,12,Loyal
12334,11,5,94.21000000000001,5,5,3,13,Recent Customer
12335,313,9,6912.598199999999,1,5,5,11,Loyal
12336,44,2,78.98,5,1,2,8,Potential
12337,174,7,8137.009999999999,3,5,5,13,Champions
12338,165,8,8265.0,3,5,5,13,Champions
12339,179,5,6865.4596,3,5,5,13,Champions
12340,128,6,6752.1282,4,5,5,14,Champions
12341,142,7,6840.6182,3,5,5,13,Champions
12342,128,7,6838.1182,4,5,5,14,Champions
12343,131,4,5567.928199999999,4,4,5,13,Champions
12344,169,6,68.7,3,5,2,10,Loyal
12345,17,6,68.7,5,5,2,12,Recent Customer
12346,133,5,6864.4596,4,5,5,14,Champions
12347,127,6,6839.1182,4,5,5,14,Champions
12348,139,10,6906.088199999999,3,5,5,13,Champions
12349,150,5,6772.138199999999,3,5,5,13,Champions
12350,126,6,6791.7496,4,5,5,14,Champions
12351,2,7,185.94,5,5,3,13,Recent Customer
12352,71,7,274.24,5,5,3,13,Champions
12353,153,5,6765.4596,3,5,5,13,Champions
12354,149,6,6797.128199999999,3,5,5,13,Champions
12355,134,7,6818.1082,3,5,5,13,Champions
12356,132,5,6810.128199999999,4,5,5,14,Champions
12357,18,6,117.94,5,5,3,13,Recent Customer
12358,147,5,6787.7596,3,5,5,13,Champions
12359,114,6,95.74000000000001,4,5,3,12,Loyal
12360,127,3,6750.479600000001,4,3,5,12,Loyal
12361,72,5,217.46,5,5,3,13,Champions
12362,283,4,5904.23,2,4,5,11,Loyal
12363,120,11,273.90000000000003,4,5,3,12,Loyal
12364,304,2,5898.26,1,1,5,7,Potential
12365,237,4,53.97,2,4,2,8,Potential
12366,63,5,88.96,5,5,2,12,Loyal
12367,80,5,160.45,4,5,3,12,Loyal
12368,63,1,34.99,5,1,1,7,Potential
12369,46,6,94.23,5,5,3,13,Champions
12370,241,6,61.53,2,5,2,9,Potential
12371,65,7,214.04,5,5,3,13,Champions
12372,194,7,99.03,3,5,3,11,Loyal
12373,165,5,5937.73,3,5,5,13,Champions
12374,356,1,34.99,1,1,1,3,At Risk
12375,18,2,43.980000000000004,5,1,2,8,Recent Customer
12376,239,3,75.47,2,3,2,7,Potential
12377,219,1,49.99,2,1,2,5,At Risk
12378,188,2,4366.4096,3,1,5,9,Potential
12379,283,1,49.99,2,1,2,5,At Risk
12380,224,5,5570.218199999999,2,5,5,12,Loyal
12381,286,6,5161.7296,2,5,5,12,Loyal
12382,237,3,5606.259599999999,2,3,5,10,Loyal
12383,174,2,5898.26,3,1,5,9,Potential
12384,294,8,5056.5282,1,5,5,11,Loyal
12385,301,4,5118.7496,1,4,5,10,Loyal
12386,208,5,4447.3696,2,5,5,12,Loyal
12387,130,1,34.99,4,1,1,6,At Risk
12388,162,3,4379.0782,3,3,5,11,Loyal
12389,77,1,49.99,4,1,2,7,Potential
12390,248,7,4977.8596,2,5,5,12,Loyal
12391,245,4,5121.4282,2,4,5,11,Loyal
12392,320,3,75.47,1,3,2,6,At Risk
12393,124,2,74.48,4,1,2,7,Potential
12394,229,5,5635.9082,2,5,5,12,Loyal
12395,127,4,5968.25,4,4,5,13,Champions
12396,106,1,49.99,4,1,2,7,Potential
12397,250,7,4968.038199999999,2,5,5,12,Loyal
12398,134,6,6498.719999999999,3,5,5,13,Champions
12399,159,4,58.96000000000001,3,4,2,9,Potential
12400,173,3,68.97,3,3,2,8,Potential
12401,132,2,36.59,4,1,1,6,At Risk
12402,241,6,5218.3982,2,5,5,12,Loyal
12403,70,3,67.27,5,3,2,10,Loyal
12404,240,8,5251.7096,2,5,5,12,Loyal
12405,22,2,36.59,5,1,1,7,Recent Customer
12406,44,1,35.0,5,1,1,7,Potential
12407,95,3,74.98,4,3,2,9,Potential
12408,121,3,42.28,4,3,2,9,Potential
12409,83,2,155.0,4,1,3,8,Potential
12410,13,3,159.99,5,3,3,11,Recent Customer
12411,104,3,159.99,4,3,3,10,Loyal
12412,79,5,258.48,4,5,3,12,Loyal
12413,169,4,162.28,3,4,3,10,Loyal
12414,151,3,157.29,3,3,3,9,Potential
12415,68,3,74.98,5,3,2,10,Loyal
12416,214,2,39.99,2,1,2,5,At Risk
12417,24,3,59.27,5,3,2,10,Recent Customer
12418,84,5,5969.719999999999,4,5,5,14,Champions
12419,233,1,35.0,2,1,1,4,At Risk
12420,320,3,42.28,1,3,2,6,At Risk
12421,323,3,74.98,1,3,2,6,At Risk
12422,108,1,35.0,4,1,1,6,At Risk
12423,72,3,5908.25,5,3,5,13,Champions
12424,157,4,99.47,3,4,3,10,Loyal
12425,73,3,89.98,5,3,2,10,Loyal
12426,85,4,99.47,4,4,3,11,Loyal
12427,239,2,39.99,2,1,2,5,At Risk
12428,95,3,74.98,4,3,2,9,Potential
12429,330,1,35.0,1,1,1,3,At Risk
12430,19,11,288.9,5,5,3,13,Recent Customer
12431,21,8,224.53,5,5,3,13,Recent Customer
12432,95,3,91.97,4,3,2,9,Potential
12433,305,3,74.98,1,3,2,6,At Risk
12434,70,3,74.98,5,3,2,10,Loyal
12435,184,3,5920.24,3,3,5,11,Loyal
12436,227,3,42.28,2,3,2,7,Potential
12437,195,5,5983.219999999999,3,5,5,13,Champions
12438,298,2,5898.26,1,1,5,7,Potential
12439,310,4,124.97,1,4,3,8,Potential
12440,207,4,5913.25,2,4,5,11,Loyal
12441,191,3,5875.549999999999,3,3,5,11,Loyal
12442,180,3,5900.549999999999,3,3,5,11,Loyal
12443,11,2,29.93,5,1,1,7,Recent Customer
12444,4,11,293.4,5,5,3,13,Recent Customer
12445,174,1,21.98,3,1,1,5,At Risk
12446,157,4,5944.73,3,4,5,12,Loyal
12447,271,4,2331.9499999999994,2,4,4,10,Loyal
12448,182,5,5915.539999999999,3,5,5,13,Champions
12449,233,3,2351.9599999999996,2,3,4,9,Potential
12450,164,4,5955.23,3,4,5,12,Loyal
12451,223,4,2367.9199999999996,2,4,4,10,Loyal
12452,182,4,5935.549999999999,3,4,5,12,Loyal
12453,254,1,21.98,2,1,1,4,At Risk
12454,296,4,71.95,1,4,2,7,Potential
12455,73,1,21.98,5,1,1,7,Potential
12456,13,1,21.98,5,1,1,7,Recent Customer
12457,300,2,24.27,1,1,1,3,At Risk
12458,147,1,49.99,3,1,2,6,At Risk
12459,227,5,5618.5396,2,5,5,12,Loyal
12460,224,6,5678.9082,2,5,5,12,Loyal
12461,253,9,5030.339599999999,2,5,5,12,Loyal
12462,265,8,5047.5382,2,5,5,12,Loyal
12463,237,7,5202.2196,2,5,5,12,Loyal
12464,138,2,5898.26,3,1,5,9,Potential
12465,154,4,83.42,3,4,2,9,Potential
12466,316,2,58.980000000000004,1,1,2,4,At Risk
12467,283,2,58.980000000000004,2,1,2,5,At Risk
12468,134,3,5875.549999999999,3,3,5,11,Loyal
12469,132,1,49.99,4,1,2,7,Potential
12470,67,1,49.99,5,1,2,8,Potential
12471,319,4,83.97,1,4,2,7,Potential
12472,173,1,49.99,3,1,2,6,At Risk
12473,213,7,5665.219599999999,2,5,5,12,Loyal
12474,141,3,5928.25,3,3,5,11,Loyal
12475,159,4,4438.3796,3,4,5,12,Loyal
12476,97,3,73.77,4,3,2,9,Potential
12477,51,1,49.99,5,1,2,8,Potential
12478,30,1,8.99,5,1,1,7,Recent Customer
12479,163,3,4401.4096,3,3,5,11,Loyal
12480,126,3,5908.25,4,3,5,12,Loyal
12481,327,1,8.99,1,1,1,3,At Risk
12482,35,1,49.99,5,1,2,8,Potential
12483,136,2,5898.26,3,1,5,9,Potential
12484,161,6,4441.038199999999,3,5,5,13,Champions
12485,128,6,5923.49,4,5,5,14,Champions
12486,207,7,5652.3982,2,5,5,12,Loyal
12487,167,3,4401.3996,3,3,5,11,Loyal
12488,131,1,8.99,4,1,1,6,At Risk
12489,20,8,157.92000000000002,5,5,3,13,Recent Customer
12490,148,8,167.83,3,5,3,11,Loyal
12491,180,3,86.58,3,3,2,8,Potential
12492,177,6,5166.4082,3,5,5,13,Champions
12493,259,2,69.99000000000001,2,1,2,5,At Risk
12494,99,5,5948.23,4,5,5,14,Champions
12495,164,5,4416.379599999999,3,5,5,13,Champions
12496,162,4,204.58,3,4,3,10,Loyal
12497,212,3,42.28,2,3,2,7,Potential
12498,214,2,39.99,2,1,2,5,At Risk
12499,155,3,4379.0782,3,3,5,11,Loyal
12500,147,6,4475.3796,3,5,5,13,Champions
12501,142,5,4416.379599999999,3,5,5,13,Champions
12502,144,4,110.46000000000001,3,4,3,10,Loyal
12503,126,4,84.46000000000001,4,4,2,10,Loyal
12504,279,3,61.08,2,3,2,7,Potential
12505,334,2,36.59,1,1,1,3,At Risk
12506,352,2,119.97999999999999,1,1,3,5,At Risk
12507,293,1,8.99,1,1,1,3,At Risk
12508,243,3,132.97,2,3,3,8,Potential
12509,150,6,82.85000000000001,3,5,2,10,Loyal
12510,131,6,6441.0199999999995,4,5,5,14,Champions
12511,215,1,8.99,2,1,1,4,At Risk
12512,312,1,8.99,1,1,1,3,At Risk
12513,110,5,241.76,4,5,3,12,Loyal
12514,349,1,8.99,1,1,1,3,At Risk
12515,189,1,8.99,3,1,1,5,At Risk
12516,44,1,8.99,5,1,1,7,Potential
12517,102,1,8.99,4,1,1,6,At Risk
12518,181,1,8.99,3,1,1,5,At Risk
12519,17,2,71.48,5,1,2,8,Recent Customer
12520,109,4,5919.73,4,4,5,13,Champions
12521,127,4,4438.3796,4,4,5,13,Champions
12522,110,4,5888.24,4,4,5,13,Champions
12523,96,3,5933.25,4,3,5,12,Loyal
12524,230,1,8.99,2,1,1,4,At Risk
12525,249,2,119.97999999999999,2,1,3,6,At Risk
12526,120,9,5229.3782,4,5,5,14,Champions
12527,43,3,86.96000000000001,5,3,2,10,Loyal
12528,154,2,71.97,3,1,2,6,At Risk
12529,10,2,85.48,5,1,2,8,Recent Customer
12530,52,11,337.9,5,5,3,13,Champions
12531,317,1,21.98,1,1,1,3,At Risk
12532,36,9,235.71999999999997,5,5,3,13,Champions
12533,291,7,271.95,1,5,3,9,Potential
12534,143,1,8.99,3,1,1,5,At Risk
12535,133,1,8.99,4,1,1,6,At Risk
12536,69,1,8.99,5,1,1,7,Potential
12537,219,1,8.99,2,1,1,4,At Risk
12538,247,1,8.99,2,1,1,4,At Risk
12539,60,1,8.99,5,1,1,7,Potential
12540,164,3,75.47,3,3,2,8,Potential
12541,228,1,8.99,2,1,1,4,At Risk
12542,18,1,8.99,5,1,1,7,Recent Customer
12543,270,1,8.99,2,1,1,4,At Risk
12544,39,1,8.99,5,1,1,7,Potential
12545,92,5,119.45000000000002,4,5,3,12,Loyal
12546,146,5,4416.379599999999,3,5,5,13,Champions
12547,120,2,5898.26,4,1,5,10,Loyal
12548,153,5,4368.0581999999995,3,5,5,13,Champions
12549,100,3,5908.25,4,3,5,12,Loyal
12550,51,5,86.75,5,5,2,12,Loyal
12551,12,3,75.47,5,3,2,10,Recent Customer
12552,108,1,8.99,4,1,1,6,At Risk
12553,263,1,9.99,2,1,1,4,At Risk
12554,103,3,87.97,4,3,2,9,Potential
12555,148,3,68.97,3,3,2,8,Potential
12556,63,1,8.99,5,1,1,7,Potential
12557,267,3,49.970000000000006,2,3,2,7,Potential
12558,149,2,14.98,3,1,1,5,At Risk
12559,164,6,5633.908199999999,3,5,5,13,Champions
12560,165,7,5636.8982,3,5,5,13,Champions
12561,108,4,5888.24,4,4,5,13,Champions
12562,321,4,58.96000000000001,1,4,2,7,Potential
12563,212,4,118.96000000000001,2,4,3,9,Potential
12564,74,5,110.75,4,5,3,12,Loyal
12565,116,4,93.46,4,4,3,11,Loyal
12566,126,5,147.95000000000002,4,5,3,12,Loyal
12567,116,3,42.97,4,3,2,9,Potential
12568,318,4,67.46,1,4,2,7,Potential
12569,192,3,74.98,3,3,2,8,Potential
12570,170,5,2654.0582,3,5,4,12,Loyal
12571,178,4,2641.3896000000004,3,4,4,11,Loyal
12572,140,2,2611.4096,3,1,4,8,Potential
12573,151,3,2668.0782,3,3,4,10,Loyal
12574,131,4,2626.3896,4,4,4,12,Loyal
12575,124,3,2668.0782,4,3,4,11,Loyal
12576,132,4,2653.0681999999997,4,4,4,12,Loyal
12577,131,3,2614.0782,4,3,4,11,Loyal
12578,98,3,2668.0782,4,3,4,11,Loyal
12579,110,2,2589.0882,4,1,4,9,Potential
12580,101,2,2589.0882,4,1,4,9,Potential
12581,104,3,2646.3995999999997,4,3,4,11,Loyal
12582,88,3,83.97,4,3,2,9,Potential
12583,111,3,2646.3995999999997,4,3,4,11,Loyal
12584,74,3,2633.3896000000004,4,3,4,11,Loyal
12585,84,4,2629.0681999999997,4,4,4,12,Loyal
12586,67,2,2636.4096,5,1,4,10,Loyal
12587,35,3,77.27,5,3,2,10,Loyal
12588,87,3,2639.0782,4,3,4,11,Loyal
12589,82,4,2665.0582,4,4,4,12,Loyal
12590,93,4,67.46,4,4,2,10,Loyal
12591,177,3,49.970000000000006,3,3,2,8,Potential
12592,53,4,51.96,5,4,2,11,Loyal
12593,153,3,42.97,3,3,2,8,Potential
12594,44,2,37.98,5,1,1,7,Potential
12595,178,3,40.269999999999996,3,3,2,8,Potential
12596,19,4,77.96000000000001,5,4,2,11,Recent Customer
12597,121,5,53.21,4,5,2,11,Loyal
12598,118,3,42.97,4,3,2,9,Potential
12599,172,8,5649.2096,3,5,5,13,Champions
12600,143,3,49.970000000000006,3,3,2,8,Potential
12601,15,6,64.9,5,5,2,12,Recent Customer
12602,34,4,45.26,5,4,2,11,Loyal
12603,127,5,117.45,4,5,3,12,Loyal
12604,244,3,23.97,2,3,1,6,At Risk
12605,262,1,9.99,2,1,1,4,At Risk
12606,4,11,333.3,5,5,3,13,Recent Customer
12607,140,7,6489.51,3,5,5,13,Champions
12608,126,8,5689.878199999999,4,5,5,14,Champions
12609,130,7,5636.8982,4,5,5,14,Champions
12610,135,5,101.95,3,5,3,11,Loyal
12611,56,4,67.46,5,4,2,11,Loyal
12612,147,6,5657.9082,3,5,5,13,Champions
12613,113,4,5983.74,4,4,5,13,Champions
12614,100,4,5918.24,4,4,5,13,Champions
12615,101,5,5663.2296,4,5,5,14,Champions
12616,254,2,14.98,2,1,1,4,At Risk
12617,195,3,39.47,3,3,1,7,Potential
12618,76,5,5923.23,4,5,5,14,Champions
12619,113,6,5200.4082,4,5,5,14,Champions
12620,125,7,6481.0199999999995,4,5,5,14,Champions
12621,129,7,6471.21,4,5,5,14,Champions
12622,89,6,5135.4082,4,5,5,14,Champions
12623,116,7,5630.2082,4,5,5,14,Champions
12624,125,3,4379.0782,4,3,5,12,Loyal
12625,147,4,99.96000000000001,3,4,3,10,Loyal
12626,73,4,77.96000000000001,5,4,2,11,Loyal
12627,213,6,110.94,2,5,3,10,Loyal
12628,206,2,14.98,3,1,1,5,At Risk
12629,74,3,53.97,4,3,2,9,Potential
12630,278,6,6825.4596,2,5,5,12,Loyal
12631,236,11,10799.52,2,5,5,12,Loyal
12632,227,6,10793.27,2,5,5,12,Loyal
12633,121,4,86.26,4,4,2,10,Loyal
12634,280,5,6787.7596,2,5,5,12,Loyal
12635,313,1,49.99,1,1,2,4,At Risk
12636,199,3,48.970000000000006,3,3,2,8,Potential
12637,275,6,6845.1182,2,5,5,12,Loyal
12638,88,3,38.47,4,3,1,8,Potential
12639,345,1,49.99,1,1,2,4,At Risk
12640,277,6,6752.1282,2,5,5,12,Loyal
12641,58,1,8.99,5,1,1,7,Potential
12642,259,1,8.99,2,1,1,4,At Risk
12643,3,4,102.96000000000001,5,4,3,12,Recent Customer
12644,284,7,6838.1182,2,5,5,12,Loyal
12645,290,6,6847.7596,1,5,5,11,Loyal
12646,29,2,13.98,5,1,1,7,Recent Customer
12647,284,9,6886.598199999999,2,5,5,12,Loyal
12648,273,8,6817.598199999999,2,5,5,12,Loyal
12649,122,1,8.99,4,1,1,6,At Risk
12650,218,9,10813.63,2,5,5,12,Loyal
12651,116,1,8.99,4,1,1,6,At Risk
12652,67,6,182.94,5,5,3,13,Champions
12653,246,10,6860.0882,2,5,5,12,Loyal
12654,217,4,45.26,2,4,2,8,Potential
12655,226,11,10899.619999999999,2,5,5,12,Loyal
12656,257,1,8.99,2,1,1,4,At Risk
12657,37,8,7384.0982,5,5,5,15,Champions
12658,261,7,6863.4396,2,5,5,12,Loyal
12659,288,3,73.97,2,3,2,7,Potential
12660,60,2,44.980000000000004,5,1,2,8,Potential
12661,304,3,49.970000000000006,1,3,2,6,At Risk
12662,48,2,14.98,5,1,1,7,Potential
12663,73,3,68.97,5,3,2,10,Loyal
12664,112,4,77.96000000000001,4,4,2,10,Loyal
12665,124,6,74.53999999999999,4,5,2,11,Loyal
12666,31,4,34.56,5,4,1,10,Loyal
12667,135,7,6813.1182,3,5,5,13,Champions
12668,132,5,6839.4596,4,5,5,14,Champions
12669,132,5,6791.0982,4,5,5,14,Champions
12670,139,5,6785.128199999999,3,5,5,13,Champions
12671,153,6,6802.1282,3,5,5,13,Champions
12672,226,5,381.97,2,5,3,10,Loyal
12673,146,5,6768.138199999999,3,5,5,13,Champions
12674,147,4,6829.4696,3,4,5,12,Loyal
12675,137,5,6812.7696,3,5,5,13,Champions
12676,145,5,6859.4596,3,5,5,13,Champions
12677,130,4,6785.4696,4,4,5,13,Champions
12678,247,8,341.43,2,5,3,10,Loyal
12679,62,3,187.98,5,3,3,11,Loyal
12680,134,10,6880.098199999999,3,5,5,13,Champions
12681,133,5,6784.128199999999,4,5,5,14,Champions
12682,65,5,227.96,5,5,3,13,Champions
12683,130,5,6801.4496,4,5,5,14,Champions
12684,102,10,6893.078199999999,4,5,5,14,Champions
12685,112,8,6904.1082,4,5,5,14,Champions
12686,120,5,6864.4596,4,5,5,14,Champions
12687,102,4,6805.4696,4,4,5,13,Champions
12688,119,6,6867.4396,4,5,5,14,Champions
12689,122,8,6846.9196,4,5,5,14,Champions
12690,8,6,197.55,5,5,3,13,Recent Customer
12691,47,5,247.46,5,5,3,13,Champions
12692,26,6,315.26,5,5,3,13,Recent Customer
12693,98,5,6820.4696,4,5,5,14,Champions
12694,112,5,6785.128199999999,4,5,5,14,Champions
12695,109,4,192.97,4,4,3,11,Loyal
12696,13,5,231.96,5,5,3,13,Recent Customer
12697,75,8,296.19,4,5,3,12,Loyal
12698,122,6,6786.7496,4,5,5,14,Champions
12699,101,6,6798.1282,4,5,5,14,Champions
12700,97,7,6860.4396,4,5,5,14,Champions
12701,121,8,6868.4396,4,5,5,14,Champions
12702,114,9,6911.098199999999,4,5,5,14,Champions
12703,118,8,6891.1182,4,5,5,14,Champions
12704,108,5,217.46,4,5,3,12,Loyal
12705,103,7,6854.1082,4,5,5,14,Champions
12706,103,9,6851.4096,4,5,5,14,Champions
12707,291,5,5948.23,1,5,5,11,Loyal
12708,92,4,83.97,4,4,2,10,Loyal
12709,280,3,5933.25,2,3,5,10,Loyal
12710,187,4,4774.04,3,4,5,12,Loyal
12711,86,4,5963.24,4,4,5,13,Champions
12712,126,4,4441.0581999999995,4,4,5,13,Champions
12713,96,5,4441.379599999999,4,5,5,14,Champions
12714,194,3,49.970000000000006,3,3,2,8,Potential
12715,179,6,74.53999999999999,3,5,2,10,Loyal
12716,351,3,78.48,1,3,2,6,At Risk
12717,84,3,5883.25,4,3,5,12,Loyal
12718,78,4,103.96000000000001,4,4,3,11,Loyal
12719,203,2,14.98,3,1,1,5,At Risk
12720,231,3,49.970000000000006,2,3,2,7,Potential
12721,270,2,14.98,2,1,1,4,At Risk
12722,298,3,39.47,1,3,1,5,At Risk
12723,336,3,68.97,1,3,2,6,At Risk
12724,362,2,14.98,1,1,1,3,At Risk
12725,164,3,127.28,3,3,3,9,Potential
12726,179,4,98.96000000000001,3,4,3,10,Loyal
12727,218,2,14.98,2,1,1,4,At Risk
12728,297,2,59.980000000000004,1,1,2,4,At Risk
12729,176,4,45.26,3,4,2,9,Potential
12730,38,6,64.9,5,5,2,12,Loyal
12731,135,2,59.980000000000004,3,1,2,6,At Risk
12732,160,2,14.98,3,1,1,5,At Risk
12733,145,3,42.97,3,3,2,8,Potential
12734,129,3,49.970000000000006,4,3,2,9,Potential
12735,116,3,4404.0782,4,3,5,12,Loyal
12736,115,5,4460.379599999999,4,5,5,14,Champions
12737,297,2,44.980000000000004,1,1,2,4,At Risk
12738,266,7,4956.028200000001,2,5,5,12,Loyal
12739,215,1,35.0,2,1,1,4,At Risk
12740,29,5,113.95,5,5,3,13,Recent Customer
12741,294,2,39.980000000000004,1,1,1,3,At Risk
12742,236,10,5148.3096,2,5,5,12,Loyal
12743,104,2,69.99000000000001,4,1,2,7,Potential
12744,153,2,71.97,3,1,2,6,At Risk
12745,36,6,5199.719599999999,5,5,5,15,Champions
12746,91,6,105.24000000000001,4,5,3,12,Loyal
12747,111,4,4384.0682,4,4,5,13,Champions
12748,183,3,49.970000000000006,3,3,2,8,Potential
12749,87,5,5915.539999999999,4,5,5,14,Champions
12750,93,6,6491.73,4,5,5,14,Champions
12751,51,4,83.97,5,4,2,11,Loyal
12752,134,5,156.25,3,5,3,11,Loyal
12753,225,5,170.76,2,5,3,10,Loyal
12754,118,7,6503.2,4,5,5,14,Champions
12755,179,6,5998.719999999999,3,5,5,13,Champions
12756,177,3,5908.25,3,3,5,11,Loyal
12757,301,3,106.96000000000001,1,3,3,7,Potential
12758,248,3,74.98,2,3,2,7,Potential
12759,217,1,21.98,2,1,1,4,At Risk
12760,233,12,273.18,2,5,3,10,Loyal
12761,173,4,5929.23,3,4,5,12,Loyal
12762,33,3,5933.26,5,3,5,13,Champions
12763,240,4,589.96,2,4,3,9,Potential
12764,300,2,4347.76,1,1,5,7,Potential
12765,317,2,1750.98,1,1,4,6,At Risk
12766,238,5,4417.7300000000005,2,5,5,12,Loyal
12767,159,1,35.0,3,1,1,5,At Risk
12768,195,4,4426.74,3,4,5,12,Loyal
12769,173,5,5948.24,3,5,5,13,Champions
12770,165,5,5943.5,3,5,5,13,Champions
12771,175,3,5908.25,3,3,5,11,Loyal
12772,162,4,5913.24,3,4,5,12,Loyal
12773,173,3,5908.25,3,3,5,11,Loyal
12774,156,5,5943.23,3,5,5,13,Champions
12775,235,1,21.98,2,1,1,4,At Risk
12776,8,5,86.26,5,5,2,12,Recent Customer
12777,177,3,5900.549999999999,3,3,5,11,Loyal
12778,40,4,45.95,5,4,2,11,Loyal
12779,160,5,5980.23,3,5,5,13,Champions
12780,134,5,5940.539999999999,3,5,5,13,Champions
12781,225,2,2329.9799999999996,2,1,4,7,Potential
12782,211,4,2400.95,2,4,4,10,Loyal
12783,184,5,2420.4599999999996,3,5,4,12,Loyal
12784,145,5,5985.219999999999,3,5,5,13,Champions
12785,185,1,2294.99,3,1,4,8,Potential
12786,79,1,21.98,4,1,1,6,At Risk
12787,126,5,53.56,4,5,2,11,Loyal
12788,208,2,56.97,2,1,2,5,At Risk
12789,124,5,5980.219999999999,4,5,5,14,Champions
12790,47,2,24.27,5,1,1,7,Potential
12791,341,2,29.93,1,1,1,3,At Risk
12792,23,2,76.97,5,1,2,8,Recent Customer
12793,344,3,120.47,1,3,3,7,Potential
12794,156,1,21.98,3,1,1,5,At Risk
12795,27,9,228.51999999999998,5,5,3,13,Recent Customer
12796,300,2,71.97,1,1,2,4,At Risk
12797,220,2,56.97,2,1,2,5,At Risk
12798,327,2,14.98,1,1,1,3,At Risk
12799,221,2,39.980000000000004,2,1,1,4,At Risk
12800,162,2,39.980000000000004,3,1,1,5,At Risk
12801,5,2,29.479999999999997,5,1,1,7,Recent Customer
12802,17,2,39.980000000000004,5,1,1,7,Recent Customer
12803,14,8,144.18,5,5,3,13,Recent Customer
12804,67,5,5948.23,5,5,5,15,Champions
12805,115,7,6522.219999999999,4,5,5,14,Champions
12806,233,5,4956.0482,2,5,5,12,Loyal
12807,201,7,5024.8596,3,5,5,13,Champions
12808,33,3,5111.4382,5,3,5,13,Champions
12809,267,2,39.980000000000004,2,1,1,4,At Risk
12810,59,2,7.28,5,1,1,7,Potential
12811,96,1,4.99,4,1,1,6,At Risk
12812,258,3,49.970000000000006,2,3,2,7,Potential
12813,67,5,4367.0181999999995,5,5,5,15,Champions
12814,276,2,29.479999999999997,2,1,1,4,At Risk
12815,95,2,7.28,4,1,1,6,At Risk
12816,76,5,4494.0181999999995,4,5,5,14,Champions
12817,82,4,5922.53,4,4,5,13,Champions
12818,63,3,71.58000000000001,5,3,2,10,Loyal
12819,92,5,5948.23,4,5,5,14,Champions
12820,92,3,5908.25,4,3,5,12,Loyal
12821,48,7,124.94,5,5,3,13,Champions
12822,64,2,75.97,5,1,2,8,Potential
12823,36,3,38.88,5,3,1,9,Potential
12824,50,3,44.540000000000006,5,3,2,10,Loyal
12825,69,5,4419.0581999999995,5,5,5,15,Champions
12826,74,5,4428.3696,4,5,5,14,Champions
12827,78,4,4461.3996,4,4,5,13,Champions
12828,317,2,54.980000000000004,1,1,2,4,At Risk
12829,64,5,4406.0581999999995,5,5,5,15,Champions
12830,33,5,5915.539999999999,5,5,5,15,Champions
12831,75,2,39.980000000000004,4,1,1,6,At Risk
12832,312,2,39.980000000000004,1,1,1,3,At Risk
12833,88,4,4359.0682,4,4,5,13,Champions
12834,58,2,5898.26,5,1,5,11,Loyal
12835,241,2,39.980000000000004,2,1,1,4,At Risk
12836,64,4,68.46,5,4,2,11,Loyal
12837,353,1,4.99,1,1,1,3,At Risk
12838,305,3,36.96,1,3,1,5,At Risk
12839,234,5,4392.0181999999995,2,5,5,12,Loyal
12840,337,2,39.980000000000004,1,1,1,3,At Risk
12841,42,3,5933.25,5,3,5,13,Champions
12842,126,1,32.6,4,1,1,6,At Risk
12843,56,3,6018.26,5,3,5,13,Champions
12844,310,2,56.97,1,1,2,4,At Risk
12845,252,2,75.97,2,1,2,5,At Risk
12846,72,5,4460.379599999999,5,5,5,15,Champions
12847,217,1,24.99,2,1,1,4,At Risk
12848,245,4,73.96000000000001,2,4,2,8,Potential
12849,38,4,5888.24,5,4,5,14,Champions
12850,92,4,4406.3895999999995,4,4,5,13,Champions
12851,64,3,71.58000000000001,5,3,2,10,Loyal
12852,86,5,4411.3682,4,5,5,14,Champions
12853,216,3,4354.0782,2,3,5,10,Loyal
12854,238,5,4367.0181999999995,2,5,5,12,Loyal
12855,232,5,4414.3396,2,5,5,12,Loyal
12856,230,5,4460.379599999999,2,5,5,12,Loyal
12857,214,4,4384.0782,2,4,5,11,Loyal
12858,71,3,4393.6996,5,3,5,13,Champions
12859,105,6,5666.219599999999,4,5,5,14,Champions
12860,188,3,4464.0882,3,3,5,11,Loyal
12861,206,5,4394.0581999999995,3,5,5,13,Champions
12862,115,3,117.58000000000001,4,3,3,10,Loyal
12863,61,8,4478.3496,5,5,5,15,Champions
12864,46,6,86.24000000000001,5,5,2,12,Loyal
12865,275,7,114.22999999999999,2,5,3,10,Loyal
12866,46,3,5883.25,5,3,5,13,Champions
12867,41,2,4366.4096,5,1,5,11,Loyal
12868,316,1,32.6,1,1,1,3,At Risk
12869,350,1,32.6,1,1,1,3,At Risk
12870,47,3,48.970000000000006,5,3,2,10,Loyal
12871,8,4,48.96,5,4,2,11,Recent Customer
12872,62,3,48.970000000000006,5,3,2,10,Loyal
12873,104,5,5676.2396,4,5,5,14,Champions
12874,116,5,5638.5396,4,5,5,14,Champions
12875,48,5,80.94,5,5,2,12,Loyal
12876,17,3,36.96,5,3,1,9,Recent Customer
12877,230,2,29.93,2,1,1,4,At Risk
12878,340,2,46.47,1,1,2,4,At Risk
12879,38,3,36.96,5,3,1,9,Potential
12880,103,8,200.73,4,5,3,12,Loyal
12881,143,3,5908.26,3,3,5,11,Loyal
12882,140,4,5930.23,3,4,5,12,Loyal
12883,128,3,5875.549999999999,4,3,5,12,Loyal
12884,135,3,5900.549999999999,3,3,5,11,Loyal
12885,126,5,5948.24,4,5,5,14,Champions
12886,135,5,5965.219999999999,3,5,5,13,Champions
12887,101,1,21.98,4,1,1,6,At Risk
12888,108,3,96.46000000000001,4,3,3,10,Loyal
12889,120,1,21.98,4,1,1,6,At Risk
12890,24,2,71.97,5,1,2,8,Recent Customer
12891,43,1,21.98,5,1,1,7,Potential
12892,61,14,419.47,5,5,3,13,Champions
12893,46,3,48.980000000000004,5,3,2,10,Loyal
12894,125,3,48.980000000000004,4,3,2,9,Potential
12895,58,15,336.65,5,5,3,13,Champions
12896,305,4,44.91,1,4,2,7,Potential
12897,146,3,106.96000000000001,3,3,3,9,Potential
12898,141,4,5958.74,3,4,5,12,Loyal
12899,43,3,96.46000000000001,5,3,3,11,Loyal
12900,71,1,21.98,5,1,1,7,Potential
12901,151,4,5917.24,3,4,5,12,Loyal
12902,190,2,2329.9799999999996,3,1,4,8,Potential
12903,205,3,2332.2799999999997,3,3,4,10,Loyal
12904,150,5,5915.53,3,5,5,13,Champions
12905,168,2,71.97,3,1,2,6,At Risk
12906,347,1,21.98,1,1,1,3,At Risk
12907,316,2,141.98,1,1,3,5,At Risk
12908,329,2,85.48,1,1,2,4,At Risk
12909,103,2,71.97,4,1,2,7,Potential
12910,115,2,56.97,4,1,2,7,Potential
12911,23,2,30.97,5,1,1,7,Recent Customer
12912,97,2,5898.26,4,1,5,10,Loyal
12913,97,4,5922.53,4,4,5,13,Champions
12914,207,2,2329.9799999999996,2,1,4,7,Potential
12915,111,5,5896.19,4,5,5,14,Champions
12916,53,9,261.22,5,5,3,13,Champions
12917,285,2,5898.26,2,1,5,8,Potential
12918,292,2,4763.34,1,1,5,7,Potential
12919,83,13,257.88,4,5,3,12,Loyal
12920,141,5,105.95,3,5,3,11,Loyal
12921,101,4,4803.33,4,4,5,13,Champions
12922,94,5,4513.5125,4,5,5,14,Champions
12923,119,3,4486.5425,4,3,5,12,Loyal
12924,89,4,90.95,4,4,2,10,Loyal
12925,320,1,21.98,1,1,1,3,At Risk
12926,300,4,4795.3099999999995,1,4,5,10,Loyal
12927,190,5,108.46000000000001,3,5,3,11,Loyal
12928,87,10,247.41,4,5,3,12,Loyal
12929,277,4,4820.3099999999995,2,4,5,11,Loyal
12930,282,4,4513.8425,2,4,5,11,Loyal
12931,194,6,155.94,3,5,3,11,Loyal
12932,94,3,48.980000000000004,4,3,2,9,Potential
12933,214,6,142.95000000000002,2,5,3,10,Loyal
12934,294,5,4551.532499999999,1,5,5,11,Loyal
12935,283,4,4794.3099999999995,2,4,5,11,Loyal
12936,101,9,265.22,4,5,3,12,Loyal
12937,178,2,75.97,3,1,2,6,At Risk
12938,344,3,81.46000000000001,1,3,2,6,At Risk
12939,2,13,237.91,5,5,3,13,Recent Customer
12940,98,5,108.46000000000001,4,5,3,12,Loyal
12941,301,3,4818.33,1,3,5,9,Potential
12942,291,2,4501.5525,1,1,5,7,Potential
12943,13,5,105.95,5,5,3,13,Recent Customer
12944,147,10,164.21,3,5,3,11,Loyal
12945,4,13,321.39,5,5,3,13,Recent Customer
12946,134,3,81.46000000000001,3,3,2,8,Potential
12947,95,4,4507.522499999999,4,4,5,13,Champions
12948,349,2,76.97,1,1,2,4,At Risk
12949,117,4,4558.5225,4,4,5,13,Champions
12950,99,3,4760.32,4,3,5,12,Loyal
12951,306,2,30.97,1,1,1,3,At Risk
12952,169,3,36.96,3,3,1,7,Potential
12953,286,3,81.46000000000001,2,3,2,7,Potential
12954,228,4,51.27,2,4,2,8,Potential
12955,16,4,83.97,5,4,2,11,Recent Customer
12956,95,5,108.46000000000001,4,5,3,12,Loyal
12957,33,2,43.99,5,1,2,8,Potential
12958,83,4,207.98,4,4,3,11,Loyal
12959,31,9,203.92000000000002,5,5,3,13,Champions
12960,247,4,51.27,2,4,2,8,Potential
12961,12,4,83.97,5,4,2,11,Recent Customer
12962,76,4,83.97,4,4,2,10,Loyal
12963,33,5,108.46000000000001,5,5,3,13,Champions
12964,74,6,119.95,4,5,3,12,Loyal
12965,359,2,56.97,1,1,2,4,At Risk
12966,208,3,106.96000000000001,2,3,3,8,Potential
12967,234,1,21.98,2,1,1,4,At Risk
12968,67,1,21.98,5,1,1,7,Potential
12969,109,12,180.79,4,5,3,12,Loyal
12970,99,15,471.11,4,5,3,12,Loyal
12971,202,1,21.98,3,1,1,5,At Risk
12972,85,10,175.71,4,5,3,12,Loyal
12973,36,4,83.97,5,4,2,11,Loyal
12974,14,2,56.97,5,1,2,8,Recent Customer
12975,109,4,4618.532499999999,4,4,5,13,Champions
12976,149,1,21.98,3,1,1,5,At Risk
12977,329,2,71.97,1,1,2,4,At Risk
12978,208,4,50.230000000000004,2,4,2,8,Potential
12979,343,2,180.98,1,1,3,5,At Risk
12980,300,4,4552.5225,1,4,5,10,Loyal
12981,279,4,4809.8099999999995,2,4,5,11,Loyal
12982,118,4,57.97,4,4,2,10,Loyal
12983,332,4,100.46000000000001,1,4,3,8,Potential
12984,92,11,200.2,4,5,3,12,Loyal
12985,190,2,43.99,3,1,2,6,At Risk
12986,211,8,4823.01,2,5,5,12,Loyal
12987,107,4,6759.4696,4,4,5,13,Champions
12988,100,7,6915.4382,4,5,5,14,Champions
12989,115,8,6817.1182,4,5,5,14,Champions
12990,120,4,6829.4696,4,4,5,13,Champions
12991,134,7,5641.8982,3,5,5,13,Champions
12992,174,9,158.51,3,5,3,11,Loyal
12993,246,5,96.25,2,5,3,10,Loyal
12994,113,7,6855.4396,4,5,5,14,Champions
12995,95,7,6850.5782,4,5,5,14,Champions
12996,119,4,6808.1482,4,4,5,13,Champions
12997,82,8,118.18,4,5,3,12,Loyal
12998,146,6,5694.8982,3,5,5,13,Champions
12999,102,5,6840.4596,4,5,5,14,Champions
13000,98,6,6799.4496,4,5,5,14,Champions
13001,112,7,6799.4282,4,5,5,14,Champions
13002,70,7,294.94,5,5,3,13,Champions
13003,199,6,230.25,3,5,3,11,Loyal
13004,145,4,190.27,3,4,3,10,Loyal
13005,6,6,386.96,5,5,3,13,Recent Customer
13006,122,4,6762.1482,4,4,5,13,Champions
13007,101,5,5671.2396,4,5,5,14,Champions
13008,43,8,125.51,5,5,3,13,Champions
13009,39,9,168.67,5,5,3,13,Champions
13010,109,8,5716.5196,4,5,5,14,Champions
13011,116,7,6819.1082,4,5,5,14,Champions
13012,103,9,7017.4396,4,5,5,14,Champions
13013,87,7,256.24,4,5,3,12,Loyal
13014,19,4,194.98000000000002,5,4,3,12,Recent Customer
13015,266,2,155.0,2,1,3,6,At Risk
13016,280,5,4813.32,2,5,5,12,Loyal
13017,163,3,42.28,3,3,2,8,Potential
13018,76,4,2642.3796,4,4,4,12,Loyal
13019,104,6,4835.289999999999,4,5,5,14,Champions
13020,44,2,2589.0882,5,1,4,10,Loyal
13021,54,4,2668.3796,5,4,4,13,Champions
13022,51,4,2644.0181999999995,5,4,4,13,Champions
13023,30,4,88.96,5,4,2,11,Recent Customer
13024,59,4,2665.0582,5,4,4,13,Champions
13025,35,3,2690.3996,5,3,4,12,Loyal
13026,54,5,155.94,5,5,3,13,Champions
13027,171,3,2319.2599999999998,3,3,4,10,Loyal
13028,38,3,48.980000000000004,5,3,2,10,Loyal
13029,200,3,2961.0425,3,3,4,10,Loyal
13030,142,2,76.97,3,1,2,6,At Risk
13031,310,1,21.98,1,1,1,3,At Risk
13032,299,3,4740.629999999999,1,3,5,9,Potential
13033,12,4,45.95,5,4,2,11,Recent Customer
13034,142,5,94.71000000000001,3,5,3,11,Loyal
13035,59,5,2638.0582,5,5,4,14,Champions
13036,56,4,2677.0681999999997,5,4,4,13,Champions
13037,80,2,59.980000000000004,4,1,2,7,Potential
13038,103,3,5581.259599999999,4,3,5,12,Loyal
13039,138,3,3282.8299999999995,3,3,5,11,Loyal
13040,12,3,94.97,5,3,3,11,Recent Customer
13041,224,5,153.95,2,5,3,10,Loyal
13042,99,3,84.47,4,3,2,9,Potential
13043,130,6,175.93,4,5,3,12,Loyal
13044,76,2,59.980000000000004,4,1,2,7,Potential
13045,196,3,62.269999999999996,3,3,2,8,Potential
13046,211,3,64.97,2,3,2,7,Potential
13047,132,7,241.93,4,5,3,12,Loyal
13048,84,7,190.23000000000002,4,5,3,12,Loyal
13049,86,6,5647.2196,4,5,5,14,Champions
13050,84,5,5651.2496,4,5,5,14,Champions
13051,96,8,6831.7396,4,5,5,14,Champions
13052,269,2,30.97,2,1,1,4,At Risk
13053,328,2,76.97,1,1,2,4,At Risk
13054,48,2,75.97,5,1,2,8,Potential
13055,145,5,3084.0225,3,5,4,12,Loyal
13056,110,4,3291.8199999999997,4,4,5,13,Champions
13057,85,5,3341.81,4,5,5,14,Champions
13058,374,5,3032.31,1,5,4,10,Loyal
13059,395,5,3089.7999999999997,1,5,4,10,Loyal
13060,355,6,2808.0024999999996,1,5,4,10,Loyal
13061,145,2,46.47,3,1,2,6,At Risk
13062,100,5,4500.5225,4,5,5,14,Champions
13063,94,3,4773.33,4,3,5,12,Loyal
13064,121,6,4579.4725,4,5,5,14,Champions
13065,236,1,1700.99,2,1,4,7,Potential
13066,317,5,3033.31,1,5,4,10,Loyal
13067,275,4,3059.31,2,4,4,10,Loyal
13068,298,5,2815.5225,1,5,4,10,Loyal
13069,298,3,2731.5425,1,3,4,8,Potential
13070,317,2,56.97,1,1,2,4,At Risk
13071,29,6,143.95,5,5,3,13,Recent Customer
13072,22,2,155.0,5,1,3,9,Recent Customer
13073,84,1,21.98,4,1,1,6,At Risk
13074,272,2,56.97,2,1,2,5,At Risk
13075,103,7,6843.9396,4,5,5,14,Champions
13076,105,5,6862.138199999999,4,5,5,14,Champions
13077,80,6,6766.6282,4,5,5,14,Champions
13078,76,6,6850.4596,4,5,5,14,Champions
13079,89,6,6752.128199999999,4,5,5,14,Champions
13080,88,9,6844.4082,4,5,5,14,Champions
13081,73,5,6772.1482,5,5,5,15,Champions
13082,79,8,6906.3896,4,5,5,14,Champions
13083,280,4,4532.522499999999,2,4,5,11,Loyal
13084,234,4,1798.96,2,4,4,10,Loyal
13085,234,5,3089.7999999999997,2,5,4,11,Loyal
13086,122,5,4805.619999999999,4,5,5,14,Champions
13087,99,4,4803.33,4,4,5,13,Champions
13088,117,3,4760.32,4,3,5,12,Loyal
13089,78,6,6800.4496,4,5,5,14,Champions
13090,72,6,6812.4182,5,5,5,15,Champions
13091,89,6,6864.9496,4,5,5,14,Champions
13092,66,5,231.96,5,5,3,13,Champions
13093,281,4,4778.33,2,4,5,11,Loyal
13094,20,2,56.97,5,1,2,8,Recent Customer
13095,38,12,328.89,5,5,3,13,Champions
13096,21,13,230.68,5,5,3,13,Recent Customer
13097,296,1,21.98,1,1,1,3,At Risk
13098,266,2,71.97,2,1,2,5,At Risk
13099,107,5,216.96,4,5,3,12,Loyal
13100,287,3,2376.9599999999996,2,3,4,9,Potential
13101,195,4,4736.03,3,4,5,12,Loyal
13102,296,5,2386.9399999999996,1,5,4,10,Loyal
13103,67,8,6842.598199999999,5,5,5,15,Champions
13104,65,8,6894.4396,5,5,5,15,Champions
13105,89,8,5585.448199999999,4,5,5,14,Champions
13106,77,7,5697.5196,4,5,5,14,Champions
13107,69,6,5650.8982,5,5,5,15,Champions
13108,46,9,5718.6596,5,5,5,15,Champions
13109,51,7,5682.8982,5,5,5,15,Champions
13110,55,3,5583.9382,5,3,5,13,Champions
13111,54,8,5707.1996,5,5,5,15,Champions
13112,48,9,5717.888199999999,5,5,5,15,Champions
13113,86,7,6832.4096,4,5,5,14,Champions
13114,67,5,6807.4496,5,5,5,15,Champions
13115,86,7,6779.4182,4,5,5,14,Champions
13116,71,6,230.25,5,5,3,13,Champions
13117,81,6,6831.4182,4,5,5,14,Champions
13118,37,6,5669.8982,5,5,5,15,Champions
13119,66,6,6829.4496,5,5,5,15,Champions
13120,34,7,205.39,5,5,3,13,Champions
13121,145,5,121.25,3,5,3,11,Loyal
13122,63,7,6871.4295999999995,5,5,5,15,Champions
13123,92,5,6765.4382000000005,4,5,5,14,Champions
13124,27,4,91.92,5,4,2,11,Recent Customer
13125,40,6,138.54,5,5,3,13,Champions
13126,67,7,6815.0782,5,5,5,15,Champions
13127,120,4,86.26,4,4,2,10,Loyal
13128,91,5,6817.138199999999,4,5,5,14,Champions
13129,71,5,6823.1482,5,5,5,15,Champions
13130,71,5,6797.1482,5,5,5,15,Champions
13131,67,4,6737.1482,5,4,5,14,Champions
13132,81,9,6880.6182,4,5,5,14,Champions
13133,92,7,6813.1182,4,5,5,14,Champions
13134,52,5,5648.918199999999,5,5,5,15,Champions
13135,73,5,6773.138199999999,5,5,5,15,Champions
13136,113,3,62.269999999999996,4,3,2,9,Potential
13137,224,6,177.94,2,5,3,10,Loyal
13138,184,3,83.97,3,3,2,8,Potential
13139,69,7,6854.4496,5,5,5,15,Champions
13140,9,10,325.21,5,5,3,13,Recent Customer
13141,65,7,240.24,5,5,3,13,Champions
13142,99,3,4798.34,4,3,5,12,Loyal
13143,180,3,2404.9699999999993,3,3,4,10,Loyal
13144,145,11,281.47,3,5,3,11,Loyal
13145,86,4,2337.2699999999995,4,4,4,12,Loyal
13146,256,2,30.97,2,1,1,4,At Risk
13147,237,3,74.98,2,3,2,7,Potential
13148,317,3,1137.43,1,3,3,7,Potential
13149,62,3,64.97,5,3,2,10,Loyal
13150,177,5,89.24000000000001,3,5,2,10,Loyal
13151,56,4,91.95,5,4,2,11,Loyal
13152,81,5,4582.5125,4,5,5,14,Champions
13153,351,3,106.96000000000001,1,3,3,7,Potential
13154,85,3,2309.9699999999993,4,3,4,11,Loyal
13155,34,6,226.95,5,5,3,13,Champions
13156,33,4,2663.6896,5,4,4,13,Champions
13157,23,2,59.980000000000004,5,1,2,8,Recent Customer
13158,100,9,221.91,4,5,3,12,Loyal
13159,45,8,208.18,5,5,3,13,Champions
13160,70,5,6839.4596,5,5,5,15,Champions
13161,70,3,4523.532499999999,5,3,5,13,Champions
13162,197,2,85.48,3,1,2,6,At Risk
13163,244,2,30.97,2,1,1,4,At Risk
13164,213,4,100.46000000000001,2,4,3,9,Potential
13165,80,2,4501.5525,4,1,5,10,Loyal
13166,313,2,71.97,1,1,2,4,At Risk
13167,84,3,42.28,4,3,2,9,Potential
13168,125,3,74.98,4,3,2,9,Potential
13169,106,3,191.97,4,3,3,10,Loyal
13170,280,4,230.96,2,4,3,9,Potential
13171,237,3,191.97,2,3,3,8,Potential
13172,21,3,144.27,5,3,3,11,Recent Customer
13173,285,5,4598.0125,2,5,5,12,Loyal
13174,295,4,4558.5225,1,4,5,10,Loyal
13175,2,12,286.88,5,5,3,13,Recent Customer
13176,283,4,4753.32,2,4,5,11,Loyal
13177,283,3,4498.532499999999,2,3,5,10,Loyal
13178,288,3,4498.532499999999,2,3,5,10,Loyal
13179,47,10,190.17000000000002,5,5,3,13,Champions
13180,156,4,201.46,3,4,3,10,Loyal
13181,88,4,185.96,4,4,3,11,Loyal
13182,54,5,165.95,5,5,3,13,Champions
13183,307,3,195.97,1,3,3,7,Potential
13184,57,5,220.46,5,5,3,13,Champions
13185,192,8,149.84,3,5,3,11,Loyal
13186,265,1,21.98,2,1,1,4,At Risk
13187,274,2,29.93,2,1,1,4,At Risk
13188,109,2,56.97,4,1,2,7,Potential
13189,290,3,4765.629999999999,1,3,5,9,Potential
13190,275,2,4501.5525,2,1,5,8,Potential
13191,152,2,46.47,3,1,2,6,At Risk
13192,81,2,56.97,4,1,2,7,Potential
13193,207,2,71.97,2,1,2,5,At Risk
13194,132,2,56.97,4,1,2,7,Potential
13195,295,2,71.97,1,1,2,4,At Risk
13196,113,2,56.97,4,1,2,7,Potential
13197,80,8,105.19000000000001,4,5,3,12,Loyal
13198,123,6,114.95,4,5,3,12,Loyal
13199,114,8,105.19000000000001,4,5,3,12,Loyal
13200,80,2,24.27,4,1,1,6,At Risk
13201,54,7,73.16,5,5,2,12,Loyal
13202,299,4,4558.5225,1,4,5,10,Loyal
13203,298,4,4491.532499999999,1,4,5,10,Loyal
13204,86,2,141.98,4,1,3,8,Potential
13205,283,4,4803.32,2,4,5,11,Loyal
13206,149,11,163.19,3,5,3,11,Loyal
13207,115,2,85.48,4,1,2,7,Potential
13208,293,5,4813.32,1,5,5,11,Loyal
13209,151,1,2319.99,3,1,4,8,Potential
13210,80,2,4501.5525,4,1,5,10,Loyal
13211,10,2,30.97,5,1,1,7,Recent Customer
13212,82,4,4564.4925,4,4,5,13,Champions
13213,327,1,21.98,1,1,1,3,At Risk
13214,82,2,4501.5525,4,1,5,10,Loyal
13215,170,4,71.95,3,4,2,9,Potential
13216,266,3,96.46000000000001,2,3,3,8,Potential
13217,134,3,2351.9599999999996,3,3,4,10,Loyal
13218,88,2,85.48,4,1,2,7,Potential
13219,116,1,21.98,4,1,1,6,At Risk
13220,303,4,4682.532499999999,1,4,5,10,Loyal
13221,280,4,4795.3099999999995,2,4,5,11,Loyal
13222,84,9,150.41,4,5,3,12,Loyal
13223,96,2,56.97,4,1,2,7,Potential
13224,251,4,4536.032499999999,2,4,5,11,Loyal
13225,62,3,4503.8425,5,3,5,13,Champions
13226,65,4,4564.4925,5,4,5,14,Champions
13227,290,2,71.97,1,1,2,4,At Risk
13228,187,2,56.97,3,1,2,6,At Risk
13229,210,1,21.98,2,1,1,4,At Risk
13230,265,4,4905.32,2,4,5,11,Loyal
13231,134,11,247.9,3,5,3,11,Loyal
13232,144,1,21.98,3,1,1,5,At Risk
13233,87,5,4587.5125,4,5,5,14,Champions
13234,363,3,36.96,1,3,1,5,At Risk
13235,345,2,56.97,1,1,2,4,At Risk
13236,101,1,21.98,4,1,1,6,At Risk
13237,273,4,4516.532499999999,2,4,5,11,Loyal
13238,246,3,4511.5425,2,3,5,10,Loyal
13239,39,11,185.7,5,5,3,13,Champions
13240,151,1,21.98,3,1,1,5,At Risk
13241,147,3,2325.9599999999996,3,3,4,10,Loyal
13242,112,2,56.97,4,1,2,7,Potential
13243,247,3,4511.5425,2,3,5,10,Loyal
13244,111,3,81.46000000000001,4,3,2,9,Potential
13245,206,2,46.47,3,1,2,6,At Risk
13246,68,5,4813.3099999999995,5,5,5,15,Champions
13247,73,4,4548.522499999999,5,4,5,14,Champions
13248,84,4,4491.532499999999,4,4,5,13,Champions
13249,192,5,4795.34,3,5,5,13,Champions
13250,268,2,4501.5525,2,1,5,8,Potential
13251,267,7,6844.4182,2,5,5,12,Loyal
13252,256,5,6820.4596,2,5,5,12,Loyal
13253,247,6,6774.4496,2,5,5,12,Loyal
13254,258,6,6801.128199999999,2,5,5,12,Loyal
13255,58,12,7393.0581999999995,5,5,5,15,Champions
13256,35,13,7494.879599999999,5,5,5,15,Champions
13257,54,9,8941.279999999999,5,5,5,15,Champions
13258,46,10,8886.53,5,5,5,15,Champions
13259,72,14,7853.489999999999,5,5,5,15,Champions
13260,169,8,7239.5599999999995,3,5,5,13,Champions
13261,121,6,7200.58,4,5,5,14,Champions
13262,126,5,86.95,4,5,2,11,Loyal
13263,207,12,10872.06,2,5,5,12,Loyal
13264,114,8,7265.5599999999995,4,5,5,14,Champions
13265,85,8,7259.5599999999995,4,5,5,14,Champions
13266,315,2,29.93,1,1,1,3,At Risk
13267,23,8,124.93,5,5,3,13,Recent Customer
13268,148,12,289.7,3,5,3,11,Loyal
13269,65,4,4507.522499999999,5,4,5,14,Champions
13270,124,5,2394.95,4,5,4,13,Champions
13271,136,1,2319.99,3,1,4,8,Potential
13272,92,3,81.46000000000001,4,3,2,9,Potential
13273,260,4,4657.532499999999,2,4,5,11,Loyal
13274,265,6,4837.8099999999995,2,5,5,12,Loyal
13275,353,1,21.98,1,1,1,3,At Risk
13276,56,1,21.98,5,1,1,7,Potential
13277,273,3,4498.532499999999,2,3,5,10,Loyal
13278,269,4,4578.522499999999,2,4,5,11,Loyal
13279,251,4,4533.5225,2,4,5,11,Loyal
13280,271,4,4558.5225,2,4,5,11,Loyal
13281,19,1,21.98,5,1,1,7,Recent Customer
13282,63,2,56.97,5,1,2,8,Potential
13283,258,3,4498.532499999999,2,3,5,10,Loyal
13284,211,5,4767.53,2,5,5,12,Loyal
13285,95,11,214.35000000000002,4,5,3,12,Loyal
13286,248,4,4516.532499999999,2,4,5,11,Loyal
13287,257,2,4763.34,2,1,5,8,Potential
13288,253,6,4573.5025,2,5,5,12,Loyal
13289,14,6,66.25,5,5,2,12,Recent Customer
13290,74,8,111.89,4,5,3,12,Loyal
13291,249,3,81.46000000000001,2,3,2,7,Potential
13292,248,3,4478.8425,2,3,5,10,Loyal
13293,193,1,21.98,3,1,1,5,At Risk
13294,115,4,86.95,4,4,2,10,Loyal
13295,6,2,71.97,5,1,2,8,Recent Customer
13296,308,1,21.98,1,1,1,3,At Risk
13297,187,1,21.98,3,1,1,5,At Risk
13298,256,3,4511.5425,2,3,5,10,Loyal
13299,272,6,4835.299999999999,2,5,5,12,Loyal
13300,152,4,45.95,3,4,2,9,Potential
13301,136,3,66.96000000000001,3,3,2,8,Potential
13302,334,2,56.97,1,1,2,4,At Risk
13303,145,6,66.25,3,5,2,10,Loyal
13304,251,5,4612.5125,2,5,5,12,Loyal
13305,270,2,71.97,2,1,2,5,At Risk
13306,44,2,71.97,5,1,2,8,Potential
13307,239,3,81.46000000000001,2,3,2,7,Potential
13308,277,2,29.93,2,1,1,4,At Risk
13309,285,1,21.98,2,1,1,4,At Risk
13310,322,2,29.93,1,1,1,3,At Risk
13311,35,2,29.93,5,1,1,7,Potential
13312,191,3,80.96000000000001,3,3,2,8,Potential
13313,322,2,76.97,1,1,2,4,At Risk
13314,257,6,4854.29,2,5,5,12,Loyal
13315,270,4,4541.532499999999,2,4,5,11,Loyal
13316,263,5,4576.532499999999,2,5,5,12,Loyal
13317,67,2,56.97,5,1,2,8,Potential
13318,118,12,214.26,4,5,3,12,Loyal
13319,253,6,4647.5125,2,5,5,12,Loyal
13320,337,1,21.98,1,1,1,3,At Risk
13321,30,4,71.95,5,4,2,11,Recent Customer
13322,265,2,85.48,2,1,2,5,At Risk
13323,47,2,141.98,5,1,3,9,Potential
13324,265,6,4526.782499999999,2,5,5,12,Loyal
13325,247,4,4558.5225,2,4,5,11,Loyal
13326,254,3,4511.5525,2,3,5,10,Loyal
13327,193,2,30.97,3,1,1,5,At Risk
13328,206,6,4708.0199999999995,3,5,5,13,Champions
13329,251,5,4807.3099999999995,2,5,5,12,Loyal
13330,141,6,94.95,3,5,3,11,Loyal
13331,201,3,65.96000000000001,3,3,2,8,Potential
13332,104,2,56.97,4,1,2,7,Potential
13333,127,1,21.98,4,1,1,6,At Risk
13334,182,4,71.95,3,4,2,9,Potential
13335,60,2,71.97,5,1,2,8,Potential
13336,296,3,106.96000000000001,1,3,3,7,Potential
13337,237,2,180.98,2,1,3,6,At Risk
13338,3,5,121.94000000000001,5,5,3,13,Recent Customer
13339,354,2,30.97,1,1,1,3,At Risk
13340,254,5,4546.5225,2,5,5,12,Loyal
13341,348,2,141.98,1,1,3,5,At Risk
13342,83,3,32.22,4,3,1,8,Potential
13343,189,6,4720.27,3,5,5,13,Champions
13344,272,3,80.96000000000001,2,3,2,7,Potential
13345,204,6,4759.51,3,5,5,13,Champions
13346,272,3,4498.532499999999,2,3,5,10,Loyal
13347,238,2,71.97,2,1,2,5,At Risk
13348,251,6,4615.032499999999,2,5,5,12,Loyal
13349,350,1,21.98,1,1,1,3,At Risk
13350,1,7,132.45,5,5,3,13,Recent Customer
13351,266,2,4476.5525,2,1,5,8,Potential
13352,222,2,56.97,2,1,2,5,At Risk
13353,90,6,4547.5025,4,5,5,14,Champions
13354,265,3,4498.532499999999,2,3,5,10,Loyal
13355,246,4,4558.532499999999,2,4,5,11,Loyal
13356,105,2,30.97,4,1,1,6,At Risk
13357,67,5,4543.8324999999995,5,5,5,15,Champions
13358,131,5,2386.9399999999996,4,5,4,13,Champions
13359,83,4,4637.8425,4,4,5,13,Champions
13360,359,2,56.97,1,1,2,4,At Risk
13361,82,3,4765.629999999999,4,3,5,12,Loyal
13362,67,2,4476.5525,5,1,5,11,Loyal
13363,335,2,71.97,1,1,2,4,At Risk
13364,259,2,56.97,2,1,2,5,At Risk
13365,140,2,24.27,3,1,1,5,At Risk
13366,210,4,4749.04,2,4,5,11,Loyal
13367,271,4,4516.532499999999,2,4,5,11,Loyal
13368,95,2,71.97,4,1,2,7,Potential
13369,247,4,4778.33,2,4,5,11,Loyal
13370,72,2,2329.99,5,1,4,10,Loyal
13371,176,2,71.97,3,1,2,6,At Risk
13372,359,2,76.97,1,1,2,4,At Risk
13373,304,4,71.95,1,4,2,7,Potential
13374,108,2,56.97,4,1,2,7,Potential
13375,57,2,71.97,5,1,2,8,Potential
13376,125,2,30.97,4,1,1,6,At Risk
13377,273,1,2319.99,2,1,4,7,Potential
13378,272,6,4522.5025,2,5,5,12,Loyal
13379,196,2,24.27,3,1,1,5,At Risk
13380,72,4,4820.3099999999995,5,4,5,14,Champions
13381,189,2,71.97,3,1,2,6,At Risk
13382,251,4,4525.8225,2,4,5,11,Loyal
13383,87,3,4511.5425,4,3,5,12,Loyal
13384,70,4,4573.522499999999,5,4,5,14,Champions
13385,77,6,4548.5025,4,5,5,14,Champions
13386,119,3,84.96000000000001,4,3,2,9,Potential
13387,88,4,2337.2699999999995,4,4,4,12,Loyal
13388,330,3,106.96000000000001,1,3,3,7,Potential
13389,60,4,115.95000000000002,5,4,3,12,Loyal
13390,30,5,99.94,5,5,3,13,Recent Customer
13391,119,3,2405.47,4,3,4,11,Loyal
13392,81,2,56.97,4,1,2,7,Potential
13393,264,3,2351.9599999999996,2,3,4,9,Potential
13394,262,4,2318.9599999999996,2,4,4,10,Loyal
13395,195,1,21.98,3,1,1,5,At Risk
13396,245,4,2362.2699999999995,2,4,4,10,Loyal
13397,78,6,2396.9399999999996,4,5,4,13,Champions
13398,69,2,2322.2799999999997,5,1,4,10,Loyal
13399,82,1,2294.99,4,1,4,9,Potential
13400,83,6,4568.5025,4,5,5,14,Champions
13401,69,3,4798.34,5,3,5,13,Champions
13402,92,3,4793.33,4,3,5,12,Loyal
13403,260,4,4578.522499999999,2,4,5,11,Loyal
13404,247,7,6812.1182,2,5,5,12,Loyal
13405,189,11,10778.609999999999,3,5,5,13,Champions
13406,73,9,7300.549999999999,5,5,5,15,Champions
13407,249,8,6904.0982,2,5,5,12,Loyal
13408,247,8,6792.118200000001,2,5,5,12,Loyal
13409,99,5,108.95,4,5,3,12,Loyal
13410,236,2,14.98,2,1,1,4,At Risk
13411,244,5,6819.4596,2,5,5,12,Loyal
13412,40,4,45.26,5,4,2,11,Loyal
13413,90,2,56.97,4,1,2,7,Potential
13414,268,1,2319.99,2,1,4,7,Potential
13415,248,3,2325.9599999999996,2,3,4,9,Potential
13416,325,3,106.96000000000001,1,3,3,7,Potential
13417,272,4,2369.9699999999993,2,4,4,10,Loyal
13418,168,4,4768.049999999999,3,4,5,12,Loyal
13419,270,2,4476.5525,2,1,5,8,Potential
13420,270,3,4798.33,2,3,5,10,Loyal
13421,277,2,24.27,2,1,1,4,At Risk
13422,258,3,81.46000000000001,2,3,2,7,Potential
13423,2,8,172.89000000000001,5,5,3,13,Recent Customer
13424,250,5,4807.3099999999995,2,5,5,12,Loyal
13425,249,4,4810.3099999999995,2,4,5,11,Loyal
13426,265,3,4498.532499999999,2,3,5,10,Loyal
13427,253,1,2294.99,2,1,4,7,Potential
13428,263,2,2316.97,2,1,4,7,Potential
13429,232,4,4587.032499999999,2,4,5,11,Loyal
13430,313,2,30.97,1,1,1,3,At Risk
13431,230,6,4592.5025,2,5,5,12,Loyal
13432,308,2,56.97,1,1,2,4,At Risk
13433,233,4,4533.5225,2,4,5,11,Loyal
13434,108,2,2354.99,4,1,4,9,Potential
13435,227,5,4838.32,2,5,5,12,Loyal
13436,239,3,4498.532499999999,2,3,5,10,Loyal
13437,333,3,80.96000000000001,1,3,2,6,At Risk
13438,232,2,4501.5525,2,1,5,8,Potential
13439,256,2,56.97,2,1,2,5,At Risk
13440,176,5,4818.53,3,5,5,13,Champions
13441,61,2,46.47,5,1,2,8,Potential
13442,223,4,4500.8225,2,4,5,11,Loyal
13443,231,3,4536.5425,2,3,5,10,Loyal
13444,200,2,56.97,3,1,2,6,At Risk
13445,76,2,75.97,4,1,2,7,Potential
13446,224,3,4536.5525,2,3,5,10,Loyal
13447,226,4,4533.5225,2,4,5,11,Loyal
13448,242,1,21.98,2,1,1,4,At Risk
13449,230,5,4526.522499999999,2,5,5,12,Loyal
13450,236,3,4773.33,2,3,5,10,Loyal
13451,103,1,21.98,4,1,1,6,At Risk
13452,243,5,4800.299999999999,2,5,5,12,Loyal
13453,226,5,4576.532499999999,2,5,5,12,Loyal
13454,229,3,2344.2599999999998,2,3,4,9,Potential
13455,233,3,2349.9199999999996,2,3,4,9,Potential
13456,244,5,4582.5125,2,5,5,12,Loyal
13457,177,2,56.97,3,1,2,6,At Risk
13458,356,4,44.91,1,4,2,7,Potential
13459,79,2,56.97,4,1,2,7,Potential
13460,177,4,4693.04,3,4,5,12,Loyal
13461,228,2,4476.5525,2,1,5,8,Potential
13462,55,5,4558.0125,5,5,5,15,Champions
13463,77,3,106.96000000000001,4,3,3,10,Loyal
13464,227,2,4501.5525,2,1,5,8,Potential
13465,69,2,75.97,5,1,2,8,Potential
13466,44,6,133.45,5,5,3,13,Champions
13467,264,1,21.98,2,1,1,4,At Risk
13468,224,6,4626.5225,2,5,5,12,Loyal
13469,13,2,71.97,5,1,2,8,Recent Customer
13470,40,2,56.97,5,1,2,8,Potential
13471,254,2,30.97,2,1,1,4,At Risk
13472,219,4,2518.9799999999996,2,4,4,10,Loyal
13473,234,4,2318.9599999999996,2,4,4,10,Loyal
13474,100,14,339.48,4,5,3,12,Loyal
13475,50,2,56.97,5,1,2,8,Potential
13476,226,2,75.97,2,1,2,5,At Risk
13477,216,3,4511.5425,2,3,5,10,Loyal
13478,239,5,4898.32,2,5,5,12,Loyal
13479,159,2,75.97,3,1,2,6,At Risk
13480,254,3,81.46000000000001,2,3,2,7,Potential
13481,19,2,30.97,5,1,1,7,Recent Customer
13482,53,4,4500.8225,5,4,5,14,Champions
13483,192,2,56.97,3,1,2,6,At Risk
13484,240,5,4813.32,2,5,5,12,Loyal
13485,348,3,36.96,1,3,1,5,At Risk
13486,149,7,225.44,3,5,3,11,Loyal
13487,224,4,4533.5225,2,4,5,11,Loyal
13488,231,2,141.98,2,1,3,6,At Risk
13489,219,3,4740.629999999999,2,3,5,10,Loyal
13490,324,2,56.97,1,1,2,4,At Risk
13491,16,9,176.41,5,5,3,13,Recent Customer
13492,217,5,4500.5225,2,5,5,12,Loyal
13493,280,4,48.96,2,4,2,8,Potential
13494,256,2,39.980000000000004,2,1,1,4,At Risk
13495,286,5,57.95,2,5,2,9,Potential
13496,287,2,36.59,2,1,1,4,At Risk
13497,339,2,39.980000000000004,1,1,1,3,At Risk
13498,163,3,100.09,3,3,3,9,Potential
13499,350,2,133.49,1,1,3,5,At Risk
13500,70,2,39.980000000000004,5,1,1,7,Potential
13501,257,2,39.980000000000004,2,1,1,4,At Risk
13502,164,2,54.980000000000004,3,1,2,6,At Risk
13503,252,5,101.25,2,5,3,10,Loyal
13504,42,5,5923.23,5,5,5,15,Champions
13505,184,7,127.93,3,5,3,11,Loyal
13506,118,2,123.97999999999999,4,1,3,8,Potential
13507,279,3,43.97,2,3,2,7,Potential
13508,359,3,128.97,1,3,3,7,Potential
13509,236,4,48.96,2,4,2,8,Potential
13510,361,2,94.47999999999999,1,1,3,5,At Risk
13511,44,5,6012.23,5,5,5,15,Champions
13512,176,1,69.99,3,1,2,6,At Risk
13513,56,4,5918.24,5,4,5,14,Champions
13514,57,5,5973.24,5,5,5,15,Champions
13515,33,5,5948.24,5,5,5,15,Champions
13516,166,3,43.97,3,3,2,8,Potential
13517,88,9,5666.378199999999,4,5,5,14,Champions
13518,47,4,2638.3582,5,4,4,13,Champions
13519,395,2,4492.4482,1,1,5,7,Potential
13520,337,4,4551.3596,1,4,5,10,Loyal
13521,360,2,4514.7696,1,1,5,7,Potential
13522,218,2,59.980000000000004,2,1,2,5,At Risk
13523,217,4,67.25999999999999,2,4,2,8,Potential
13524,288,4,4528.7496,2,4,5,11,Loyal
13525,254,6,4607.2296,2,5,5,12,Loyal
13526,225,3,4549.7596,2,3,5,10,Loyal
13527,199,4,4529.038199999999,3,4,5,12,Loyal
13528,163,5,4531.0396,3,5,5,13,Champions
13529,171,5,4614.8596,3,5,5,13,Champions
13530,137,3,186.28,3,3,3,9,Potential
13531,146,1,69.99,3,1,2,6,At Risk
13532,126,2,7.28,4,1,1,6,At Risk
13533,52,6,137.94,5,5,3,13,Champions
13534,58,6,86.24000000000001,5,5,2,12,Loyal
13535,102,6,59.2,4,5,2,11,Loyal
13536,39,5,5973.24,5,5,5,15,Champions
13537,38,5,5910.219999999999,5,5,5,15,Champions
13538,56,3,5908.25,5,3,5,13,Champions
13539,92,4,78.96000000000001,4,4,2,10,Loyal
13540,186,9,6528.179999999999,3,5,5,13,Champions
13541,213,9,6536.69,2,5,5,12,Loyal
13542,57,4,5943.24,5,4,5,14,Champions
13543,36,5,5923.23,5,5,5,15,Champions
13544,73,6,108.44,5,5,3,13,Champions
13545,48,3,5908.25,5,3,5,13,Champions
13546,48,4,5918.24,5,4,5,14,Champions
13547,120,5,83.95,4,5,2,11,Loyal
13548,33,3,5908.25,5,3,5,13,Champions
13549,273,2,94.47999999999999,2,1,3,6,At Risk
13550,314,1,69.99,1,1,2,4,At Risk
13551,90,5,5622.9182,4,5,5,14,Champions
13552,44,4,5922.53,5,4,5,14,Champions
13553,72,4,5603.2396,5,4,5,14,Champions
13554,88,4,5641.2496,4,4,5,13,Champions
13555,119,9,6484.45,4,5,5,14,Champions
13556,72,7,6497.209999999999,5,5,5,15,Champions
13557,187,4,4443.3796,3,4,5,12,Loyal
13558,77,6,6500.219999999999,4,5,5,14,Champions
13559,211,7,6508.709999999999,2,5,5,12,Loyal
13560,158,5,6453.23,3,5,5,13,Champions
13561,209,4,4393.3582,2,4,5,11,Loyal
13562,208,2,4369.0882,2,1,5,8,Potential
13563,174,5,5948.23,3,5,5,13,Champions
13564,56,6,5932.219999999999,5,5,5,15,Champions
13565,39,4,4775.629999999999,5,4,5,14,Champions
13566,220,2,13.98,2,1,1,4,At Risk
13567,38,4,5935.549999999999,5,4,5,14,Champions
13568,345,2,119.97999999999999,1,1,3,5,At Risk
13569,243,3,48.970000000000006,2,3,2,7,Potential
13570,32,5,5948.23,5,5,5,15,Champions
13571,366,3,144.46999999999997,1,3,3,7,Potential
13572,51,4,5945.23,5,4,5,14,Champions
13573,261,2,119.97999999999999,2,1,3,6,At Risk
13574,364,2,39.980000000000004,1,1,1,3,At Risk
13575,179,13,9458.182499999999,3,5,5,13,Champions
13576,222,7,8330.789999999999,2,5,5,12,Loyal
13577,166,11,9450.3225,3,5,5,13,Champions
13578,14,2,44.980000000000004,5,1,2,8,Recent Customer
13579,72,10,7295.039999999999,5,5,5,15,Champions
13580,33,7,7285.57,5,5,5,15,Champions
13581,234,8,8374.789999999999,2,5,5,12,Loyal
13582,154,4,77.96000000000001,3,4,2,9,Potential
13583,237,8,8375.289999999999,2,5,5,12,Loyal
13584,187,7,8361.29,3,5,5,13,Champions
13585,194,6,8368.29,3,5,5,13,Champions
13586,42,4,97.96000000000001,5,4,3,12,Loyal
13587,93,3,78.48,4,3,2,9,Potential
13588,74,2,14.98,4,1,1,6,At Risk
13589,162,3,78.48,3,3,2,8,Potential
13590,191,6,8306.3,3,5,5,13,Champions
13591,203,9,8355.269999999999,3,5,5,13,Champions
13592,171,7,9695.73,3,5,5,13,Champions
13593,45,3,49.970000000000006,5,3,2,10,Loyal
13594,185,2,44.980000000000004,3,1,2,6,At Risk
13595,167,9,9390.5325,3,5,5,13,Champions
13596,353,1,9.99,1,1,1,3,At Risk
13597,163,4,58.96000000000001,3,4,2,9,Potential
13598,114,3,49.970000000000006,4,3,2,9,Potential
13599,121,5,51.25,4,5,2,11,Loyal
13600,210,11,8460.25,2,5,5,12,Loyal
13601,26,2,44.980000000000004,5,1,2,8,Recent Customer
13602,213,8,8376.28,2,5,5,12,Loyal
13603,233,6,133.94,2,5,3,10,Loyal
13604,10,8,177.92000000000002,5,5,3,13,Recent Customer
13605,181,7,9614.73,3,5,5,13,Champions
13606,33,6,7195.58,5,5,5,15,Champions
13607,51,5,6465.03,5,5,5,15,Champions
13608,109,3,71.58000000000001,4,3,2,9,Potential
13609,73,4,98.96,5,4,3,12,Loyal
13610,314,2,44.980000000000004,1,1,2,4,At Risk
13611,24,3,38.88,5,3,1,9,Recent Customer
13612,34,5,83.95,5,5,2,12,Loyal
13613,211,4,105.22,2,4,3,9,Potential
13614,105,5,114.21,4,5,3,12,Loyal
13615,98,5,146.91,4,5,3,12,Loyal
13616,83,8,6872.0581999999995,4,5,5,14,Champions
13617,9,5,141.91,5,5,3,13,Recent Customer
13618,62,4,6763.1482,5,4,5,14,Champions
13619,68,8,6808.098199999999,5,5,5,15,Champions
13620,77,7,6848.0682,4,5,5,14,Champions
13621,142,6,167.39999999999998,3,5,3,11,Loyal
13622,89,7,6841.4295999999995,4,5,5,14,Champions
13623,42,6,99.2,5,5,3,13,Champions
13624,21,4,118.96000000000001,5,4,3,12,Recent Customer
13625,92,6,6962.138199999999,4,5,5,14,Champions
13626,77,9,6909.0882,4,5,5,14,Champions
13627,70,6,214.25,5,5,3,13,Champions
13628,125,6,191.25,4,5,3,12,Loyal
13629,71,7,6889.1082,5,5,5,15,Champions
13630,58,8,6824.7296,5,5,5,15,Champions
13631,39,8,6817.1182,5,5,5,15,Champions
13632,43,5,6838.4596,5,5,5,15,Champions
13633,49,6,6803.138199999999,5,5,5,15,Champions
13634,36,7,234.93,5,5,3,13,Champions
13635,34,7,215.74,5,5,3,13,Champions
13636,61,5,6831.7596,5,5,5,15,Champions
13637,38,6,6777.1282,5,5,5,15,Champions
13638,52,7,6832.1182,5,5,5,15,Champions
13639,222,5,188.96,2,5,3,10,Loyal
13640,84,5,71.25,4,5,2,11,Loyal
13641,236,6,144.74,2,5,3,10,Loyal
13642,259,3,79.97,2,3,2,7,Potential
13643,58,6,6799.4496,5,5,5,15,Champions
13644,37,5,6864.4596,5,5,5,15,Champions
13645,44,8,6817.1182,5,5,5,15,Champions
13646,55,8,6843.598199999999,5,5,5,15,Champions
13647,39,5,6793.1482,5,5,5,15,Champions
13648,38,5,6765.4382000000005,5,5,5,15,Champions
13649,45,7,6812.1282,5,5,5,15,Champions
13650,32,5,6768.138199999999,5,5,5,15,Champions
13651,40,7,6812.1182,5,5,5,15,Champions
13652,266,2,30.97,2,1,1,4,At Risk
13653,238,5,4546.7925,2,5,5,12,Loyal
13654,205,2,56.97,3,1,2,6,At Risk
13655,84,1,21.98,4,1,1,6,At Risk
13656,199,2,56.97,3,1,2,6,At Risk
13657,237,5,4819.299999999999,2,5,5,12,Loyal
13658,220,4,4787.61,2,4,5,11,Loyal
13659,238,3,65.96000000000001,2,3,2,7,Potential
13660,168,6,4750.01,3,5,5,13,Champions
13661,176,4,5913.24,3,4,5,12,Loyal
13662,377,3,3021.0424999999996,1,3,4,8,Potential
13663,361,3,15.23,1,3,1,5,At Risk
13664,95,6,210.25,4,5,3,12,Loyal
13665,15,5,83.95,5,5,2,12,Recent Customer
13666,55,3,5900.549999999999,5,3,5,13,Champions
13667,347,3,3001.0425,1,3,4,8,Potential
13668,53,5,114.21,5,5,3,13,Champions
13669,11,5,129.70999999999998,5,5,3,13,Recent Customer
13670,58,5,178.45,5,5,3,13,Champions
13671,1,4,135.23,5,4,3,12,Recent Customer
13672,216,2,119.97999999999999,2,1,3,6,At Risk
13673,73,2,94.47999999999999,5,1,3,9,Potential
13674,269,3,148.46999999999997,2,3,3,8,Potential
13675,82,8,215.23,4,5,3,12,Loyal
13676,162,4,68.87,3,4,2,9,Potential
13677,25,2,39.980000000000004,5,1,1,7,Recent Customer
13678,160,3,5933.25,3,3,5,11,Loyal
13679,181,3,5933.26,3,3,5,11,Loyal
13680,176,5,5948.24,3,5,5,13,Champions
13681,120,3,74.98,4,3,2,9,Potential
13682,230,3,15.23,2,3,1,6,At Risk
13683,108,3,89.97,4,3,2,9,Potential
13684,61,2,39.980000000000004,5,1,1,7,Potential
13685,157,9,6509.69,3,5,5,13,Champions
13686,145,4,6493.24,3,4,5,12,Loyal
13687,154,2,5873.26,3,1,5,9,Potential
13688,214,2,27.279999999999998,2,1,1,4,At Risk
13689,158,2,5898.26,3,1,5,9,Potential
13690,84,6,7162.079999999999,4,5,5,14,Champions
13691,154,5,5976.74,3,5,5,13,Champions
13692,98,1,24.99,4,1,1,6,At Risk
13693,55,6,7171.58,5,5,5,15,Champions
13694,121,5,105.56,4,5,3,12,Loyal
13695,225,1,35.0,2,1,1,4,At Risk
13696,342,3,48.97,1,3,2,6,At Risk
13697,151,7,6485.669999999999,3,5,5,13,Champions
13698,343,3,32.269999999999996,1,3,1,5,At Risk
13699,106,2,75.97,4,1,2,7,Potential
13700,34,4,4525.8225,5,4,5,14,Champions
13701,11,10,169.52,5,5,3,13,Recent Customer
13702,56,3,4478.8425,5,3,5,13,Champions
13703,268,3,74.98,2,3,2,7,Potential
13704,236,4,2736.5325,2,4,4,10,Loyal
13705,159,3,3018.33,3,3,4,10,Loyal
13706,62,4,2337.2699999999995,5,4,4,13,Champions
13707,6,9,189.04,5,5,3,13,Recent Customer
13708,19,9,160.53,5,5,3,13,Recent Customer
13709,79,3,2332.2799999999997,4,3,4,11,Loyal
13710,91,3,2341.4599999999996,4,3,4,11,Loyal
13711,74,3,2380.47,4,3,4,11,Loyal
13712,43,3,4503.8425,5,3,5,13,Champions
13713,40,5,4828.3099999999995,5,5,5,15,Champions
13714,173,5,3033.31,3,5,4,12,Loyal
13715,137,4,2778.5225,3,4,4,11,Loyal
13716,133,5,3078.31,4,5,4,13,Champions
13717,257,3,74.98,2,3,2,7,Potential
13718,128,3,3062.3299999999995,4,3,4,11,Loyal
13719,248,2,1129.48,2,1,3,6,At Risk
13720,138,2,1155.48,3,1,3,7,Potential
13721,121,5,2786.5225,4,5,4,13,Champions
13722,104,6,3102.7999999999997,4,5,4,13,Champions
13723,89,3,74.98,4,3,2,9,Potential
13724,52,2,4476.5525,5,1,5,11,Loyal
13725,40,4,4532.522499999999,5,4,5,14,Champions
13726,47,4,4500.8225,5,4,5,14,Champions
13727,50,3,80.96000000000001,5,3,2,10,Loyal
13728,34,6,4879.799999999999,5,5,5,15,Champions
13729,60,5,4883.82,5,5,5,15,Champions
13730,45,5,4571.0225,5,5,5,15,Champions
13731,6,1,21.98,5,1,1,7,Recent Customer
13732,157,5,108.96000000000001,3,5,3,11,Loyal
13733,55,4,4553.522499999999,5,4,5,14,Champions
13734,56,6,4522.5025,5,5,5,15,Champions
13735,32,4,4516.532499999999,5,4,5,14,Champions
13736,41,3,4478.8425,5,3,5,13,Champions
13737,212,4,39.25,2,4,1,7,Potential
13738,13,1,21.98,5,1,1,7,Recent Customer
13739,158,2,71.97,3,1,2,6,At Risk
13740,153,2,56.97,3,1,2,6,At Risk
13741,386,2,2951.0525,1,1,4,6,At Risk
13742,368,5,2988.3224999999998,1,5,4,10,Loyal
13743,83,2,2349.9799999999996,4,1,4,9,Potential
13744,371,3,2959.0025,1,3,4,8,Potential
13745,385,5,3282.81,1,5,5,11,Loyal
13746,371,5,3250.1099999999997,1,5,4,10,Loyal
13747,374,4,3045.5325,1,4,4,9,Potential
13748,284,2,71.97,2,1,2,5,At Risk
13749,219,1,21.98,2,1,1,4,At Risk
13750,235,2,71.97,2,1,2,5,At Risk
13751,33,9,224.91000000000003,5,5,3,13,Champions
13752,168,2,24.27,3,1,1,5,At Risk
13753,1,3,84.92,5,3,2,10,Recent Customer
13754,42,2,56.97,5,1,2,8,Potential
13755,57,4,45.95,5,4,2,11,Loyal
13756,221,13,298.49,2,5,3,10,Loyal
13757,176,3,86.96000000000001,3,3,2,8,Potential
13758,43,10,284.13,5,5,3,13,Champions
13759,301,4,100.46000000000001,1,4,3,8,Potential
13760,26,11,197.81,5,5,3,13,Recent Customer
13761,219,2,46.47,2,1,2,5,At Risk
13762,24,12,229.0,5,5,3,13,Recent Customer
13763,141,2,30.97,3,1,1,5,At Risk
13764,318,3,74.98,1,3,2,6,At Risk
13765,32,5,7152.09,5,5,5,15,Champions
13766,334,3,3001.0425,1,3,4,8,Potential
13767,47,5,5910.219999999999,5,5,5,15,Champions
13768,81,4,5063.5225,4,4,5,13,Champions
13769,68,5,5085.532499999999,5,5,5,15,Champions
13770,117,5,6428.23,4,5,5,14,Champions
13771,106,10,6535.69,4,5,5,14,Champions
13772,131,3,5928.25,4,3,5,12,Loyal
13773,203,3,42.28,3,3,2,8,Potential
13774,389,4,4392.74,1,4,5,10,Loyal
13775,41,3,68.97,5,3,2,10,Loyal
13776,319,4,70.57,1,4,2,7,Potential
13777,33,7,7147.07,5,5,5,15,Champions
13778,369,3,4397.75,1,3,5,9,Potential
13779,286,6,3063.0025,2,5,4,11,Loyal
13780,66,2,59.489999999999995,5,1,2,8,Potential
13781,225,5,109.96000000000001,2,5,3,10,Loyal
13782,106,9,6512.19,4,5,5,14,Champions
13783,143,4,5955.23,3,4,5,12,Loyal
13784,37,4,7138.099999999999,5,4,5,14,Champions
13785,226,8,121.83000000000001,2,5,3,10,Loyal
13786,178,1,4.99,3,1,1,5,At Risk
13787,258,2,59.980000000000004,2,1,2,5,At Risk
13788,103,7,200.81,4,5,3,12,Loyal
13789,387,3,4397.75,1,3,5,9,Potential
13790,360,3,4397.75,1,3,5,9,Potential
13791,141,6,107.85000000000001,3,5,3,11,Loyal
13792,38,7,7216.079999999999,5,5,5,15,Champions
13793,302,3,3021.0424999999996,1,3,4,8,Potential
13794,48,9,7212.0599999999995,5,5,5,15,Champions
13795,332,3,4357.75,1,3,5,9,Potential
13796,89,2,39.980000000000004,4,1,1,6,At Risk
13797,30,2,7.28,5,1,1,7,Recent Customer
13798,24,6,136.36,5,5,3,13,Recent Customer
13799,297,4,3010.0325000000003,1,4,4,9,Potential
13800,259,3,3262.83,2,3,4,9,Potential
13801,253,3,3262.83,2,3,4,9,Potential
13802,341,5,79.46,1,5,2,8,Potential
13803,170,3,186.28,3,3,3,9,Potential
13804,29,2,27.279999999999998,5,1,1,7,Recent Customer
13805,245,2,28.979999999999997,2,1,1,4,At Risk
13806,246,7,3075.5025,2,5,4,11,Loyal
13807,302,3,4506.76,1,3,5,9,Potential
13808,251,4,4406.74,2,4,5,11,Loyal
13809,286,4,113.96000000000001,2,4,3,9,Potential
13810,41,3,53.47,5,3,2,10,Loyal
13811,215,3,3001.0425,2,3,4,9,Potential
13812,241,3,3262.83,2,3,4,9,Potential
13813,332,3,74.98,1,3,2,6,At Risk
13814,291,7,230.04,1,5,3,9,Potential
13815,123,6,114.55000000000001,4,5,3,12,Loyal
13816,152,9,260.83,3,5,3,11,Loyal
13817,230,1,35.0,2,1,1,4,At Risk
13818,363,2,39.99,1,1,2,4,At Risk
13819,221,1,35.0,2,1,1,4,At Risk
13820,127,3,5908.26,4,3,5,12,Loyal
13821,141,5,5940.539999999999,3,5,5,13,Champions
13822,104,7,6523.209999999999,4,5,5,14,Champions
13823,76,5,5393.3099999999995,4,5,5,14,Champions
13824,101,1,4.99,4,1,1,6,At Risk
13825,157,2,37.29,3,1,1,5,At Risk
13826,84,3,48.970000000000006,4,3,2,9,Potential
13827,196,2,29.479999999999997,3,1,1,5,At Risk
13828,90,3,166.28,4,3,3,10,Loyal
13829,269,4,4380.04,2,4,5,11,Loyal
13830,20,6,284.56,5,5,3,13,Recent Customer
13831,329,1,35.0,1,1,1,3,At Risk
13832,315,2,24.27,1,1,1,3,At Risk
13833,72,3,106.96000000000001,5,3,3,11,Loyal
13834,81,1,21.98,4,1,1,6,At Risk
13835,154,3,36.96,3,3,1,7,Potential
13836,219,4,4380.04,2,4,5,11,Loyal
13837,78,3,89.97,4,3,2,9,Potential
13838,36,6,140.55,5,5,3,13,Champions
13839,224,3,3242.83,2,3,4,9,Potential
13840,185,4,3010.0325000000003,3,4,4,11,Loyal
13841,104,4,6624.599999999999,4,4,5,13,Champions
13842,222,4,4404.7300000000005,2,4,5,11,Loyal
13843,324,2,30.97,1,1,1,3,At Risk
13844,241,3,4355.71,2,3,5,10,Loyal
13845,127,4,5917.24,4,4,5,13,Champions
13846,135,3,5933.25,3,3,5,11,Loyal
13847,149,4,5888.24,3,4,5,12,Loyal
13848,354,4,61.45,1,4,2,7,Potential
13849,384,4,3084.5424999999996,1,4,4,9,Potential
13850,240,2,56.97,2,1,2,5,At Risk
13851,79,4,2331.9499999999994,4,4,4,12,Loyal
13852,62,1,2294.99,5,1,4,10,Loyal
13853,47,2,2329.9799999999996,5,1,4,10,Loyal
13854,354,4,3247.8199999999997,1,4,4,9,Potential
13855,337,5,3095.5225,1,5,4,10,Loyal
13856,347,4,2982.0225,1,4,4,9,Potential
13857,50,4,45.95,5,4,2,11,Loyal
13858,172,4,71.95,3,4,2,9,Potential
13859,36,1,21.98,5,1,1,7,Potential
13860,10,8,122.84,5,5,3,13,Recent Customer
13861,183,1,21.98,3,1,1,5,At Risk
13862,346,3,2986.0424999999996,1,3,4,8,Potential
13863,143,2,71.97,3,1,2,6,At Risk
13864,207,1,21.98,2,1,1,4,At Risk
13865,235,4,4533.522499999999,2,4,5,11,Loyal
13866,236,7,4639.5125,2,5,5,12,Loyal
13867,242,2,56.97,2,1,2,5,At Risk
13868,311,2,30.97,1,1,1,3,At Risk
13869,88,1,21.98,4,1,1,6,At Risk
13870,343,3,3282.8299999999995,1,3,5,9,Potential
13871,340,5,3060.5225,1,5,4,10,Loyal
13872,362,2,180.98,1,1,3,5,At Risk
13873,230,3,4765.629999999999,2,3,5,10,Loyal
13874,189,2,76.97,3,1,2,6,At Risk
13875,5,2,24.27,5,1,1,7,Recent Customer
13876,202,1,21.98,3,1,1,5,At Risk
13877,336,4,3030.0325,1,4,4,9,Potential
13878,45,3,2366.9599999999996,5,3,4,12,Loyal
13879,143,1,21.98,3,1,1,5,At Risk
13880,206,2,71.97,3,1,2,6,At Risk
13881,155,2,71.97,3,1,2,6,At Risk
13882,358,5,3282.81,1,5,5,11,Loyal
13883,364,3,3021.0424999999996,1,3,4,8,Potential
13884,352,6,3043.0024999999996,1,5,4,10,Loyal
13885,241,5,4844.799999999999,2,5,5,12,Loyal
13886,223,3,4536.5425,2,3,5,10,Loyal
13887,232,2,4763.34,2,1,5,8,Potential
13888,92,1,21.98,4,1,1,6,At Risk
13889,338,5,3084.0225,1,5,4,10,Loyal
13890,317,4,2982.0225,1,4,4,9,Potential
13891,267,2,85.48,2,1,2,5,At Risk
13892,332,3,3021.0424999999996,1,3,4,8,Potential
13893,224,1,21.98,2,1,1,4,At Risk
13894,227,6,4810.289999999999,2,5,5,12,Loyal
13895,242,4,4558.5225,2,4,5,11,Loyal
13896,237,4,4775.629999999999,2,4,5,11,Loyal
13897,234,3,4498.532499999999,2,3,5,10,Loyal
13898,233,6,4835.289999999999,2,5,5,12,Loyal
13899,291,1,21.98,1,1,1,3,At Risk
13900,285,1,21.98,2,1,1,4,At Risk
13901,232,3,66.96000000000001,2,3,2,7,Potential
13902,201,1,21.98,3,1,1,5,At Risk
13903,242,3,4511.5425,2,3,5,10,Loyal
13904,218,2,4501.5525,2,1,5,8,Potential
13905,214,4,4548.522499999999,2,4,5,11,Loyal
13906,312,3,3021.0424999999996,1,3,4,8,Potential
13907,240,3,4596.5525,2,3,5,10,Loyal
13908,165,5,4715.33,3,5,5,13,Champions
13909,148,6,4764.0199999999995,3,5,5,13,Champions
13910,230,5,4526.522499999999,2,5,5,12,Loyal
13911,217,4,4548.522499999999,2,4,5,11,Loyal
13912,244,4,4548.022499999999,2,4,5,11,Loyal
13913,205,3,106.96000000000001,3,3,3,9,Potential
13914,278,2,71.97,2,1,2,5,At Risk
13915,333,4,3045.5325,1,4,4,9,Potential
13916,46,2,2354.9799999999996,5,1,4,10,Loyal
13917,334,5,3282.81,1,5,5,11,Loyal
13918,44,5,2397.95,5,5,4,14,Champions
13919,25,2,85.48,5,1,2,8,Recent Customer
13920,92,12,266.97,4,5,3,12,Loyal
13921,117,2,56.97,4,1,2,7,Potential
13922,76,2,56.97,4,1,2,7,Potential
13923,294,2,56.97,1,1,2,4,At Risk
13924,215,2,29.93,2,1,1,4,At Risk
13925,327,3,3220.79,1,3,4,8,Potential
13926,269,2,56.97,2,1,2,5,At Risk
13927,315,3,3021.0424999999996,1,3,4,8,Potential
13928,49,2,85.48,5,1,2,8,Potential
13929,2,2,76.97,5,1,2,8,Recent Customer
13930,93,3,140.47,4,3,3,10,Loyal
13931,184,1,21.98,3,1,1,5,At Risk
13932,84,1,21.98,4,1,1,6,At Risk
13933,337,2,56.97,1,1,2,4,At Risk
13934,54,2,30.97,5,1,1,7,Potential
13935,333,2,56.97,1,1,2,4,At Risk
13936,82,8,218.93,4,5,3,12,Loyal
13937,177,2,85.48,3,1,2,6,At Risk
13938,318,6,3071.0125,1,5,4,10,Loyal
13939,326,5,3084.0225,1,5,4,10,Loyal
13940,174,2,85.48,3,1,2,6,At Risk
13941,41,11,286.82,5,5,3,13,Champions
13942,328,2,56.97,1,1,2,4,At Risk
13943,147,3,36.96,3,3,1,7,Potential
13944,23,10,160.12,5,5,3,13,Recent Customer
13945,320,2,56.97,1,1,2,4,At Risk
13946,15,1,21.98,5,1,1,7,Recent Customer
13947,217,5,4605.0425,2,5,5,12,Loyal
13948,225,4,4562.032499999999,2,4,5,11,Loyal
13949,214,4,4548.522499999999,2,4,5,11,Loyal
13950,124,2,24.27,4,1,1,6,At Risk
13951,125,2,56.97,4,1,2,7,Potential
13952,120,4,82.25999999999999,4,4,2,10,Loyal
13953,41,6,6840.7496,5,5,5,15,Champions
13954,117,4,128.45999999999998,4,4,3,11,Loyal
13955,45,8,6888.4396,5,5,5,15,Champions
13956,100,4,82.25999999999999,4,4,2,10,Loyal
13957,39,5,5645.2396,5,5,5,15,Champions
13958,57,5,6838.638199999999,5,5,5,15,Champions
13959,50,8,6858.4182,5,5,5,15,Champions
13960,37,7,6871.739600000001,5,5,5,15,Champions
13961,13,5,136.94,5,5,3,13,Recent Customer
13962,9,5,90.21,5,5,2,12,Recent Customer
13963,16,5,139.45,5,5,3,13,Recent Customer
13964,43,5,6806.4496,5,5,5,15,Champions
13965,40,9,6872.3896,5,5,5,15,Champions
13966,34,8,6842.1182,5,5,5,15,Champions
13967,32,8,5721.9082,5,5,5,15,Champions
13968,38,9,5181.6996,5,5,5,15,Champions
13969,49,3,77.27,5,3,2,10,Loyal
13970,50,5,6843.138199999999,5,5,5,15,Champions
13971,36,6,6772.1282,5,5,5,15,Champions
13972,35,3,77.27,5,3,2,10,Loyal
13973,51,7,5185.6796,5,5,5,15,Champions
13974,59,7,5237.7296,5,5,5,15,Champions
13975,42,5,5138.718199999999,5,5,5,15,Champions
13976,228,3,4511.5425,2,3,5,10,Loyal
13977,220,6,4788.57,2,5,5,12,Loyal
13978,221,5,4775.299999999999,2,5,5,12,Loyal
13979,307,3,3282.8299999999995,1,3,5,9,Potential
13980,283,2,56.97,2,1,2,5,At Risk
13981,193,5,124.21000000000001,3,5,3,11,Loyal
13982,85,2,59.980000000000004,4,1,2,7,Potential
13983,187,8,180.41,3,5,3,11,Loyal
13984,326,3,3282.8299999999995,1,3,5,9,Potential
13985,282,2,30.97,2,1,1,4,At Risk
13986,312,4,1893.9075,1,4,4,9,Potential
13987,36,2,2329.99,5,1,4,10,Loyal
13988,119,10,195.52,4,5,3,12,Loyal
13989,316,2,46.47,1,1,2,4,At Risk
13990,309,4,1893.9075,1,4,4,9,Potential
13991,88,2,85.48,4,1,2,7,Potential
13992,292,4,1802.2075,1,4,4,9,Potential
13993,298,3,1804.9175,1,3,4,8,Potential
13994,141,4,4528.7496,3,4,5,12,Loyal
13995,73,3,64.97,5,3,2,10,Loyal
13996,213,4,66.26,2,4,2,8,Potential
13997,35,5,4586.3496,5,5,5,15,Champions
13998,99,6,245.25,4,5,3,12,Loyal
13999,221,2,3295.4275,2,1,5,8,Potential
14000,186,3,84.92,3,3,2,8,Potential
14001,174,3,106.96000000000001,3,3,3,9,Potential
14002,320,2,85.48,1,1,2,4,At Risk
14003,121,5,1579.3975,4,5,4,13,Champions
14004,156,2,56.97,3,1,2,6,At Risk
14005,242,5,3319.3974999999996,2,5,5,12,Loyal
14006,241,2,3295.4275,2,1,5,8,Potential
14007,386,2,3772.4096,1,1,5,7,Potential
14008,188,3,63.97,3,3,2,8,Potential
14009,86,3,63.97,4,3,2,9,Potential
14010,336,4,3861.3896,1,4,5,10,Loyal
14011,350,4,3831.8896,1,4,5,10,Loyal
14012,54,7,5249.918199999999,5,5,5,15,Champions
14013,48,5,138.45,5,5,3,13,Champions
14014,88,3,62.269999999999996,4,3,2,9,Potential
14015,98,2,59.980000000000004,4,1,2,7,Potential
14016,146,5,121.06,3,5,3,11,Loyal
14017,304,4,1848.9075,1,4,4,9,Potential
14018,96,4,63.87,4,4,2,10,Loyal
14019,25,3,61.58,5,3,2,10,Recent Customer
14020,50,5,6831.7596,5,5,5,15,Champions
14021,264,1,21.98,2,1,1,4,At Risk
14022,85,6,1668.8975,4,5,4,13,Champions
14023,40,3,1575.4175,5,3,4,12,Loyal
14024,299,5,1902.8975,1,5,4,10,Loyal
14025,55,6,1586.3775,5,5,4,14,Champions
14026,51,4,1589.6975,5,4,4,13,Champions
14027,175,1,21.98,3,1,1,5,At Risk
14028,194,4,91.95,3,4,2,9,Potential
14029,1,2,56.97,5,1,2,8,Recent Customer
14030,50,5,6905.4696,5,5,5,15,Champions
14031,50,8,6964.4182,5,5,5,15,Champions
14032,42,8,6859.4295999999995,5,5,5,15,Champions
14033,45,5,6809.9596,5,5,5,15,Champions
14034,51,5,104.24,5,5,3,13,Champions
14035,186,3,65.96000000000001,3,3,2,8,Potential
14036,302,3,1839.9175,1,3,4,8,Potential
14037,281,5,1898.8975,2,5,4,11,Loyal
14038,43,6,6819.118199999999,5,5,5,15,Champions
14039,55,6,6808.128199999999,5,5,5,15,Champions
14040,231,2,31.97,2,1,1,4,At Risk
14041,145,5,4765.02,3,5,5,13,Champions
14042,48,1,21.98,5,1,1,7,Potential
14043,330,2,56.97,1,1,2,4,At Risk
14044,239,4,3357.7174999999997,2,4,5,11,Loyal
14045,35,5,6804.128199999999,5,5,5,15,Champions
14046,166,5,5645.2396,3,5,5,13,Champions
14047,169,5,5643.5396,3,5,5,13,Champions
14048,52,5,5123.7396,5,5,5,15,Champions
14049,40,9,5290.6796,5,5,5,15,Champions
14050,178,5,5650.2396,3,5,5,13,Champions
14051,170,6,5606.9082,3,5,5,13,Champions
14052,238,4,86.26,2,4,2,8,Potential
14053,355,4,86.26,1,4,2,7,Potential
14054,5,5,280.76,5,5,3,13,Recent Customer
14055,32,6,5177.3982,5,5,5,15,Champions
14056,11,4,128.45999999999998,5,4,3,12,Recent Customer
14057,9,4,114.96000000000001,5,4,3,12,Recent Customer
14058,179,7,5652.5196,3,5,5,13,Champions
14059,209,5,106.75,2,5,3,10,Loyal
14060,97,3,99.47,4,3,3,10,Loyal
14061,305,4,82.25999999999999,1,4,2,7,Potential
14062,166,5,5647.918199999999,3,5,5,13,Champions
14063,180,5,5676.2496,3,5,5,13,Champions
14064,163,8,5694.2096,3,5,5,13,Champions
14065,172,4,5608.5496,3,4,5,12,Loyal
14066,173,8,3612.1882,3,5,5,13,Champions
14067,166,4,114.96000000000001,3,4,3,10,Loyal
14068,163,3,77.27,3,3,2,8,Potential
14069,36,6,173.94,5,5,3,13,Champions
14070,170,4,5618.928199999999,3,4,5,12,Loyal
14071,182,5,5617.9182,3,5,5,13,Champions
14072,164,2,74.98,3,1,2,6,At Risk
14073,100,7,156.84,4,5,3,12,Loyal
14074,247,3,59.88,2,3,2,7,Potential
14075,281,2,56.97,2,1,2,5,At Risk
14076,271,2,71.97,2,1,2,5,At Risk
14077,102,8,180.73,4,5,3,12,Loyal
14078,376,2,839.48,1,1,3,5,At Risk
14079,3,11,223.62,5,5,3,13,Recent Customer
14080,298,4,1848.9075,1,4,4,9,Potential
14081,345,3,3451.7374999999997,1,3,5,9,Potential
14082,46,1,21.98,5,1,1,7,Potential
14083,319,3,2751.4175,1,3,4,8,Potential
14084,155,9,138.68,3,5,3,11,Loyal
14085,280,3,36.96,2,3,1,6,At Risk
14086,9,6,70.15,5,5,2,12,Recent Customer
14087,205,5,341.97,3,5,3,11,Loyal
14088,252,3,2755.4175,2,3,4,9,Potential
14089,287,4,1893.9075,2,4,4,10,Loyal
14090,274,2,85.48,2,1,2,5,At Risk
14091,177,11,251.20000000000002,3,5,3,11,Loyal
14092,143,2,56.97,3,1,2,6,At Risk
14093,159,2,30.97,3,1,1,5,At Risk
14094,278,1,21.98,2,1,1,4,At Risk
14095,293,4,1802.2075,1,4,4,9,Potential
14096,9,12,233.69,5,5,3,13,Recent Customer
14097,188,2,56.97,3,1,2,6,At Risk
14098,292,4,1845.8975,1,4,4,9,Potential
14099,137,5,200.26,3,5,3,11,Loyal
14100,54,5,226.26,5,5,3,13,Champions
14101,169,7,3679.8982,3,5,5,13,Champions
14102,181,6,3667.2296,3,5,5,13,Champions
14103,143,7,3612.2196,3,5,5,13,Champions
14104,303,4,1889.9075,1,4,4,9,Potential
14105,293,4,1784.9075,1,4,4,9,Potential
14106,276,5,1839.8975,2,5,4,11,Loyal
14107,316,4,819.46,1,4,3,8,Potential
14108,296,2,839.48,1,1,3,5,At Risk
14109,167,2,2701.4275,3,1,4,8,Potential
14110,281,4,819.46,2,4,3,9,Potential
14111,182,2,76.97,3,1,2,6,At Risk
14112,240,5,3361.3875,2,5,5,12,Loyal
14113,267,1,21.98,2,1,1,4,At Risk
14114,1,2,85.48,5,1,2,8,Recent Customer
14115,234,3,3297.7174999999997,2,3,5,10,Loyal
14116,222,3,3317.4075,2,3,5,10,Loyal
14117,230,4,3352.3974999999996,2,4,5,11,Loyal
14118,133,4,4741.34,4,4,5,13,Champions
14119,93,7,148.94,4,5,3,12,Loyal
14120,216,5,3376.8874999999994,2,5,5,12,Loyal
14121,235,4,3319.6974999999998,2,4,5,11,Loyal
14122,288,2,30.97,2,1,1,4,At Risk
14123,198,3,61.58,3,3,2,8,Potential
14124,76,2,57.59,4,1,2,7,Potential
14125,350,2,3772.4096,1,1,5,7,Potential
14126,62,6,135.55,5,5,3,13,Champions
14127,324,4,3809.5681999999997,1,4,5,10,Loyal
14128,330,5,3836.3795999999998,1,5,5,11,Loyal
14129,289,2,3750.0882,1,1,5,7,Potential
14130,276,5,3814.0581999999995,2,5,5,12,Loyal
14131,305,3,3807.3996,1,3,5,9,Potential
14132,265,3,3804.0782,2,3,5,10,Loyal
14133,269,4,3764.0681999999997,2,4,5,11,Loyal
14134,271,4,3835.0681999999997,2,4,5,11,Loyal
14135,286,3,86.96000000000001,2,3,2,7,Potential
14136,251,4,71.95,2,4,2,8,Potential
14137,214,3,4397.75,2,3,5,10,Loyal
14138,240,5,4444.22,2,5,5,12,Loyal
14139,217,3,4397.75,2,3,5,10,Loyal
14140,210,3,4397.75,2,3,5,10,Loyal
14141,188,5,3282.81,3,5,5,13,Champions
14142,92,2,29.479999999999997,4,1,1,6,At Risk
14143,12,6,133.55,5,5,3,13,Recent Customer
14144,96,2,56.97,4,1,2,7,Potential
14145,357,2,24.27,1,1,1,3,At Risk
14146,105,8,6750.5599999999995,4,5,5,14,Champions
14147,175,3,4397.75,3,3,5,11,Loyal
14148,174,4,4406.74,3,4,5,12,Loyal
14149,159,3,4417.75,3,3,5,11,Loyal
14150,119,5,6705.589999999999,4,5,5,14,Champions
14151,135,2,85.48,3,1,2,6,At Risk
14152,188,2,71.97,3,1,2,6,At Risk
14153,263,3,48.970000000000006,2,3,2,7,Potential
14154,158,6,3018.0025,3,5,4,12,Loyal
14155,116,3,5993.26,4,3,5,12,Loyal
14156,76,5,229.57,4,5,3,12,Loyal
14157,93,4,6650.599999999999,4,4,5,13,Champions
14158,101,5,5976.74,4,5,5,14,Champions
14159,108,4,5930.23,4,4,5,13,Champions
14160,112,8,6679.699999999999,4,5,5,14,Champions
14161,87,7,6497.21,4,5,5,14,Champions
14162,41,7,6473.699999999999,5,5,5,15,Champions
14163,56,7,6567.0199999999995,5,5,5,15,Champions
14164,55,7,6484.71,5,5,5,15,Champions
14165,113,4,5910.549999999999,4,4,5,13,Champions
14166,349,2,71.97,1,1,2,4,At Risk
14167,175,4,4406.74,3,4,5,12,Loyal
14168,4,4,71.95,5,4,2,11,Recent Customer
14169,164,3,3262.83,3,3,4,10,Loyal
14170,181,4,3291.8199999999997,3,4,5,12,Loyal
14171,48,10,6615.7,5,5,5,15,Champions
14172,133,6,75.74,4,5,2,11,Loyal
14173,249,3,38.88,2,3,1,6,At Risk
14174,341,3,38.88,1,3,1,5,At Risk
14175,16,7,145.23000000000002,5,5,3,13,Recent Customer
14176,233,4,121.57000000000001,2,4,3,9,Potential
14177,52,4,46.830000000000005,5,4,2,11,Loyal
14178,66,3,86.58,5,3,2,10,Loyal
14179,15,3,71.58000000000001,5,3,2,10,Recent Customer
14180,265,1,32.6,2,1,1,4,At Risk
14181,215,5,8326.31,2,5,5,12,Loyal
14182,149,1,32.6,3,1,1,5,At Risk
14183,186,5,8321.31,3,5,5,13,Champions
14184,184,6,105.24000000000001,3,5,3,11,Loyal
14185,182,13,9523.002499999999,3,5,5,13,Champions
14186,170,10,9796.32,3,5,5,13,Champions
14187,53,2,36.59,5,1,1,7,Potential
14188,193,1,32.6,3,1,1,5,At Risk
14189,233,4,8317.32,2,4,5,11,Loyal
14190,197,2,36.59,3,1,1,5,At Risk
14191,198,5,8301.31,3,5,5,13,Champions
14192,179,10,9451.9125,3,5,5,13,Champions
14193,251,2,36.59,2,1,1,4,At Risk
14194,124,7,168.93,4,5,3,12,Loyal
14195,178,7,8316.289999999999,3,5,5,13,Champions
14196,21,6,137.94,5,5,3,13,Recent Customer
14197,113,3,107.08,4,3,3,10,Loyal
14198,236,7,8308.59,2,5,5,12,Loyal
14199,158,6,118.94,3,5,3,11,Loyal
14200,123,10,9421.912499999999,4,5,5,14,Champions
14201,76,1,32.6,4,1,1,6,At Risk
14202,276,1,32.6,2,1,1,4,At Risk
14203,151,9,7081.4625,3,5,5,13,Champions
14204,366,3,71.58000000000001,1,3,2,6,At Risk
14205,316,1,32.6,1,1,1,3,At Risk
14206,20,3,156.59,5,3,3,11,Recent Customer
14207,226,6,8361.3,2,5,5,12,Loyal
14208,195,7,117.43,3,5,3,11,Loyal
14209,80,4,193.97,4,4,3,11,Loyal
14210,154,5,5621.2396,3,5,5,13,Champions
14211,177,7,5662.8982,3,5,5,13,Champions
14212,235,4,82.25999999999999,2,4,2,8,Potential
14213,79,4,86.26,4,4,2,10,Loyal
14214,178,7,5759.868199999999,3,5,5,13,Champions
14215,182,8,5665.888199999999,3,5,5,13,Champions
14216,179,5,5653.9182,3,5,5,13,Champions
14217,209,5,139.45,2,5,3,10,Loyal
14218,164,9,5651.8782,3,5,5,13,Champions
14219,155,8,5744.2196,3,5,5,13,Champions
14220,162,9,5696.1896,3,5,5,13,Champions
14221,154,4,82.25999999999999,3,4,2,9,Potential
14222,46,4,82.25999999999999,5,4,2,11,Loyal
14223,226,5,155.94,2,5,3,10,Loyal
14224,180,5,5621.218199999999,3,5,5,13,Champions
14225,156,5,5603.918199999999,3,5,5,13,Champions
14226,145,6,5656.2396,3,5,5,13,Champions
14227,48,4,114.96000000000001,5,4,3,12,Loyal
14228,21,2,74.98,5,1,2,8,Recent Customer
14229,84,2,74.98,4,1,2,7,Potential
14230,125,7,5661.8982,4,5,5,14,Champions
14231,188,3,83.97,3,3,2,8,Potential
14232,262,3,77.27,2,3,2,7,Potential
14233,187,3,78.97,3,3,2,8,Potential
14234,129,6,5687.719599999999,4,5,5,14,Champions
14235,107,8,5682.1996,4,5,5,14,Champions
14236,95,7,5710.2296,4,5,5,14,Champions
14237,171,5,90.25,3,5,2,10,Loyal
14238,101,7,5642.8982,4,5,5,14,Champions
14239,241,2,3295.4275,2,1,5,8,Potential
14240,216,6,3391.3875,2,5,5,12,Loyal
14241,182,3,84.92,3,3,2,8,Potential
14242,240,4,3351.3974999999996,2,4,5,11,Loyal
14243,298,2,71.97,1,1,2,4,At Risk
14244,40,5,154.95999999999998,5,5,3,13,Champions
14245,364,2,56.97,1,1,2,4,At Risk
14246,333,2,71.97,1,1,2,4,At Risk
14247,19,3,81.46000000000001,5,3,2,10,Recent Customer
14248,127,2,56.97,4,1,2,7,Potential
14249,244,3,96.46000000000001,2,3,3,8,Potential
14250,152,2,30.97,3,1,1,5,At Risk
14251,84,2,71.97,4,1,2,7,Potential
14252,40,3,96.46000000000001,5,3,3,11,Loyal
14253,232,6,3394.8974999999996,2,5,5,12,Loyal
14254,211,3,81.46000000000001,2,3,2,7,Potential
14255,232,4,3379.9074999999993,2,4,5,11,Loyal
14256,233,3,3342.4075,2,3,5,10,Loyal
14257,163,2,85.48,3,1,2,6,At Risk
14258,5,3,80.96000000000001,5,3,2,10,Recent Customer
14259,137,4,3630.9282,3,4,5,12,Loyal
14260,150,6,3716.2296,3,5,5,13,Champions
14261,74,5,5653.9182,4,5,5,14,Champions
14262,53,6,5652.5396,5,5,5,15,Champions
14263,49,5,5647.9282,5,5,5,15,Champions
14264,148,7,5217.7296,3,5,5,13,Champions
14265,24,9,215.22,5,5,3,13,Recent Customer
14266,336,2,56.97,1,1,2,4,At Risk
14267,109,4,2786.4075,4,4,4,12,Loyal
14268,94,3,2736.4175,4,3,4,11,Loyal
14269,128,2,85.48,4,1,2,7,Potential
14270,263,4,1794.1975,2,4,4,10,Loyal
14271,327,1,21.98,1,1,1,3,At Risk
14272,110,5,2765.3975,4,5,4,13,Champions
14273,145,2,71.97,3,1,2,6,At Risk
14274,31,6,121.56,5,5,3,13,Champions
14275,125,6,5158.3682,4,5,5,14,Champions
14276,153,11,5259.3582,3,5,5,13,Champions
14277,145,5,5196.7396,3,5,5,13,Champions
14278,158,5,177.46,3,5,3,11,Loyal
14279,127,7,5137.7082,4,5,5,14,Champions
14280,284,2,56.97,2,1,2,5,At Risk
14281,137,7,4746.3,3,5,5,13,Champions
14282,20,9,195.22,5,5,3,13,Recent Customer
14283,251,3,1799.9175,2,3,4,9,Potential
14284,254,2,1769.9275,2,1,4,7,Potential
14285,267,3,1804.9175,2,3,4,9,Potential
14286,148,7,5234.3982,3,5,5,13,Champions
14287,153,4,5141.428199999999,3,4,5,12,Loyal
14288,226,4,3351.3974999999996,2,4,5,11,Loyal
14289,231,5,3376.8874999999994,2,5,5,12,Loyal
14290,220,4,3377.3974999999996,2,4,5,11,Loyal
14291,166,8,258.44,3,5,3,11,Loyal
14292,217,4,3319.6974999999998,2,4,5,11,Loyal
14293,164,2,46.47,3,1,2,6,At Risk
14294,279,3,81.46000000000001,2,3,2,7,Potential
14295,246,2,56.97,2,1,2,5,At Risk
14296,246,4,45.95,2,4,2,8,Potential
14297,215,4,3335.4174999999996,2,4,5,11,Loyal
14298,222,5,3365.6674999999996,2,5,5,12,Loyal
14299,146,3,5108.7596,3,3,5,11,Loyal
14300,123,8,5322.7296,4,5,5,14,Champions
14301,130,4,5142.7496,4,4,5,13,Champions
14302,141,5,5140.7296,3,5,5,13,Champions
14303,131,5,3636.9082,4,5,5,14,Champions
14304,100,4,3595.9282,4,4,5,13,Champions
14305,116,7,3652.1982,4,5,5,14,Champions
14306,120,6,3653.2296,4,5,5,14,Champions
14307,198,5,196.26,3,5,3,11,Loyal
14308,145,7,5140.3982,3,5,5,13,Champions
14309,86,3,99.47,4,3,3,10,Loyal
14310,136,9,5200.6596,3,5,5,13,Champions
14311,171,5,138.45,3,5,3,11,Loyal
14312,178,4,191.27,3,4,3,10,Loyal
14313,69,7,222.44,5,5,3,13,Champions
14314,173,5,122.95,3,5,3,11,Loyal
14315,116,5,109.71,4,5,3,12,Loyal
14316,96,10,3797.3682,4,5,5,14,Champions
14317,82,4,81.26,4,4,2,10,Loyal
14318,157,5,138.45,3,5,3,11,Loyal
14319,55,5,138.45,5,5,3,13,Champions
14320,133,6,261.95,4,5,3,12,Loyal
14321,4,3,77.27,5,3,2,10,Recent Customer
14322,142,3,5111.4382,3,3,5,11,Loyal
14323,127,7,5222.0196,4,5,5,14,Champions
14324,135,4,5121.4282,3,4,5,12,Loyal
14325,103,7,5152.6982,4,5,5,14,Champions
14326,108,8,5207.6996,4,5,5,14,Champions
14327,72,3,32.22,5,3,1,9,Potential
14328,118,15,308.66,4,5,3,12,Loyal
14329,366,4,91.95,1,4,2,7,Potential
14330,260,4,806.76,2,4,3,9,Potential
14331,128,2,56.97,4,1,2,7,Potential
14332,152,6,102.25,3,5,3,11,Loyal
14333,63,3,81.46000000000001,5,3,2,10,Loyal
14334,262,4,1848.9075,2,4,4,10,Loyal
14335,245,3,1804.9175,2,3,4,9,Potential
14336,260,4,1893.9075,2,4,4,10,Loyal
14337,261,6,1815.1475,2,5,4,11,Loyal
14338,257,5,828.74,2,5,3,10,Loyal
14339,351,4,71.95,1,4,2,7,Potential
14340,24,1,21.98,5,1,1,7,Recent Customer
14341,7,14,244.12,5,5,3,13,Recent Customer
14342,254,3,1804.9175,2,3,4,9,Potential
14343,273,3,1839.9175,2,3,4,9,Potential
14344,38,5,126.95,5,5,3,13,Champions
14345,43,5,3639.9182,5,5,5,15,Champions
14346,59,3,3583.2596000000003,5,3,5,13,Champions
14347,197,4,2900.3896,3,4,4,11,Loyal
14348,190,5,2989.3795999999998,3,5,4,12,Loyal
14349,140,2,56.97,3,1,2,6,At Risk
14350,133,4,71.95,4,4,2,10,Loyal
14351,315,2,56.97,1,1,2,4,At Risk
14352,203,2,85.48,3,1,2,6,At Risk
14353,299,8,128.84,1,5,3,9,Potential
14354,91,3,2755.4175,4,3,4,11,Loyal
14355,260,3,1804.9175,2,3,4,9,Potential
14356,237,4,3352.3974999999996,2,4,5,11,Loyal
14357,232,5,3337.7074999999995,2,5,5,12,Loyal
14358,184,4,45.95,3,4,2,9,Potential
14359,76,8,256.24,4,5,3,12,Loyal
14360,97,2,85.48,4,1,2,7,Potential
14361,23,3,106.96000000000001,5,3,3,11,Recent Customer
14362,261,4,1845.8975,2,4,4,10,Loyal
14363,73,9,192.34,5,5,3,13,Champions
14364,228,4,1893.9075,2,4,4,10,Loyal
14365,216,3,1804.9175,2,3,4,9,Potential
14366,216,4,1897.8775,2,4,4,10,Loyal
14367,234,3,1839.9175,2,3,4,9,Potential
14368,15,2,85.48,5,1,2,8,Recent Customer
14369,207,2,46.47,2,1,2,5,At Risk
14370,188,6,122.56,3,5,3,11,Loyal
14371,25,6,119.86,5,5,3,13,Recent Customer
14372,232,2,24.27,2,1,1,4,At Risk
14373,222,2,75.97,2,1,2,5,At Risk
14374,243,5,3362.7074999999995,2,5,5,12,Loyal
14375,211,2,39.980000000000004,2,1,1,4,At Risk
14376,183,2,71.97,3,1,2,6,At Risk
14377,237,2,3320.4275,2,1,5,8,Potential
14378,242,5,1809.3975,2,5,4,11,Loyal
14379,243,4,1854.9075,2,4,4,10,Loyal
14380,218,3,3330.4275,2,3,5,10,Loyal
14381,226,3,3330.4174999999996,2,3,5,10,Loyal
14382,231,5,3373.9074999999993,2,5,5,12,Loyal
14383,171,2,56.97,3,1,2,6,At Risk
14384,115,3,93.97,4,3,3,10,Loyal
14385,222,3,1777.8775,2,3,4,9,Potential
14386,220,5,1918.3975,2,5,4,11,Loyal
14387,272,4,898.46,2,4,3,9,Potential
14388,246,3,81.46000000000001,2,3,2,7,Potential
14389,91,2,7.28,4,1,1,6,At Risk
14390,87,2,39.980000000000004,4,1,1,6,At Risk
14391,127,1,21.98,4,1,1,6,At Risk
14392,184,2,3295.4275,3,1,5,9,Potential
14393,122,2,31.97,4,1,1,6,At Risk
14394,191,4,3344.6974999999998,3,4,5,12,Loyal
14395,104,3,96.46000000000001,4,3,3,10,Loyal
14396,196,3,76.96000000000001,3,3,2,8,Potential
14397,4,2,39.980000000000004,5,1,1,7,Recent Customer
14398,216,3,1804.9175,2,3,4,9,Potential
14399,292,1,4.99,1,1,1,3,At Risk
14400,199,5,3357.3974999999996,3,5,5,13,Champions
14401,252,3,15.23,2,3,1,6,At Risk
14402,29,2,39.980000000000004,5,1,1,7,Recent Customer
14403,47,2,7.28,5,1,1,7,Potential
14404,341,1,4.99,1,1,1,3,At Risk
14405,130,3,64.47,4,3,2,9,Potential
14406,235,5,1851.3875,2,5,4,11,Loyal
14407,26,3,64.47,5,3,2,10,Recent Customer
14408,54,3,65.96000000000001,5,3,2,10,Loyal
14409,212,2,85.48,2,1,2,5,At Risk
14410,64,2,56.97,5,1,2,8,Potential
14411,185,4,3360.4174999999996,3,4,5,12,Loyal
14412,207,2,3320.4275,2,1,5,8,Potential
14413,240,4,1889.9075,2,4,4,10,Loyal
14414,214,5,1793.8975,2,5,4,11,Loyal
14415,216,2,1769.9275,2,1,4,7,Potential
14416,254,1,769.49,2,1,3,6,At Risk
14417,227,4,1848.9075,2,4,4,10,Loyal
14418,238,3,1928.9275,2,3,4,9,Potential
14419,197,4,3371.3974999999996,3,4,5,12,Loyal
14420,212,2,3320.4275,2,1,5,8,Potential
14421,190,5,3369.4074999999993,3,5,5,13,Champions
14422,298,3,38.88,1,3,1,5,At Risk
14423,259,9,141.91,2,5,3,10,Loyal
14424,126,7,6998.862499999999,4,5,5,14,Champions
14425,232,6,8332.3,2,5,5,12,Loyal
14426,227,6,8319.3,2,5,5,12,Loyal
14427,155,10,8451.259999999998,3,5,5,13,Champions
14428,200,5,8321.31,3,5,5,13,Champions
14429,166,6,8394.289999999999,3,5,5,13,Champions
14430,119,2,30.97,4,1,1,6,At Risk
14431,15,1,21.98,5,1,1,7,Recent Customer
14432,139,1,21.98,3,1,1,5,At Risk
14433,206,3,3342.4075,3,3,5,11,Loyal
14434,208,4,3396.3974999999996,2,4,5,11,Loyal
14435,170,3,80.96000000000001,3,3,2,8,Potential
14436,126,6,4776.009999999999,4,5,5,14,Champions
14437,42,1,21.98,5,1,1,7,Potential
14438,187,4,3352.3974999999996,3,4,5,12,Loyal
14439,194,5,3312.6974999999993,3,5,5,13,Champions
14440,194,6,3367.3774999999996,3,5,5,13,Champions
14441,281,2,141.98,2,1,3,6,At Risk
14442,196,5,3370.4074999999993,3,5,5,13,Champions
14443,314,1,21.98,1,1,1,3,At Risk
14444,219,2,30.97,2,1,1,4,At Risk
14445,298,4,100.46000000000001,1,4,3,8,Potential
14446,68,6,146.75,5,5,3,13,Champions
14447,203,5,3385.3974999999996,3,5,5,13,Champions
14448,190,5,3370.4074999999993,3,5,5,13,Champions
14449,211,3,3355.4174999999996,2,3,5,10,Loyal
14450,251,2,180.98,2,1,3,6,At Risk
14451,202,5,3362.7074999999995,3,5,5,13,Champions
14452,205,4,3377.3974999999996,3,4,5,12,Loyal
14453,189,5,3401.3875,3,5,5,13,Champions
14454,302,2,31.97,1,1,1,3,At Risk
14455,77,8,218.93,4,5,3,12,Loyal
14456,212,4,3405.9075,2,4,5,11,Loyal
14457,187,5,3359.8974999999996,3,5,5,13,Champions
14458,137,6,133.95,3,5,3,11,Loyal
14459,137,6,4775.01,3,5,5,13,Champions
14460,56,3,96.46000000000001,5,3,3,11,Loyal
14461,200,4,3310.4074999999993,3,4,5,12,Loyal
14462,134,1,21.98,3,1,1,5,At Risk
14463,327,3,67.93,1,3,2,6,At Risk
14464,210,4,3357.7174999999997,2,4,5,11,Loyal
14465,355,2,7.28,1,1,1,3,At Risk
14466,108,3,90.47,4,3,2,9,Potential
14467,264,2,39.980000000000004,2,1,1,4,At Risk
14468,352,2,7.28,1,1,1,3,At Risk
14469,304,3,64.47,1,3,2,6,At Risk
14470,203,5,3382.3974999999996,3,5,5,13,Champions
14471,202,3,3355.4275,3,3,5,11,Loyal
14472,186,5,3503.6974999999998,3,5,5,13,Champions
14473,189,4,3413.9174999999996,3,4,5,12,Loyal
14474,1,2,7.28,5,1,1,7,Recent Customer
14475,287,2,7.28,2,1,1,4,At Risk
14476,156,2,7.28,3,1,1,5,At Risk
14477,186,3,3342.4075,3,3,5,11,Loyal
14478,147,6,4795.01,3,5,5,13,Champions
14479,48,3,81.96000000000001,5,3,2,10,Loyal
14480,89,7,194.94,4,5,3,12,Loyal
14481,185,4,3360.4174999999996,3,4,5,12,Loyal
14482,24,3,89.97,5,3,2,10,Recent Customer
14483,258,2,39.980000000000004,2,1,1,4,At Risk
14484,211,5,3345.3974999999996,2,5,5,12,Loyal
14485,201,5,3312.6974999999993,3,5,5,13,Champions
14486,213,4,3310.4074999999993,2,4,5,11,Loyal
14487,234,2,39.980000000000004,2,1,1,4,At Risk
14488,112,3,67.93,4,3,2,9,Potential
14489,94,2,39.980000000000004,4,1,1,6,At Risk
14490,56,2,39.980000000000004,5,1,1,7,Potential
14491,248,3,127.28,2,3,3,8,Potential
14492,284,2,7.28,2,1,1,4,At Risk
14493,55,4,54.96000000000001,5,4,2,11,Loyal
14494,234,2,1769.9275,2,1,4,7,Potential
14495,220,3,1839.9175,2,3,4,9,Potential
14496,239,2,804.48,2,1,3,6,At Risk
14497,242,2,804.48,2,1,3,6,At Risk
14498,204,6,3394.3874999999994,3,5,5,13,Champions
14499,91,3,15.23,4,3,1,8,Potential
14500,14,3,64.47,5,3,2,10,Recent Customer
14501,200,2,2994.0881999999997,3,1,4,8,Potential
14502,122,5,122.25999999999999,4,5,3,12,Loyal
14503,256,2,39.980000000000004,2,1,1,4,At Risk
14504,7,7,162.24,5,5,3,13,Recent Customer
14505,349,3,61.96,1,3,2,6,At Risk
14506,77,2,39.980000000000004,4,1,1,6,At Risk
14507,351,2,39.980000000000004,1,1,1,3,At Risk
14508,246,2,54.980000000000004,2,1,2,5,At Risk
14509,122,2,163.99,4,1,3,8,Potential
14510,190,5,3036.3681999999994,3,5,4,12,Loyal
14511,299,3,89.97,1,3,2,6,At Risk
14512,357,2,39.980000000000004,1,1,1,3,At Risk
14513,101,1,4.99,4,1,1,6,At Risk
14514,3,2,141.98,5,1,3,9,Recent Customer
14515,106,2,56.97,4,1,2,7,Potential
14516,200,2,78.98,3,1,2,6,At Risk
14517,101,3,82.97,4,3,2,9,Potential
14518,181,5,126.95,3,5,3,11,Loyal
14519,322,3,80.96000000000001,1,3,2,6,At Risk
14520,236,3,1503.5782,2,3,4,9,Potential
14521,77,4,117.96000000000001,4,4,3,11,Loyal
14522,127,5,126.95,4,5,3,12,Loyal
14523,240,3,3807.3996,2,3,5,10,Loyal
14524,177,3,3001.0425,3,3,4,10,Loyal
14525,95,6,6665.58,4,5,5,14,Champions
14526,228,2,29.479999999999997,2,1,1,4,At Risk
14527,80,1,4.99,4,1,1,6,At Risk
14528,186,1,4.99,3,1,1,5,At Risk
14529,38,6,254.06,5,5,3,13,Champions
14530,76,5,72.86,4,5,2,11,Loyal
14531,307,7,190.54000000000002,1,5,3,9,Potential
14532,320,1,21.98,1,1,1,3,At Risk
14533,30,6,160.55,5,5,3,13,Recent Customer
14534,86,3,36.96,4,3,1,8,Potential
14535,318,3,123.47,1,3,3,7,Potential
14536,210,2,68.49,2,1,2,5,At Risk
14537,206,3,42.28,3,3,2,8,Potential
14538,136,5,3017.0125,3,5,4,12,Loyal
14539,123,4,3271.8199999999997,4,4,4,12,Loyal
14540,148,5,156.25,3,5,3,11,Loyal
14541,132,3,4397.75,4,3,5,12,Loyal
14542,116,5,115.25,4,5,3,12,Loyal
14543,208,3,42.28,2,3,2,7,Potential
14544,263,2,39.980000000000004,2,1,1,4,At Risk
14545,15,4,112.96,5,4,3,12,Recent Customer
14546,28,3,152.97,5,3,3,11,Recent Customer
14547,37,5,192.95,5,5,3,13,Champions
14548,89,2,124.99,4,1,3,8,Potential
14549,166,3,74.98,3,3,2,8,Potential
14550,144,3,48.97,3,3,2,8,Potential
14551,40,4,111.96000000000001,5,4,3,12,Loyal
14552,69,3,103.97,5,3,3,11,Loyal
14553,278,5,147.95,2,5,3,10,Loyal
14554,173,5,178.45,3,5,3,11,Loyal
14555,103,5,3021.0225,4,5,4,13,Champions
14556,125,3,19.97,4,3,1,8,Potential
14557,6,4,117.96000000000001,5,4,3,12,Recent Customer
14558,232,4,1528.0682,2,4,4,10,Loyal
14559,240,4,1547.5682,2,4,4,10,Loyal
14560,242,3,1538.5782,2,3,4,9,Potential
14561,79,8,158.84,4,5,3,12,Loyal
14562,255,2,7.28,2,1,1,4,At Risk
14563,189,2,39.980000000000004,3,1,1,5,At Risk
14564,41,2,124.99,5,1,3,9,Potential
14565,220,3,1503.5782,2,3,4,9,Potential
14566,122,13,401.49,4,5,3,12,Loyal
14567,54,10,161.28,5,5,3,13,Champions
14568,297,4,54.96000000000001,1,4,2,7,Potential
14569,99,2,7.28,4,1,1,6,At Risk
14570,269,2,39.980000000000004,2,1,1,4,At Risk
14571,161,3,89.97,3,3,2,8,Potential
14572,191,3,3016.0681999999997,3,3,4,10,Loyal
14573,125,2,39.980000000000004,4,1,1,6,At Risk
14574,64,11,177.6,5,5,3,13,Champions
14575,6,3,185.97,5,3,3,11,Recent Customer
14576,202,3,1476.5382,3,3,4,10,Loyal
14577,204,5,1505.8582000000001,3,5,4,12,Loyal
14578,215,3,848.47,2,3,3,8,Potential
14579,332,2,124.99,1,1,3,5,At Risk
14580,212,2,1468.5882000000001,2,1,4,7,Potential
14581,212,6,1563.0482,2,5,4,11,Loyal
14582,66,9,111.79,5,5,3,13,Champions
14583,26,1,4.99,5,1,1,7,Recent Customer
14584,195,6,3040.0382,3,5,4,12,Loyal
14585,190,3,3016.0681999999997,3,3,4,10,Loyal
14586,40,7,233.94,5,5,3,13,Champions
14587,247,2,7.28,2,1,1,4,At Risk
14588,131,2,39.980000000000004,4,1,1,6,At Risk
14589,198,2,1468.5882000000001,3,1,4,8,Potential
14590,199,5,1597.5582,3,5,4,12,Loyal
14591,204,4,1500.8682,3,4,4,11,Loyal
14592,241,1,4.99,2,1,1,4,At Risk
14593,226,2,7.28,2,1,1,4,At Risk
14594,276,2,163.99,2,1,3,6,At Risk
14595,91,2,39.980000000000004,4,1,1,6,At Risk
14596,191,5,3056.0481999999997,3,5,4,12,Loyal
14597,100,7,4803.3099999999995,4,5,5,14,Champions
14598,108,8,4839.0,4,5,5,14,Champions
14599,205,3,3054.0782,3,3,4,10,Loyal
14600,141,2,39.980000000000004,3,1,1,5,At Risk
14601,202,4,3076.0582,3,4,4,11,Loyal
14602,207,6,3150.5382,2,5,4,11,Loyal
14603,185,4,3034.0681999999997,3,4,4,11,Loyal
14604,269,6,137.95,2,5,3,10,Loyal
14605,111,6,4750.01,4,5,5,14,Champions
14606,105,5,4716.0199999999995,4,5,5,14,Champions
14607,80,1,4.99,4,1,1,6,At Risk
14608,283,2,39.980000000000004,2,1,1,4,At Risk
14609,224,1,4.99,2,1,1,4,At Risk
14610,187,2,1468.5882000000001,3,1,4,8,Potential
14611,108,8,304.55,4,5,3,12,Loyal
14612,56,2,39.980000000000004,5,1,1,7,Potential
14613,206,5,1601.5582,3,5,4,12,Loyal
14614,195,6,1645.5482000000002,3,5,4,12,Loyal
14615,91,4,28.96,4,4,1,9,Potential
14616,206,3,1538.5782,3,3,4,10,Loyal
14617,200,5,1538.5582,3,5,4,12,Loyal
14618,121,2,39.980000000000004,4,1,1,6,At Risk
14619,99,2,39.980000000000004,4,1,1,6,At Risk
14620,181,1,4.99,3,1,1,5,At Risk
14621,40,3,103.48,5,3,3,11,Loyal
14622,261,4,28.96,2,4,1,7,Potential
14623,329,3,64.47,1,3,2,6,At Risk
14624,93,2,39.980000000000004,4,1,1,6,At Risk
14625,92,2,7.28,4,1,1,6,At Risk
14626,37,8,197.04,5,5,3,13,Champions
14627,214,2,7.28,2,1,1,4,At Risk
14628,112,1,4.99,4,1,1,6,At Risk
14629,328,1,4.99,1,1,1,3,At Risk
14630,88,1,4.99,4,1,1,6,At Risk
14631,197,3,848.47,3,3,3,9,Potential
14632,22,7,156.55,5,5,3,13,Recent Customer
14633,90,11,242.50000000000003,4,5,3,12,Loyal
14634,187,3,1538.5782,3,3,4,10,Loyal
14635,174,4,37.21,3,4,1,8,Potential
14636,203,3,1538.5782,3,3,4,10,Loyal
14637,127,2,39.980000000000004,4,1,1,6,At Risk
14638,42,2,26.97,5,1,1,7,Potential
14639,198,4,1547.5682,3,4,4,11,Loyal
14640,186,4,812.42,3,4,3,10,Loyal
14641,105,6,119.86,4,5,3,12,Loyal
14642,248,2,7.28,2,1,1,4,At Risk
14643,162,5,1613.0582,3,5,4,12,Loyal
14644,353,2,7.28,1,1,1,3,At Risk
14645,165,3,1538.5782,3,3,4,10,Loyal
14646,180,5,1538.5582,3,5,4,12,Loyal
14647,159,4,1588.5682,3,4,4,11,Loyal
14648,211,4,3024.0181999999995,2,4,4,10,Loyal
14649,180,5,1601.5582,3,5,4,12,Loyal
14650,162,3,1538.5782,3,3,4,10,Loyal
14651,168,4,1588.5682,3,4,4,11,Loyal
14652,155,4,1528.0682,3,4,4,11,Loyal
14653,177,4,1547.5682,3,4,4,11,Loyal
14654,303,2,7.28,1,1,1,3,At Risk
14655,264,5,174.95999999999998,2,5,3,10,Loyal
14656,200,5,3084.0582,3,5,4,12,Loyal
14657,205,4,3076.0582,3,4,4,11,Loyal
14658,85,6,92.82000000000001,4,5,3,12,Loyal
14659,247,2,39.980000000000004,2,1,1,4,At Risk
14660,172,4,1588.5682,3,4,4,11,Loyal
14661,178,10,195.02,3,5,3,11,Loyal
14662,171,4,1602.0782,3,4,4,11,Loyal
14663,74,5,104.95,4,5,3,12,Loyal
14664,194,5,3100.5481999999997,3,5,4,12,Loyal
14665,200,4,81.26,3,4,2,9,Potential
14666,111,6,5199.918199999999,4,5,5,14,Champions
14667,102,7,5295.4082,4,5,5,14,Champions
14668,95,7,5216.6896,4,5,5,14,Champions
14669,60,5,90.25,5,5,2,12,Loyal
14670,209,4,2919.8896,2,4,4,10,Loyal
14671,172,6,2934.3696,3,5,4,12,Loyal
14672,75,8,5237.719599999999,4,5,5,14,Champions
14673,62,4,5117.7496,5,4,5,14,Champions
14674,73,4,142.47,5,4,3,12,Loyal
14675,24,4,237.97,5,4,3,12,Recent Customer
14676,77,5,5188.4082,4,5,5,14,Champions
14677,34,4,81.26,5,4,2,11,Loyal
14678,18,5,167.95,5,5,3,13,Recent Customer
14679,14,4,87.96000000000001,5,4,2,11,Recent Customer
14680,1,5,163.95,5,5,3,13,Recent Customer
14681,85,6,5178.3982,4,5,5,14,Champions
14682,54,5,138.45,5,5,3,13,Champions
14683,124,5,98.95,4,5,3,12,Loyal
14684,24,6,93.54,5,5,3,13,Recent Customer
14685,99,6,146.74,4,5,3,12,Loyal
14686,81,5,203.46,4,5,3,12,Loyal
14687,143,3,80.96000000000001,3,3,2,8,Potential
14688,340,3,74.98,1,3,2,6,At Risk
14689,31,1,4.99,5,1,1,7,Potential
14690,40,4,128.97,5,4,3,12,Loyal
14691,149,3,89.97,3,3,2,8,Potential
14692,18,4,106.25999999999999,5,4,3,12,Recent Customer
14693,115,2,39.980000000000004,4,1,1,6,At Risk
14694,239,6,156.94,2,5,3,10,Loyal
14695,87,3,48.980000000000004,4,3,2,9,Potential
14696,292,3,42.28,1,3,2,6,At Risk
14697,121,6,6684.58,4,5,5,14,Champions
14698,48,4,60.95,5,4,2,11,Loyal
14699,207,2,78.98,2,1,2,5,At Risk
14700,106,4,5904.23,4,4,5,13,Champions
14701,116,5,3001.0225,4,5,4,13,Champions
14702,115,7,6729.57,4,5,5,14,Champions
14703,346,3,42.28,1,3,2,6,At Risk
14704,359,5,95.94,1,5,3,9,Potential
14705,93,3,5875.549999999999,4,3,5,12,Loyal
14706,145,1,24.99,3,1,1,5,At Risk
14707,351,2,37.29,1,1,1,3,At Risk
14708,94,4,2966.0325,4,4,4,12,Loyal
14709,143,3,4397.75,3,3,5,11,Loyal
14710,111,2,39.99,4,1,2,7,Potential
14711,308,2,71.97,1,1,2,4,At Risk
14712,117,5,6660.589999999999,4,5,5,14,Champions
14713,56,7,6461.709999999999,5,5,5,15,Champions
14714,33,8,5386.28,5,5,5,15,Champions
14715,118,3,31.27,4,3,1,8,Potential
14716,51,6,5300.259999999999,5,5,5,15,Champions
14717,265,5,113.96000000000001,2,5,3,10,Loyal
14718,329,3,63.97,1,3,2,6,At Risk
14719,37,10,5512.259999999999,5,5,5,15,Champions
14720,96,3,5900.549999999999,4,3,5,12,Loyal
14721,48,1,4.99,5,1,1,7,Potential
14722,178,2,1468.5882000000001,3,1,4,8,Potential
14723,223,5,87.57000000000001,2,5,2,9,Potential
14724,18,10,120.41000000000001,5,5,3,13,Recent Customer
14725,51,10,318.83,5,5,3,13,Champions
14726,161,4,1483.5682,3,4,4,11,Loyal
14727,169,4,1563.0682,3,4,4,11,Loyal
14728,159,4,1563.0682,3,4,4,11,Loyal
14729,200,1,4.99,3,1,1,5,At Risk
14730,33,5,2588.0682,5,5,4,14,Champions
14731,52,3,2435.0782,5,3,4,12,Loyal
14732,56,3,2450.0782,5,3,4,12,Loyal
14733,338,3,1854.5782,1,3,4,8,Potential
14734,335,3,1854.5782,1,3,4,8,Potential
14735,317,3,1854.5782,1,3,4,8,Potential
14736,334,2,85.48,1,1,2,4,At Risk
14737,260,3,1873.5782,2,3,4,9,Potential
14738,151,3,1503.5782,3,3,4,10,Loyal
14739,135,4,1500.8682,3,4,4,11,Loyal
14740,147,5,1533.5582,3,5,4,12,Loyal
14741,132,4,1588.5682,4,4,4,12,Loyal
14742,165,2,7.28,3,1,1,5,At Risk
14743,207,3,64.47,2,3,2,7,Potential
14744,130,5,1505.8582000000001,4,5,4,13,Champions
14745,185,4,902.46,3,4,3,10,Loyal
14746,138,4,1588.5682,3,4,4,11,Loyal
14747,123,3,1503.5782,4,3,4,11,Loyal
14748,182,2,124.99,3,1,3,7,Potential
14749,319,4,98.96000000000001,1,4,3,8,Potential
14750,129,5,1613.0582,4,5,4,13,Champions
14751,213,2,7.28,2,1,1,4,At Risk
14752,131,4,1528.0682,4,4,4,12,Loyal
14753,128,2,1468.5882000000001,4,1,4,9,Potential
14754,127,4,1500.8682,4,4,4,12,Loyal
14755,123,4,1592.5682,4,4,4,12,Loyal
14756,148,4,1588.5682,3,4,4,11,Loyal
14757,143,3,1538.5782,3,3,4,10,Loyal
14758,270,2,39.980000000000004,2,1,1,4,At Risk
14759,18,2,7.28,5,1,1,7,Recent Customer
14760,48,5,167.26,5,5,3,13,Champions
14761,360,2,39.980000000000004,1,1,1,3,At Risk
14762,216,1,4.99,2,1,1,4,At Risk
14763,163,1,4.99,3,1,1,5,At Risk
14764,53,2,7.28,5,1,1,7,Potential
14765,20,6,119.86000000000001,5,5,3,13,Recent Customer
14766,65,1,4.99,5,1,1,7,Potential
14767,122,2,29.93,4,1,1,6,At Risk
14768,242,3,106.96000000000001,2,3,3,8,Potential
14769,120,3,4397.75,4,3,5,12,Loyal
14770,110,5,6679.59,4,5,5,14,Champions
14771,104,6,6689.58,4,5,5,14,Champions
14772,97,4,4380.04,4,4,5,13,Champions
14773,214,5,7015.612499999999,2,5,5,12,Loyal
14774,53,4,6434.74,5,4,5,14,Champions
14775,238,8,8404.279999999999,2,5,5,12,Loyal
14776,114,3,5908.25,4,3,5,12,Loyal
14777,98,5,5923.23,4,5,5,14,Champions
14778,73,7,6673.53,5,5,5,15,Champions
14779,105,3,3262.83,4,3,4,11,Loyal
14780,94,2,7.28,4,1,1,6,At Risk
14781,45,2,56.97,5,1,2,8,Potential
14782,344,3,66.96000000000001,1,3,2,6,At Risk
14783,129,4,158.95999999999998,4,4,3,11,Loyal
14784,55,5,156.25,5,5,3,13,Champions
14785,25,3,48.97,5,3,2,10,Recent Customer
14786,171,3,66.96000000000001,3,3,2,8,Potential
14787,61,5,163.45,5,5,3,13,Champions
14788,332,1,4.99,1,1,1,3,At Risk
14789,105,4,4382.74,4,4,5,13,Champions
14790,226,8,7004.5725,2,5,5,12,Loyal
14791,221,9,7210.849999999999,2,5,5,12,Loyal
14792,93,4,5913.24,4,4,5,13,Champions
14793,99,5,5948.24,4,5,5,14,Champions
14794,78,2,5873.26,4,1,5,10,Loyal
14795,108,4,4380.04,4,4,5,13,Champions
14796,65,6,3071.0125,5,5,4,14,Champions
14797,96,3,4397.75,4,3,5,12,Loyal
14798,69,3,3001.0425,5,3,4,12,Loyal
14799,262,5,162.95,2,5,3,10,Loyal
14800,92,5,4390.69,4,5,5,14,Champions
14801,80,4,4382.74,4,4,5,13,Champions
14802,86,4,3287.3199999999997,4,4,5,13,Champions
14803,91,3,4355.71,4,3,5,12,Loyal
14804,185,4,138.95999999999998,3,4,3,10,Loyal
14805,221,3,101.46000000000001,2,3,3,8,Potential
14806,230,6,242.94,2,5,3,10,Loyal
14807,129,2,39.980000000000004,4,1,1,6,At Risk
14808,81,6,164.2,4,5,3,12,Loyal
14809,180,5,115.25,3,5,3,11,Loyal
14810,239,2,39.99,2,1,2,5,At Risk
14811,318,3,36.93,1,3,1,5,At Risk
14812,245,3,63.97,2,3,2,7,Potential
14813,46,5,3341.81,5,5,5,15,Champions
14814,327,4,128.45999999999998,1,4,3,8,Potential
14815,76,3,63.97,4,3,2,9,Potential
14816,51,3,63.97,5,3,2,10,Loyal
14817,156,3,63.97,3,3,2,8,Potential
14818,58,5,2973.9825,5,5,4,14,Champions
14819,69,3,4355.71,5,3,5,13,Champions
14820,349,3,37.269999999999996,1,3,1,5,At Risk
14821,319,1,29.99,1,1,1,3,At Risk
14822,67,3,4397.75,5,3,5,13,Champions
14823,63,4,4392.74,5,4,5,14,Champions
14824,81,4,4441.25,4,4,5,13,Champions
14825,224,4,61.45,2,4,2,8,Potential
14826,167,2,39.980000000000004,3,1,1,5,At Risk
14827,49,4,4467.74,5,4,5,14,Champions
14828,290,2,75.97,1,1,2,4,At Risk
14829,230,3,90.47,2,3,2,7,Potential
14830,244,8,8346.279999999999,2,5,5,12,Loyal
14831,77,5,5912.73,4,5,5,14,Champions
14832,80,4,5938.24,4,4,5,13,Champions
14833,82,5,6679.599999999999,4,5,5,14,Champions
14834,51,3,4397.75,5,3,5,13,Champions
14835,234,3,80.96000000000001,2,3,2,7,Potential
14836,164,5,115.25,3,5,3,11,Loyal
14837,73,4,116.95000000000002,5,4,3,12,Loyal
14838,36,5,4414.72,5,5,5,15,Champions
14839,235,5,156.25,2,5,3,10,Loyal
14840,139,4,157.95999999999998,3,4,3,10,Loyal
14841,149,2,85.48,3,1,2,6,At Risk
14842,327,5,99.94,1,5,3,9,Potential
14843,64,6,6690.58,5,5,5,15,Champions
14844,106,2,85.48,4,1,2,7,Potential
14845,347,2,7.28,1,1,1,3,At Risk
14846,80,7,6744.57,4,5,5,14,Champions
14847,71,7,6725.57,5,5,5,15,Champions
14848,351,2,2746.5525,1,1,4,6,At Risk
14849,303,2,56.97,1,1,2,4,At Risk
14850,165,2,39.980000000000004,3,1,1,5,At Risk
14851,340,7,2802.4925,1,5,4,10,Loyal
14852,139,2,1468.5882000000001,3,1,4,8,Potential
14853,58,3,37.97,5,3,1,9,Potential
14854,159,4,72.96000000000001,3,4,2,9,Potential
14855,234,3,3759.0782,2,3,5,10,Loyal
14856,14,2,39.980000000000004,5,1,1,7,Recent Customer
14857,249,3,87.97,2,3,2,7,Potential
14858,88,4,196.97,4,4,3,11,Loyal
14859,17,4,40.26,5,4,2,11,Recent Customer
14860,219,4,67.26,2,4,2,8,Potential
14861,88,5,5976.74,4,5,5,14,Champions
14862,155,2,32.28,3,1,1,5,At Risk
14863,320,2,32.28,1,1,1,3,At Risk
14864,113,3,69.97,4,3,2,9,Potential
14865,309,1,29.99,1,1,1,3,At Risk
14866,356,3,31.27,1,3,1,5,At Risk
14867,201,2,839.48,3,1,3,7,Potential
14868,94,5,1597.5582,4,5,4,13,Champions
14869,6,4,54.96000000000001,5,4,2,11,Recent Customer
14870,366,4,85.95,1,4,2,7,Potential
14871,158,3,848.47,3,3,3,9,Potential
14872,247,2,71.97,2,1,2,5,At Risk
14873,139,1,21.98,3,1,1,5,At Risk
14874,143,2,804.48,3,1,3,7,Potential
14875,134,2,839.48,3,1,3,7,Potential
14876,262,2,12.940000000000001,2,1,1,4,At Risk
14877,144,3,889.47,3,3,3,9,Potential
14878,283,4,125.46000000000001,2,4,3,9,Potential
14879,100,5,1613.0582,4,5,4,13,Champions
14880,222,2,1819.5882000000001,2,1,4,7,Potential
14881,98,3,1854.5782,4,3,4,11,Loyal
14882,76,3,1854.5782,4,3,4,11,Loyal
14883,83,3,1828.5782,4,3,4,11,Loyal
14884,90,5,1883.5582,4,5,4,13,Champions
14885,117,2,1155.48,4,1,3,8,Potential
14886,310,1,539.99,1,1,3,5,At Risk
14887,297,4,86.95,1,4,2,7,Potential
14888,54,4,1898.0682,5,4,4,13,Champions
14889,114,1,21.98,4,1,1,6,At Risk
14890,229,1,21.98,2,1,1,4,At Risk
14891,107,3,1498.5782,4,3,4,11,Loyal
14892,107,2,1468.5882000000001,4,1,4,9,Potential
14893,117,2,839.48,4,1,3,8,Potential
14894,117,3,1503.5782,4,3,4,11,Loyal
14895,112,3,1503.5782,4,3,4,11,Loyal
14896,103,4,1588.5682,4,4,4,12,Loyal
14897,122,11,196.27,4,5,3,12,Loyal
14898,58,4,41.95,5,4,2,11,Loyal
14899,230,1,4.99,2,1,1,4,At Risk
14900,109,2,839.48,4,1,3,8,Potential
14901,353,2,7.28,1,1,1,3,At Risk
14902,120,3,1538.5782,4,3,4,11,Loyal
14903,290,3,61.96,1,3,2,6,At Risk
14904,59,12,468.12,5,5,3,13,Champions
14905,132,2,163.99,4,1,3,8,Potential
14906,15,9,189.53,5,5,3,13,Recent Customer
14907,152,3,127.28,3,3,3,9,Potential
14908,283,2,39.980000000000004,2,1,1,4,At Risk
14909,339,1,4.99,1,1,1,3,At Risk
14910,94,2,839.48,4,1,3,8,Potential
14911,102,4,867.97,4,4,3,11,Loyal
14912,108,4,1547.5682,4,4,4,12,Loyal
14913,103,5,1533.5582,4,5,4,13,Champions
14914,97,4,1592.5682,4,4,4,12,Loyal
14915,93,3,1538.5782,4,3,4,11,Loyal
14916,351,2,26.97,1,1,1,3,At Risk
14917,205,3,64.47,3,3,2,8,Potential
14918,178,2,12.940000000000001,3,1,1,5,At Risk
14919,274,2,7.28,2,1,1,4,At Risk
14920,285,1,4.99,2,1,1,4,At Risk
14921,343,2,7.28,1,1,1,3,At Risk
14922,66,1,4.99,5,1,1,7,Potential
14923,94,3,15.23,4,3,1,8,Potential
14924,322,2,39.980000000000004,1,1,1,3,At Risk
14925,306,2,2721.5525,1,1,4,6,At Risk
14926,321,5,3058.31,1,5,4,10,Loyal
14927,370,4,4190.23,1,4,5,10,Loyal
14928,90,6,6706.57,4,5,5,14,Champions
14929,86,5,6646.58,4,5,5,14,Champions
14930,305,2,2721.5525,1,1,4,6,At Risk
14931,215,10,6980.8525,2,5,5,12,Loyal
14932,170,4,98.96000000000001,3,4,3,10,Loyal
14933,3,3,36.96,5,3,1,9,Recent Customer
14934,70,5,178.45,5,5,3,13,Champions
14935,325,2,29.93,1,1,1,3,At Risk
14936,167,5,95.94,3,5,3,11,Loyal
14937,81,5,6652.889999999999,4,5,5,14,Champions
14938,123,3,107.97,4,3,3,10,Loyal
14939,216,7,8367.3,2,5,5,12,Loyal
14940,197,8,8367.55,3,5,5,13,Champions
14941,64,7,6865.57,5,5,5,15,Champions
14942,211,1,4.99,2,1,1,4,At Risk
14943,298,3,36.96,1,3,1,5,At Risk
14944,241,4,3040.31,2,4,4,10,Loyal
14945,383,4,4260.24,1,4,5,10,Loyal
14946,229,4,2778.5225,2,4,4,10,Loyal
14947,83,6,6658.58,4,5,5,14,Champions
14948,226,5,2786.5225,2,5,4,11,Loyal
14949,56,5,6795.599999999999,5,5,5,15,Champions
14950,43,6,6709.59,5,5,5,15,Champions
14951,358,3,4153.25,1,3,5,9,Potential
14952,316,3,4153.25,1,3,5,9,Potential
14953,313,5,202.45999999999998,1,5,3,9,Potential
14954,194,4,70.95,3,4,2,9,Potential
14955,166,3,103.97,3,3,3,9,Potential
14956,317,4,4145.54,1,4,5,10,Loyal
14957,227,4,2807.0325000000003,2,4,4,10,Loyal
14958,31,2,29.479999999999997,5,1,1,7,Potential
14959,141,2,39.980000000000004,3,1,1,5,At Risk
14960,241,4,2803.5225,2,4,4,10,Loyal
14961,297,4,151.27,1,4,3,8,Potential
14962,6,3,63.97,5,3,2,10,Recent Customer
14963,81,2,39.980000000000004,4,1,1,6,At Risk
14964,62,3,48.970000000000006,5,3,2,10,Loyal
14965,190,5,2753.8225,3,5,4,12,Loyal
14966,191,2,2746.5525,3,1,4,8,Potential
14967,249,4,4194.2300000000005,2,4,5,11,Loyal
14968,183,3,48.970000000000006,3,3,2,8,Potential
14969,270,2,4118.26,2,1,5,8,Potential
14970,63,4,158.95999999999998,5,4,3,12,Loyal
14971,240,2,39.980000000000004,2,1,1,4,At Risk
14972,49,2,56.97,5,1,2,8,Potential
14973,341,2,29.93,1,1,1,3,At Risk
14974,39,6,158.95000000000002,5,5,3,13,Champions
14975,86,6,5957.219999999999,4,5,5,14,Champions
14976,234,5,7040.612499999999,2,5,5,12,Loyal
14977,12,2,29.979999999999997,5,1,1,7,Recent Customer
14978,226,6,4209.21,2,5,5,12,Loyal
14979,241,5,4183.23,2,5,5,12,Loyal
14980,27,2,56.97,5,1,2,8,Recent Customer
14981,251,4,71.27,2,4,2,8,Potential
14982,301,7,152.45,1,5,3,9,Potential
14983,74,4,71.27,4,4,2,10,Loyal
14984,32,7,6699.57,5,5,5,15,Champions
14985,321,2,29.979999999999997,1,1,1,3,At Risk
14986,13,6,116.91000000000001,5,5,3,13,Recent Customer
14987,236,1,24.99,2,1,1,4,At Risk
14988,29,4,71.27,5,4,2,11,Recent Customer
14989,221,3,32.269999999999996,2,3,1,6,At Risk
14990,223,4,4173.19,2,4,5,11,Loyal
14991,51,6,6706.57,5,5,5,15,Champions
14992,24,5,106.26,5,5,3,13,Recent Customer
14993,196,7,152.94,3,5,3,11,Loyal
14994,244,2,29.979999999999997,2,1,1,4,At Risk
14995,192,4,2832.0325000000003,3,4,4,11,Loyal
14996,213,1,21.98,2,1,1,4,At Risk
14997,183,3,4143.25,3,3,5,11,Loyal
14998,175,5,3058.31,3,5,4,12,Loyal
14999,23,6,57.510000000000005,5,5,2,12,Recent Customer
15000,339,2,46.47,1,1,2,4,At Risk
15001,194,2,30.97,3,1,1,5,At Risk
15002,170,3,2781.5424999999996,3,3,4,10,Loyal
15003,163,6,3048.56,3,5,4,12,Loyal
15004,178,5,3073.31,3,5,4,12,Loyal
15005,109,3,1503.5782,4,3,4,11,Loyal
15006,206,2,2994.0881999999997,3,1,4,8,Potential
15007,77,9,209.83,4,5,3,12,Loyal
15008,95,9,170.53,4,5,3,12,Loyal
15009,261,3,36.96,2,3,1,6,At Risk
15010,37,3,80.96000000000001,5,3,2,10,Loyal
15011,204,3,89.97,3,3,2,8,Potential
15012,40,2,39.980000000000004,5,1,1,7,Potential
15013,271,2,26.97,2,1,1,4,At Risk
15014,231,6,3860.8696,2,5,5,12,Loyal
15015,239,3,3804.0782,2,3,5,10,Loyal
15016,112,3,1498.5782,4,3,4,11,Loyal
15017,374,5,1307.0582,1,5,4,10,Loyal
15018,338,4,112.46000000000001,1,4,3,8,Potential
15019,157,4,72.96000000000001,3,4,2,9,Potential
15020,71,4,40.26,5,4,2,11,Loyal
15021,69,2,38.98,5,1,1,7,Potential
15022,145,3,2999.9096,3,3,4,10,Loyal
15023,187,4,3079.5681999999997,3,4,4,11,Loyal
15024,90,4,78.96000000000001,4,4,2,10,Loyal
15025,152,6,128.94,3,5,3,11,Loyal
15026,171,2,29.979999999999997,3,1,1,5,At Risk
15027,137,4,2853.5681999999997,3,4,4,11,Loyal
15028,217,3,3826.3996,2,3,5,10,Loyal
15029,233,3,3826.3996,2,3,5,10,Loyal
15030,197,4,3786.3896,3,4,5,12,Loyal
15031,158,3,41.27,3,3,2,8,Potential
15032,185,3,3800.0782,3,3,5,11,Loyal
15033,182,3,3797.3995999999997,3,3,5,11,Loyal
15034,66,5,103.45,5,5,3,13,Champions
15035,157,2,3772.4096,3,1,5,9,Potential
15036,168,3,3785.0782,3,3,5,11,Loyal
15037,162,5,3856.3796,3,5,5,13,Champions
15038,156,2,3750.0882,3,1,5,9,Potential
15039,130,4,78.96000000000001,4,4,2,10,Loyal
15040,157,3,3807.3996,3,3,5,11,Loyal
15041,176,3,3826.3996,3,3,5,11,Loyal
15042,142,3,3807.3996,3,3,5,11,Loyal
15043,148,4,3846.8896000000004,3,4,5,12,Loyal
15044,153,5,3803.5582,3,5,5,13,Champions
15045,188,2,49.48,3,1,2,6,At Risk
15046,43,4,5943.25,5,4,5,14,Champions
15047,41,7,6669.57,5,5,5,15,Champions
15048,59,6,6690.58,5,5,5,15,Champions
15049,64,2,71.97,5,1,2,8,Potential
15050,213,4,4206.24,2,4,5,11,Loyal
15051,60,4,6650.599999999999,5,4,5,14,Champions
15052,64,4,44.57,5,4,2,11,Loyal
15053,134,3,93.48,3,3,3,9,Potential
15054,205,5,4155.22,3,5,5,13,Champions
15055,194,3,4178.25,3,3,5,11,Loyal
15056,59,9,6749.049999999999,5,5,5,15,Champions
15057,108,5,114.96000000000001,4,5,3,12,Loyal
15058,56,6,6639.58,5,5,5,15,Champions
15059,40,10,6793.539999999999,5,5,5,15,Champions
15060,31,1,24.99,5,1,1,7,Potential
15061,182,3,2781.5424999999996,3,3,4,10,Loyal
15062,40,5,6684.589999999999,5,5,5,15,Champions
15063,172,4,4133.24,3,4,5,12,Loyal
15064,155,3,2992.33,3,3,4,10,Loyal
15065,333,2,24.27,1,1,1,3,At Risk
15066,162,1,24.99,3,1,1,5,At Risk
15067,150,4,2803.5225,3,4,4,11,Loyal
15068,269,5,80.94,2,5,2,9,Potential
15069,332,4,71.95,1,4,2,7,Potential
15070,132,4,2770.8225,4,4,4,12,Loyal
15071,132,2,2746.5525,4,1,4,9,Potential
15072,128,3,2755.5425,4,3,4,11,Loyal
15073,161,2,4143.26,3,1,5,9,Potential
15074,10,2,85.48,5,1,2,8,Recent Customer
15075,73,3,74.98,5,3,2,10,Loyal
15076,42,3,96.46000000000001,5,3,3,11,Loyal
15077,41,7,6673.53,5,5,5,15,Champions
15078,35,4,6675.599999999999,5,4,5,14,Champions
15079,135,3,2731.5425,3,3,4,10,Loyal
15080,204,6,8305.3,3,5,5,13,Champions
15081,40,3,5900.549999999999,5,3,5,13,Champions
15082,239,8,7068.0825,2,5,5,12,Loyal
15083,61,4,5888.24,5,4,5,14,Champions
15084,186,7,6999.0925,3,5,5,13,Champions
15085,200,6,7229.369999999999,3,5,5,13,Champions
15086,159,9,6958.572499999999,3,5,5,13,Champions
15087,33,4,5917.24,5,4,5,14,Champions
15088,33,5,5896.19,5,5,5,15,Champions
15089,48,3,5895.24,5,3,5,13,Champions
15090,190,2,163.99,3,1,3,7,Potential
15091,268,2,39.980000000000004,2,1,1,4,At Risk
15092,286,2,36.59,2,1,1,4,At Risk
15093,80,7,7265.65,4,5,5,14,Champions
15094,73,7,7108.8724999999995,5,5,5,15,Champions
15095,51,6,7255.659999999999,5,5,5,15,Champions
15096,133,1,69.99,4,1,2,7,Potential
15097,179,9,8377.09,3,5,5,13,Champions
15098,188,3,38.88,3,3,1,7,Potential
15099,230,3,90.58000000000001,2,3,2,7,Potential
15100,206,6,6952.5824999999995,3,5,5,13,Champions
15101,194,7,6943.5525,3,5,5,13,Champions
15102,65,6,97.35,5,5,3,13,Champions
15103,56,6,107.85000000000001,5,5,3,13,Champions
15104,193,1,69.99,3,1,2,6,At Risk
15105,333,2,119.97999999999999,1,1,3,5,At Risk
15106,168,8,8421.279999999999,3,5,5,13,Champions
15107,309,1,69.99,1,1,2,4,At Risk
15108,115,7,210.54000000000002,4,5,3,12,Loyal
15109,230,2,119.97999999999999,2,1,3,6,At Risk
15110,33,1,69.99,5,1,2,8,Potential
15111,13,2,78.97999999999999,5,1,2,8,Recent Customer
15112,352,2,94.47999999999999,1,1,3,5,At Risk
15113,10,2,119.97999999999999,5,1,3,9,Recent Customer
15114,191,7,6918.8724999999995,3,5,5,13,Champions
15115,203,2,94.47999999999999,3,1,3,7,Potential
15116,204,7,7212.86,3,5,5,13,Champions
15117,184,9,6974.562499999999,3,5,5,13,Champions
15118,162,5,8301.31,3,5,5,13,Champions
15119,48,4,68.87,5,4,2,11,Loyal
15120,84,8,5217.6982,4,5,5,14,Champions
15121,47,6,5202.7296,5,5,5,15,Champions
15122,46,6,5193.719599999999,5,5,5,15,Champions
15123,67,4,81.26,5,4,2,11,Loyal
15124,251,6,122.44,2,5,3,10,Loyal
15125,56,4,81.26,5,4,2,11,Loyal
15126,93,4,86.26,4,4,2,10,Loyal
15127,56,7,5182.7296,5,5,5,15,Champions
15128,264,3,77.27,2,3,2,7,Potential
15129,57,6,5177.7296,5,5,5,15,Champions
15130,54,7,5215.3982,5,5,5,15,Champions
15131,163,4,81.26,3,4,2,9,Potential
15132,62,6,151.94,5,5,3,13,Champions
15133,35,7,5237.7296,5,5,5,15,Champions
15134,61,5,5151.7096,5,5,5,15,Champions
15135,122,4,4381.3895999999995,4,4,5,13,Champions
15136,143,3,62.269999999999996,3,3,2,8,Potential
15137,271,6,161.94,2,5,3,10,Loyal
15138,95,5,123.45,4,5,3,12,Loyal
15139,280,2,59.980000000000004,2,1,2,5,At Risk
15140,93,3,62.269999999999996,4,3,2,9,Potential
15141,36,3,63.97,5,3,2,10,Loyal
15142,63,4,138.46,5,4,3,12,Loyal
15143,113,2,4366.4096,4,1,5,10,Loyal
15144,113,2,4344.0882,4,1,5,10,Loyal
15145,95,3,4368.6996,4,3,5,12,Loyal
15146,200,6,161.94,3,5,3,11,Loyal
15147,176,5,97.45,3,5,3,11,Loyal
15148,236,5,90.75,2,5,2,9,Potential
15149,73,3,63.97,5,3,2,10,Loyal
15150,120,3,4379.0782,4,3,5,12,Loyal
15151,99,2,4344.0882,4,1,5,10,Loyal
15152,100,5,4464.5682,4,5,5,14,Champions
15153,152,3,113.97,3,3,3,9,Potential
15154,28,3,109.97,5,3,3,11,Recent Customer
15155,211,6,3148.9399999999996,2,5,4,11,Loyal
15156,309,2,124.99,1,1,3,5,At Risk
15157,62,7,213.94,5,5,3,13,Champions
15158,350,2,39.980000000000004,1,1,1,3,At Risk
15159,73,2,7.28,5,1,1,7,Potential
15160,1,4,98.96000000000001,5,4,3,12,Recent Customer
15161,340,2,7.28,1,1,1,3,At Risk
15162,70,5,154.95999999999998,5,5,3,13,Champions
15163,138,2,7.28,3,1,1,5,At Risk
15164,195,1,4.99,3,1,1,5,At Risk
15165,205,2,39.980000000000004,3,1,1,5,At Risk
15166,195,3,3124.96,3,3,4,10,Loyal
15167,168,6,3180.9399999999996,3,5,4,12,Loyal
15168,131,2,39.980000000000004,4,1,1,6,At Risk
15169,142,4,2919.8896,3,4,4,11,Loyal
15170,114,2,4391.4096,4,1,5,10,Loyal
15171,118,5,4392.0181999999995,4,5,5,14,Champions
15172,77,12,215.45,4,5,3,12,Loyal
15173,283,4,45.95,2,4,2,8,Potential
15174,128,5,99.9,4,5,3,12,Loyal
15175,96,7,4850.33,4,5,5,14,Champions
15176,98,5,4703.03,4,5,5,14,Champions
15177,65,2,7.28,5,1,1,7,Potential
15178,108,4,4445.0581999999995,4,4,5,13,Champions
15179,101,5,4444.8895999999995,4,5,5,14,Champions
15180,99,5,4466.3895999999995,4,5,5,14,Champions
15181,115,4,4448.379599999999,4,4,5,13,Champions
15182,94,2,4391.4096,4,1,5,10,Loyal
15183,103,3,4368.6996,4,3,5,12,Loyal
15184,120,5,4441.379599999999,4,5,5,14,Champions
15185,107,3,4393.6996,4,3,5,12,Loyal
15186,24,4,86.75999999999999,5,4,2,11,Recent Customer
15187,95,6,4725.32,4,5,5,14,Champions
15188,106,4,1631.46,4,4,4,12,Loyal
15189,106,2,1552.48,4,1,4,9,Potential
15190,55,4,98.96000000000001,5,4,3,12,Loyal
15191,119,2,1552.48,4,1,4,9,Potential
15192,113,4,4384.0782,4,4,5,13,Champions
15193,155,7,3209.9299999999994,3,5,4,12,Loyal
15194,164,6,3173.9399999999996,3,5,4,12,Loyal
15195,157,4,3154.95,3,4,4,11,Loyal
15196,178,5,3159.4399999999996,3,5,4,12,Loyal
15197,12,10,191.81,5,5,3,13,Recent Customer
15198,356,2,7.28,1,1,1,3,At Risk
15199,163,3,3080.2699999999995,3,3,4,10,Loyal
15200,174,4,3142.9699999999993,3,4,4,11,Loyal
15201,94,7,4793.0199999999995,4,5,5,14,Champions
15202,184,2,12.940000000000001,3,1,1,5,At Risk
15203,163,6,3211.45,3,5,4,12,Loyal
15204,106,5,4444.0682,4,5,5,14,Champions
15205,94,5,4433.6896,4,5,5,14,Champions
15206,101,4,98.96000000000001,4,4,3,11,Loyal
15207,94,3,4446.3996,4,3,5,12,Loyal
15208,137,5,2951.5581999999995,3,5,4,12,Loyal
15209,123,5,2916.5581999999995,4,5,4,13,Champions
15210,119,4,2926.3896000000004,4,4,4,12,Loyal
15211,71,3,2910.8996,5,3,4,12,Loyal
15212,39,4,68.96,5,4,2,11,Loyal
15213,67,2,2818.5882,5,1,4,10,Loyal
15214,117,6,4490.8796,4,5,5,14,Champions
15215,109,6,4468.5581999999995,4,5,5,14,Champions
15216,297,6,101.74,1,5,3,9,Potential
15217,64,4,41.26,5,4,2,11,Loyal
15218,121,3,4399.0782,4,3,5,12,Loyal
15219,120,3,4399.0782,4,3,5,12,Loyal
15220,97,4,4384.0782,4,4,5,13,Champions
15221,99,5,4447.8696,4,5,5,14,Champions
15222,95,5,123.45,4,5,3,12,Loyal
15223,112,2,4366.4096,4,1,5,10,Loyal
15224,65,4,71.92,5,4,2,11,Loyal
15225,97,3,4401.4096,4,3,5,12,Loyal
15226,104,2,4391.4096,4,1,5,10,Loyal
15227,93,6,4469.5582,4,5,5,14,Champions
15228,108,4,4375.0581999999995,4,4,5,13,Champions
15229,81,4,2833.5681999999997,4,4,4,12,Loyal
15230,15,6,242.95,5,5,3,13,Recent Customer
15231,14,5,90.75,5,5,2,12,Recent Customer
15232,163,3,39.97,3,3,1,7,Potential
15233,132,2,59.980000000000004,4,1,2,7,Potential
15234,184,2,59.980000000000004,3,1,2,6,At Risk
15235,155,7,190.89000000000001,3,5,3,11,Loyal
15236,241,5,126.95,2,5,3,10,Loyal
15237,101,4,66.26,4,4,2,10,Loyal
15238,108,4,98.96000000000001,4,4,3,11,Loyal
15239,177,5,123.45,3,5,3,11,Loyal
15240,49,4,73.96000000000001,5,4,2,11,Loyal
15241,176,5,51.91,3,5,2,10,Loyal
15242,159,3,37.269999999999996,3,3,1,7,Potential
15243,93,3,36.96,4,3,1,8,Potential
15244,94,12,179.19,4,5,3,12,Loyal
15245,183,2,30.97,3,1,1,5,At Risk
15246,247,1,21.98,2,1,1,4,At Risk
15247,265,2,7.28,2,1,1,4,At Risk
15248,81,3,64.47,4,3,2,9,Potential
15249,147,2,46.47,3,1,2,6,At Risk
15250,269,2,56.97,2,1,2,5,At Risk
15251,1,11,200.2,5,5,3,13,Recent Customer
15252,94,2,1552.48,4,1,4,9,Potential
15253,73,4,78.96000000000001,5,4,2,11,Loyal
15254,109,4,1624.45,4,4,4,12,Loyal
15255,84,3,1587.47,4,3,4,11,Loyal
15256,73,4,1631.46,5,4,4,13,Champions
15257,360,2,39.980000000000004,1,1,1,3,At Risk
15258,126,1,4.99,4,1,1,6,At Risk
15259,25,1,21.98,5,1,1,7,Recent Customer
15260,300,4,45.95,1,4,2,7,Potential
15261,185,6,70.74,3,5,2,10,Loyal
15262,138,2,3772.4096,3,1,5,9,Potential
15263,3,4,78.96000000000001,5,4,2,11,Recent Customer
15264,148,2,38.98,3,1,1,5,At Risk
15265,92,4,2897.5681999999997,4,4,4,12,Loyal
15266,75,6,2935.3696,4,5,4,13,Champions
15267,35,3,2853.5782,5,3,4,12,Loyal
15268,48,2,2840.9096,5,1,4,10,Loyal
15269,277,2,7.28,2,1,1,4,At Risk
15270,176,2,39.980000000000004,3,1,1,5,At Risk
15271,148,2,39.980000000000004,3,1,1,5,At Risk
15272,66,3,64.47,5,3,2,10,Loyal
15273,298,3,103.48,1,3,3,7,Potential
15274,256,4,114.46000000000001,2,4,3,9,Potential
15275,336,2,13.98,1,1,1,3,At Risk
15276,374,4,1346.76,1,4,4,9,Potential
15277,221,5,96.44,2,5,3,10,Loyal
15278,360,2,56.97,1,1,2,4,At Risk
15279,119,2,56.97,4,1,2,7,Potential
15280,163,5,3114.9399999999996,3,5,4,12,Loyal
15281,315,2,39.980000000000004,1,1,1,3,At Risk
15282,115,2,7.28,4,1,1,6,At Risk
15283,111,4,865.95,4,4,3,11,Loyal
15284,74,6,1683.93,4,5,4,13,Champions
15285,319,2,39.980000000000004,1,1,1,3,At Risk
15286,79,2,68.49,4,1,2,7,Potential
15287,83,5,1681.45,4,5,4,13,Champions
15288,63,3,1574.46,5,3,4,12,Loyal
15289,91,3,1574.46,4,3,4,11,Loyal
15290,85,4,1676.46,4,4,4,12,Loyal
15291,75,3,889.47,4,3,3,10,Loyal
15292,117,4,54.96000000000001,4,4,2,10,Loyal
15293,17,2,39.980000000000004,5,1,1,7,Recent Customer
15294,282,2,59.980000000000004,2,1,2,5,At Risk
15295,231,2,7.28,2,1,1,4,At Risk
15296,116,2,7.28,4,1,1,6,At Risk
15297,206,2,39.980000000000004,3,1,1,5,At Risk
15298,70,2,7.28,5,1,1,7,Potential
15299,65,2,7.28,5,1,1,7,Potential
15300,3,1,4.99,5,1,1,7,Recent Customer
15301,342,3,15.23,1,3,1,5,At Risk
15302,173,4,3134.95,3,4,4,11,Loyal
15303,154,2,3077.9799999999996,3,1,4,8,Potential
15304,102,8,4843.0,4,5,5,14,Champions
15305,283,3,15.23,2,3,1,6,At Risk
15306,27,3,89.97,5,3,2,10,Recent Customer
15307,305,2,39.980000000000004,1,1,1,3,At Risk
15308,90,3,1622.47,4,3,4,11,Loyal
15309,90,3,1622.47,4,3,4,11,Loyal
15310,137,8,94.44,3,5,3,11,Loyal
15311,86,3,1622.47,4,3,4,11,Loyal
15312,90,4,1631.46,4,4,4,12,Loyal
15313,165,2,7.28,3,1,1,5,At Risk
15314,75,5,1576.45,4,5,4,13,Champions
15315,296,1,4.99,1,1,1,3,At Risk
15316,91,2,7.28,4,1,1,6,At Risk
15317,265,2,54.980000000000004,2,1,2,5,At Risk
15318,59,2,39.980000000000004,5,1,1,7,Potential
15319,365,2,7.28,1,1,1,3,At Risk
15320,166,5,3152.9599999999996,3,5,4,12,Loyal
15321,176,3,3112.9799999999996,3,3,4,10,Loyal
15322,163,5,3152.9499999999994,3,5,4,12,Loyal
15323,70,3,804.47,5,3,3,11,Loyal
15324,43,5,50.940000000000005,5,5,2,12,Loyal
15325,77,4,1584.76,4,4,4,12,Loyal
15326,169,3,172.98,3,3,3,9,Potential
15327,65,2,39.980000000000004,5,1,1,7,Potential
15328,163,5,3199.4399999999996,3,5,4,12,Loyal
15329,168,4,3134.95,3,4,4,11,Loyal
15330,354,2,39.980000000000004,1,1,1,3,At Risk
15331,281,2,7.28,2,1,1,4,At Risk
15332,63,2,39.980000000000004,5,1,1,7,Potential
15333,90,4,1631.46,4,4,4,12,Loyal
15334,33,3,848.47,5,3,3,11,Loyal
15335,82,2,39.980000000000004,4,1,1,6,At Risk
15336,9,2,7.28,5,1,1,7,Recent Customer
15337,66,3,1622.47,5,3,4,12,Loyal
15338,81,6,1597.6999999999998,4,5,4,13,Champions
15339,77,3,1622.47,4,3,4,11,Loyal
15340,57,8,156.04,5,5,3,13,Champions
15341,63,3,1622.47,5,3,4,12,Loyal
15342,87,4,1646.96,4,4,4,12,Loyal
15343,65,2,1552.48,5,1,4,10,Loyal
15344,287,1,4.99,2,1,1,4,At Risk
15345,180,5,3101.95,3,5,4,12,Loyal
15346,171,5,3247.25,3,5,4,12,Loyal
15347,78,4,1631.46,4,4,4,12,Loyal
15348,170,5,3198.45,3,5,4,12,Loyal
15349,178,5,3139.9399999999996,3,5,4,12,Loyal
15350,159,5,3145.2599999999993,3,5,4,12,Loyal
15351,168,5,3114.9399999999996,3,5,4,12,Loyal
15352,312,1,69.99,1,1,2,4,At Risk
15353,57,9,325.83,5,5,3,13,Champions
15354,175,6,8297.289999999999,3,5,5,13,Champions
15355,87,1,35.0,4,1,1,6,At Risk
15356,328,2,119.97999999999999,1,1,3,5,At Risk
15357,198,7,7232.37,3,5,5,13,Champions
15358,53,2,39.980000000000004,5,1,1,7,Potential
15359,139,3,51.46,3,3,2,8,Potential
15360,50,1,4.99,5,1,1,7,Potential
15361,5,2,39.980000000000004,5,1,1,7,Recent Customer
15362,119,5,4745.02,4,5,5,14,Champions
15363,103,4,4719.04,4,4,5,13,Champions
15364,176,5,3183.9399999999996,3,5,4,12,Loyal
15365,167,6,3142.2299999999996,3,5,4,12,Loyal
15366,341,2,59.980000000000004,1,1,2,4,At Risk
15367,176,5,3177.9599999999996,3,5,4,12,Loyal
15368,298,2,7.28,1,1,1,3,At Risk
15369,172,5,3127.9499999999994,3,5,4,12,Loyal
15370,113,2,7.28,4,1,1,6,At Risk
15371,181,4,3178.95,3,4,4,11,Loyal
15372,165,3,3105.2699999999995,3,3,4,10,Loyal
15373,47,2,39.980000000000004,5,1,1,7,Potential
15374,161,5,3177.9599999999996,3,5,4,12,Loyal
15375,204,3,67.93,3,3,2,8,Potential
15376,89,7,136.24,4,5,3,12,Loyal
15377,8,7,167.89999999999998,5,5,3,13,Recent Customer
15378,97,9,170.91,4,5,3,12,Loyal
15379,169,5,3184.4399999999996,3,5,4,12,Loyal
15380,166,5,3145.2599999999993,3,5,4,12,Loyal
15381,21,1,4.99,5,1,1,7,Recent Customer
15382,178,3,103.48,3,3,3,9,Potential
15383,10,4,114.46000000000001,5,4,3,12,Recent Customer
15384,300,2,7.28,1,1,1,3,At Risk
15385,290,2,7.28,1,1,1,3,At Risk
15386,155,1,4.99,3,1,1,5,At Risk
15387,65,1,4.99,5,1,1,7,Potential
15388,182,5,3127.9499999999994,3,5,4,12,Loyal
15389,160,5,3152.9599999999996,3,5,4,12,Loyal
15390,146,2,39.980000000000004,3,1,1,5,At Risk
15391,88,8,4828.009999999999,4,5,5,14,Champions
15392,232,2,39.980000000000004,2,1,1,4,At Risk
15393,35,2,7.28,5,1,1,7,Potential
15394,155,4,3134.95,3,4,4,11,Loyal
15395,77,6,4780.02,4,5,5,14,Champions
15396,156,5,3147.95,3,5,4,12,Loyal
15397,345,2,39.980000000000004,1,1,1,3,At Risk
15398,169,3,3132.9699999999993,3,3,4,10,Loyal
15399,156,5,3148.2199999999993,3,5,4,12,Loyal
15400,273,1,4.99,2,1,1,4,At Risk
15401,102,2,39.980000000000004,4,1,1,6,At Risk
15402,120,7,131.55,4,5,3,12,Loyal
15403,221,2,39.980000000000004,2,1,1,4,At Risk
15404,171,5,3114.9399999999996,3,5,4,12,Loyal
15405,275,3,15.23,2,3,1,6,At Risk
15406,317,2,7.28,1,1,1,3,At Risk
15407,89,2,39.980000000000004,4,1,1,6,At Risk
15408,151,2,39.980000000000004,3,1,1,5,At Risk
15409,70,4,1567.46,5,4,4,13,Champions
15410,63,6,1619.9,5,5,4,14,Champions
15411,159,5,3127.9499999999994,3,5,4,12,Loyal
15412,52,1,4.99,5,1,1,7,Potential
15413,149,9,318.92,3,5,3,11,Loyal
15414,354,1,4.99,1,1,1,3,At Risk
15415,156,3,89.97,3,3,2,8,Potential
15416,107,1,4.99,4,1,1,6,At Risk
15417,173,5,3120.2599999999993,3,5,4,12,Loyal
15418,217,8,232.23,2,5,3,10,Loyal
15419,182,2,3102.9799999999996,3,1,4,8,Potential
15420,333,1,4.99,1,1,1,3,At Risk
15421,93,1,4.99,4,1,1,6,At Risk
15422,53,5,1633.94,5,5,4,14,Champions
15423,325,1,4.99,1,1,1,3,At Risk
15424,41,2,30.97,5,1,1,7,Potential
15425,136,2,3772.4096,3,1,5,9,Potential
15426,79,7,115.92,4,5,3,12,Loyal
15427,48,3,1574.46,5,3,4,12,Loyal
15428,51,4,1631.46,5,4,4,13,Champions
15429,181,6,3170.2,3,5,4,12,Loyal
15430,360,2,39.980000000000004,1,1,1,3,At Risk
15431,278,2,7.28,2,1,1,4,At Risk
15432,56,3,1587.47,5,3,4,12,Loyal
15433,59,3,1622.47,5,3,4,12,Loyal
15434,116,2,32.28,4,1,1,6,At Risk
15435,139,4,3801.3896,3,4,5,12,Loyal
15436,128,2,3772.4096,4,1,5,10,Loyal
15437,13,3,37.269999999999996,5,3,1,9,Recent Customer
15438,102,5,3788.6796,4,5,5,14,Champions
15439,105,3,3804.0782,4,3,5,12,Loyal
15440,35,8,6736.5599999999995,5,5,5,15,Champions
15441,241,4,77.27,2,4,2,8,Potential
15442,210,3,93.48,2,3,3,8,Potential
15443,358,2,7.28,1,1,1,3,At Risk
15444,29,6,138.95000000000002,5,5,3,13,Recent Customer
15445,216,3,64.97,2,3,2,7,Potential
15446,259,3,32.269999999999996,2,3,1,6,At Risk
15447,247,1,24.99,2,1,1,4,At Risk
15448,27,4,52.93000000000001,5,4,2,11,Recent Customer
15449,33,5,49.56,5,5,2,12,Loyal
15450,334,3,32.269999999999996,1,3,1,5,At Risk
15451,135,3,2756.5424999999996,3,3,4,10,Loyal
15452,315,1,24.99,1,1,1,3,At Risk
15453,46,4,6650.599999999999,5,4,5,14,Champions
15454,146,2,2746.5525,3,1,4,8,Potential
15455,108,6,3099.29,4,5,4,13,Champions
15456,127,5,2815.5225,4,5,4,13,Champions
15457,134,3,2781.5424999999996,3,3,4,10,Loyal
15458,167,1,4.99,3,1,1,5,At Risk
15459,214,3,34.92,2,3,1,6,At Risk
15460,97,2,2746.5525,4,1,4,9,Potential
15461,127,5,88.96000000000001,4,5,2,11,Loyal
15462,104,4,3086.8199999999997,4,4,4,12,Loyal
15463,103,7,2802.4925,4,5,4,13,Champions
15464,46,3,37.269999999999996,5,3,1,9,Potential
15465,123,3,40.23,4,3,2,9,Potential
15466,54,3,1587.47,5,3,4,12,Loyal
15467,33,4,1631.46,5,4,4,13,Champions
15468,111,10,436.35,4,5,3,12,Loyal
15469,354,2,39.980000000000004,1,1,1,3,At Risk
15470,167,3,76.96000000000001,3,3,2,8,Potential
15471,58,3,1622.47,5,3,4,12,Loyal
15472,44,3,1560.43,5,3,4,12,Loyal
15473,60,2,1552.48,5,1,4,10,Loyal
15474,48,4,1676.46,5,4,4,13,Champions
15475,33,4,1587.46,5,4,4,13,Champions
15476,363,2,7.28,1,1,1,3,At Risk
15477,46,2,7.28,5,1,1,7,Potential
15478,159,9,182.83,3,5,3,11,Loyal
15479,70,4,85.95,5,4,2,11,Loyal
15480,162,2,3077.9799999999996,3,1,4,8,Potential
15481,165,5,3152.9599999999996,3,5,4,12,Loyal
15482,179,4,3124.45,3,4,4,11,Loyal
15483,175,5,3120.2599999999993,3,5,4,12,Loyal
15484,156,4,3179.95,3,4,4,11,Loyal
15485,323,2,39.980000000000004,1,1,1,3,At Risk
15486,222,2,39.980000000000004,2,1,1,4,At Risk
15487,328,3,89.97,1,3,2,6,At Risk
15488,104,9,165.3,4,5,3,12,Loyal
15489,57,5,1685.45,5,5,4,14,Champions
15490,76,7,4813.52,4,5,5,14,Champions
15491,182,5,3181.4599999999996,3,5,4,12,Loyal
15492,163,5,3117.45,3,5,4,12,Loyal
15493,169,3,3099.96,3,3,4,10,Loyal
15494,68,7,275.44,5,5,3,13,Champions
15495,31,2,39.980000000000004,5,1,1,7,Potential
15496,330,2,39.980000000000004,1,1,1,3,At Risk
15497,36,3,1622.47,5,3,4,12,Loyal
15498,127,10,256.52,4,5,3,12,Loyal
15499,155,3,3222.9799999999996,3,3,4,10,Loyal
15500,157,4,3153.95,3,4,4,11,Loyal
15501,165,3,3197.9799999999996,3,3,4,10,Loyal
15502,33,3,1587.47,5,3,4,12,Loyal
15503,52,5,1622.45,5,5,4,14,Champions
15504,255,2,39.980000000000004,2,1,1,4,At Risk
15505,220,2,7.28,2,1,1,4,At Risk
15506,55,2,1552.48,5,1,4,10,Loyal
15507,184,9,267.84,3,5,3,11,Loyal
15508,190,2,39.980000000000004,3,1,1,5,At Risk
15509,320,2,39.980000000000004,1,1,1,3,At Risk
15510,160,2,39.980000000000004,3,1,1,5,At Risk
15511,9,7,143.54000000000002,5,5,3,13,Recent Customer
15512,98,3,61.96,4,3,2,9,Potential
15513,166,2,39.980000000000004,3,1,1,5,At Risk
15514,247,2,124.99,2,1,3,6,At Risk
15515,60,2,7.28,5,1,1,7,Potential
15516,210,2,7.28,2,1,1,4,At Risk
15517,156,3,3112.9799999999996,3,3,4,10,Loyal
15518,143,5,3114.9399999999996,3,5,4,12,Loyal
15519,277,1,21.98,2,1,1,4,At Risk
15520,44,4,1611.96,5,4,4,13,Champions
15521,141,5,3172.95,3,5,4,12,Loyal
15522,165,2,26.97,3,1,1,5,At Risk
15523,34,4,1631.46,5,4,4,13,Champions
15524,253,2,7.28,2,1,1,4,At Risk
15525,51,3,1560.43,5,3,4,12,Loyal
15526,87,10,188.32,4,5,3,12,Loyal
15527,43,3,1622.47,5,3,4,12,Loyal
15528,60,4,1676.46,5,4,4,13,Champions
15529,60,3,1587.47,5,3,4,12,Loyal
15530,44,3,846.46,5,3,3,11,Loyal
15531,41,3,1622.47,5,3,4,12,Loyal
15532,43,5,1589.75,5,5,4,14,Champions
15533,163,1,4.99,3,1,1,5,At Risk
15534,146,5,3199.4399999999996,3,5,4,12,Loyal
15535,149,3,3099.96,3,3,4,10,Loyal
15536,31,10,249.53,5,5,3,13,Champions
15537,39,4,1631.46,5,4,4,13,Champions
15538,41,5,1595.4099999999999,5,5,4,14,Champions
15539,108,3,64.47,4,3,2,9,Potential
15540,123,3,3124.96,4,3,4,11,Loyal
15541,160,3,61.96,3,3,2,8,Potential
15542,142,4,3117.9599999999996,3,4,4,11,Loyal
15543,118,5,180.94,4,5,3,12,Loyal
15544,276,4,111.95000000000002,2,4,3,9,Potential
15545,197,2,39.980000000000004,3,1,1,5,At Risk
15546,42,2,39.980000000000004,5,1,1,7,Potential
15547,35,3,1587.47,5,3,4,12,Loyal
15548,367,4,1337.96,1,4,4,9,Potential
15549,383,2,574.98,1,1,3,5,At Risk
15550,61,1,4.99,5,1,1,7,Potential
15551,393,4,1375.26,1,4,4,9,Potential
15552,369,5,1426.46,1,5,4,10,Loyal
15553,389,5,1372.95,1,5,4,10,Loyal
15554,370,3,1357.97,1,3,4,8,Potential
15555,378,5,1371.95,1,5,4,10,Loyal
15556,332,4,588.96,1,4,3,8,Potential
15557,386,4,1337.96,1,4,4,9,Potential
15558,359,4,1362.96,1,4,4,9,Potential
15559,249,7,172.04,2,5,3,10,Loyal
15560,263,1,4.99,2,1,1,4,At Risk
15561,343,4,1375.26,1,4,4,9,Potential
15562,364,3,1347.97,1,3,4,8,Potential
15563,116,2,39.980000000000004,4,1,1,6,At Risk
15564,145,8,188.52,3,5,3,11,Loyal
15565,124,3,3099.96,4,3,4,11,Loyal
15566,53,10,4912.469999999999,5,5,5,15,Champions
15567,53,6,4720.27,5,5,5,15,Champions
15568,123,3,3112.9699999999993,4,3,4,11,Loyal
15569,126,2,3077.9799999999996,4,1,4,9,Potential
15570,336,3,1344.96,1,3,4,8,Potential
15571,117,5,101.85000000000001,4,5,3,12,Loyal
15572,107,5,104.55000000000001,4,5,3,12,Loyal
15573,116,1,4.99,4,1,1,6,At Risk
15574,22,3,127.28,5,3,3,11,Recent Customer
15575,52,3,2910.8996,5,3,4,12,Loyal
15576,100,2,4344.0882,4,1,5,10,Loyal
15577,170,5,143.45,3,5,3,11,Loyal
15578,96,4,4509.8996,4,4,5,13,Champions
15579,325,2,34.98,1,1,1,3,At Risk
15580,47,3,2910.8996,5,3,4,12,Loyal
15581,156,6,113.94,3,5,3,11,Loyal
15582,51,5,2907.5581999999995,5,5,4,14,Champions
15583,103,4,66.26,4,4,2,10,Loyal
15584,34,3,62.269999999999996,5,3,2,10,Loyal
15585,107,5,4367.0181999999995,4,5,5,14,Champions
15586,122,6,4469.369599999999,4,5,5,14,Champions
15587,102,4,4423.3796,4,4,5,13,Champions
15588,96,4,4486.0682,4,4,5,13,Champions
15589,119,5,4416.379599999999,4,5,5,14,Champions
15590,93,6,4440.048199999999,4,5,5,14,Champions
15591,105,3,4346.3782,4,3,5,12,Loyal
15592,134,2,59.980000000000004,3,1,2,6,At Risk
15593,197,4,116.26,3,4,3,10,Loyal
15594,12,4,66.26,5,4,2,11,Recent Customer
15595,116,2,4369.0882,4,1,5,10,Loyal
15596,97,6,4460.038199999999,4,5,5,14,Champions
15597,100,2,4391.4096,4,1,5,10,Loyal
15598,60,7,167.93,5,5,3,13,Champions
15599,31,6,81.24,5,5,2,12,Loyal
15600,96,5,4590.3996,4,5,5,14,Champions
15601,105,4,4429.5682,4,4,5,13,Champions
15602,45,3,63.97,5,3,2,10,Loyal
15603,166,3,39.97,3,3,1,7,Potential
15604,138,5,66.75,3,5,2,10,Loyal
15605,67,3,39.97,5,3,1,9,Potential
15606,164,7,115.92999999999999,3,5,3,11,Loyal
15607,21,4,88.46000000000001,5,4,2,11,Recent Customer
15608,154,2,39.980000000000004,3,1,1,5,At Risk
15609,167,2,27.279999999999998,3,1,1,5,At Risk
15610,93,5,114.96000000000001,4,5,3,12,Loyal
15611,229,4,54.25,2,4,2,8,Potential
15612,215,4,79.97,2,4,2,8,Potential
15613,251,2,27.279999999999998,2,1,1,4,At Risk
15614,51,9,6059.179999999999,5,5,5,15,Champions
15615,32,7,70.24,5,5,2,12,Loyal
15616,130,2,27.279999999999998,4,1,1,6,At Risk
15617,362,4,59.91,1,4,2,7,Potential
15618,303,1,24.99,1,1,1,3,At Risk
15619,42,3,5908.25,5,3,5,13,Champions
15620,53,6,5959.719999999999,5,5,5,15,Champions
15621,36,4,5977.74,5,4,5,14,Champions
15622,121,4,3027.3199999999997,4,4,4,12,Loyal
15623,128,7,7246.87,4,5,5,14,Champions
15624,128,7,6989.5825,4,5,5,14,Champions
15625,187,4,7169.389999999999,3,4,5,12,Loyal
15626,206,8,7029.072499999999,3,5,5,13,Champions
15627,155,7,6943.5824999999995,3,5,5,13,Champions
15628,104,3,63.97,4,3,2,9,Potential
15629,29,2,39.980000000000004,5,1,1,7,Recent Customer
15630,138,7,5136.37,3,5,5,13,Champions
15631,121,5,5122.39,4,5,5,14,Champions
15632,110,8,5245.06,4,5,5,14,Champions
15633,253,2,68.49,2,1,2,5,At Risk
15634,58,3,61.96000000000001,5,3,2,10,Loyal
15635,78,4,116.95,4,4,3,11,Loyal
15636,232,4,78.96000000000001,2,4,2,8,Potential
15637,113,8,6999.5725,4,5,5,14,Champions
15638,110,7,5162.37,4,5,5,14,Champions
15639,261,3,34.57,2,3,1,6,At Risk
15640,273,3,34.57,2,3,1,6,At Risk
15641,280,5,96.75,2,5,3,10,Loyal
15642,100,2,3772.4096,4,1,5,10,Loyal
15643,96,3,3807.3996,4,3,5,12,Loyal
15644,86,5,3803.6796,4,5,5,14,Champions
15645,89,3,3785.0782,4,3,5,12,Loyal
15646,82,3,3804.0782,4,3,5,12,Loyal
15647,92,4,3764.0681999999997,4,4,5,13,Champions
15648,67,3,3807.3996,5,3,5,13,Champions
15649,106,5,3048.31,4,5,4,13,Champions
15650,46,4,114.96000000000001,5,4,3,12,Loyal
15651,65,2,2746.5525,5,1,4,10,Loyal
15652,97,6,5160.08,4,5,5,14,Champions
15653,72,8,5204.06,5,5,5,15,Champions
15654,233,1,24.99,2,1,1,4,At Risk
15655,101,5,2753.8225,4,5,4,13,Champions
15656,108,3,2992.33,4,3,4,11,Loyal
15657,63,10,5251.34,5,5,5,15,Champions
15658,150,3,64.97,3,3,2,8,Potential
15659,103,5,3047.81,4,5,4,13,Champions
15660,35,7,5169.07,5,5,5,15,Champions
15661,57,10,5208.04,5,5,5,15,Champions
15662,49,8,5253.07,5,5,5,15,Champions
15663,65,3,2771.5425,5,3,4,12,Loyal
15664,68,5,2770.5225,5,5,4,14,Champions
15665,92,4,2803.5225,4,4,4,12,Loyal
15666,79,5,3089.3,4,5,4,13,Champions
15667,76,4,3125.3199999999997,4,4,4,12,Loyal
15668,38,4,5913.24,5,4,5,14,Champions
15669,45,2,5898.26,5,1,5,11,Loyal
15670,43,4,114.96000000000001,5,4,3,12,Loyal
15671,159,4,31.55,3,4,1,8,Potential
15672,36,3,89.97,5,3,2,10,Loyal
15673,294,3,64.97,1,3,2,6,At Risk
15674,87,4,3053.3199999999997,4,4,4,12,Loyal
15675,168,7,7206.379999999999,3,5,5,13,Champions
15676,117,7,7224.679999999999,4,5,5,14,Champions
15677,105,8,7200.86,4,5,5,14,Champions
15678,114,10,7223.339999999999,4,5,5,14,Champions
15679,263,3,64.97,2,3,2,7,Potential
15680,208,1,4.99,2,1,1,4,At Risk
15681,220,5,105.56,2,5,3,10,Loyal
15682,18,1,69.99,5,1,2,8,Recent Customer
15683,322,3,89.98,1,3,2,6,At Risk
15684,212,8,6963.0725,2,5,5,12,Loyal
15685,191,6,7188.369999999999,3,5,5,13,Champions
15686,75,3,72.58,4,3,2,9,Potential
15687,34,6,6973.8724999999995,5,5,5,15,Champions
15688,223,5,6221.522499999999,2,5,5,12,Loyal
15689,270,1,35.0,2,1,1,4,At Risk
15690,17,4,76.57000000000001,5,4,2,11,Recent Customer
15691,180,7,8341.289999999999,3,5,5,13,Champions
15692,182,7,8392.3,3,5,5,13,Champions
15693,189,5,6904.602499999999,3,5,5,13,Champions
15694,8,5,107.37,5,5,3,13,Recent Customer
15695,157,8,8324.24,3,5,5,13,Champions
15696,216,3,198.99,2,3,3,8,Potential
15697,211,10,6974.5425,2,5,5,12,Loyal
15698,79,3,42.28,4,3,2,9,Potential
15699,171,8,6969.572499999999,3,5,5,13,Champions
15700,210,5,6247.532499999999,2,5,5,12,Loyal
15701,116,5,78.86,4,5,2,11,Loyal
15702,150,7,6917.5425,3,5,5,13,Champions
15703,366,3,74.98,1,3,2,6,At Risk
15704,163,1,35.0,3,1,1,5,At Risk
15705,254,2,69.99000000000001,2,1,2,5,At Risk
15706,323,1,35.0,1,1,1,3,At Risk
15707,139,1,35.0,3,1,1,5,At Risk
15708,340,3,74.98,1,3,2,6,At Risk
15709,311,3,94.98,1,3,3,7,Potential
15710,191,7,6316.5025,3,5,5,13,Champions
15711,208,5,126.56,2,5,3,10,Loyal
15712,115,4,51.57,4,4,2,10,Loyal
15713,62,2,37.59,5,1,1,7,Potential
15714,112,4,83.97,4,4,2,10,Loyal
15715,89,3,39.97,4,3,1,8,Potential
15716,115,5,4467.0581999999995,4,5,5,14,Champions
15717,82,5,4411.3682,4,5,5,14,Champions
15718,41,3,63.97,5,3,2,10,Loyal
15719,91,4,4429.5682,4,4,5,13,Champions
15720,65,4,70.22,5,4,2,11,Loyal
15721,115,4,118.96000000000001,4,4,3,11,Loyal
15722,85,4,4448.5682,4,4,5,13,Champions
15723,64,5,4444.0682,5,5,5,15,Champions
15724,68,4,4359.0682,5,4,5,14,Champions
15725,86,5,4416.379599999999,4,5,5,14,Champions
15726,72,4,4393.3582,5,4,5,14,Champions
15727,55,4,134.45999999999998,5,4,3,12,Loyal
15728,87,3,63.97,4,3,2,9,Potential
15729,66,3,4393.6996,5,3,5,13,Champions
15730,93,4,122.96000000000001,4,4,3,11,Loyal
15731,123,2,59.980000000000004,4,1,2,7,Potential
15732,75,3,4376.3996,4,3,5,12,Loyal
15733,79,6,4443.548199999999,4,5,5,14,Champions
15734,62,3,4426.4096,5,3,5,13,Champions
15735,144,5,116.25,3,5,3,11,Loyal
15736,83,5,76.94,4,5,2,11,Loyal
15737,153,6,3117.2299999999996,3,5,4,12,Loyal
15738,44,3,166.28,5,3,3,11,Loyal
15739,152,4,3140.2699999999995,3,4,4,11,Loyal
15740,133,2,39.980000000000004,4,1,1,6,At Risk
15741,101,3,89.97,4,3,2,9,Potential
15742,347,2,39.980000000000004,1,1,1,3,At Risk
15743,66,2,39.980000000000004,5,1,1,7,Potential
15744,166,2,12.940000000000001,3,1,1,5,At Risk
15745,152,3,89.97,3,3,2,8,Potential
15746,57,1,4.99,5,1,1,7,Potential
15747,146,2,39.980000000000004,3,1,1,5,At Risk
15748,65,8,296.91,5,5,3,13,Champions
15749,12,2,7.28,5,1,1,7,Recent Customer
15750,127,3,3087.9699999999993,4,3,4,11,Loyal
15751,66,3,4446.3996,5,3,5,13,Champions
15752,66,5,4408.6896,5,5,5,15,Champions
15753,73,3,4399.0782,5,3,5,13,Champions
15754,72,5,4416.379599999999,5,5,5,15,Champions
15755,82,3,4404.0782,4,3,5,12,Loyal
15756,84,5,4441.3895999999995,4,5,5,14,Champions
15757,62,2,4366.4096,5,1,5,11,Loyal
15758,5,4,98.96000000000001,5,4,3,12,Recent Customer
15759,314,3,89.97,1,3,2,6,At Risk
15760,11,9,146.52,5,5,3,13,Recent Customer
15761,3,11,196.4,5,5,3,13,Recent Customer
15762,218,2,564.48,2,1,3,6,At Risk
15763,312,5,1387.95,1,5,4,10,Loyal
15764,81,3,4413.3896,4,3,5,12,Loyal
15765,76,2,4369.0882,4,1,5,10,Loyal
15766,223,3,62.269999999999996,2,3,2,7,Potential
15767,87,3,4379.0882,4,3,5,12,Loyal
15768,127,3,3124.96,4,3,4,11,Loyal
15769,145,4,3159.95,3,4,4,11,Loyal
15770,143,7,3179.93,3,5,4,12,Loyal
15771,126,4,3174.95,4,4,4,12,Loyal
15772,194,2,39.980000000000004,3,1,1,5,At Risk
15773,186,3,64.47,3,3,2,8,Potential
15774,296,2,124.99,1,1,3,5,At Risk
15775,165,3,15.23,3,3,1,7,Potential
15776,248,1,4.99,2,1,1,4,At Risk
15777,284,2,39.980000000000004,2,1,1,4,At Risk
15778,130,5,3177.9599999999996,4,5,4,13,Champions
15779,253,3,90.47,2,3,2,7,Potential
15780,136,4,3244.96,3,4,4,11,Loyal
15781,142,5,3209.9399999999996,3,5,4,12,Loyal
15782,45,2,7.28,5,1,1,7,Potential
15783,98,4,98.96000000000001,4,4,3,11,Loyal
15784,78,3,4379.0882,4,3,5,12,Loyal
15785,91,4,4454.3496,4,4,5,13,Champions
15786,78,3,4366.0682,4,3,5,12,Loyal
15787,48,7,167.93,5,5,3,13,Champions
15788,88,4,4443.3796,4,4,5,13,Champions
15789,69,4,4486.0682,5,4,5,14,Champions
15790,336,4,2668.3796,1,4,4,9,Potential
15791,58,4,42.26,5,4,2,11,Loyal
15792,309,3,2645.3995999999997,1,3,4,8,Potential
15793,62,2,4369.0882,5,1,5,11,Loyal
15794,33,3,113.97,5,3,3,11,Loyal
15795,275,6,132.44,2,5,3,10,Loyal
15796,26,2,59.980000000000004,5,1,2,8,Recent Customer
15797,87,4,4415.6796,4,4,5,13,Champions
15798,233,4,98.96000000000001,2,4,3,9,Potential
15799,77,4,4423.3796,4,4,5,13,Champions
15800,63,3,4399.0782,5,3,5,13,Champions
15801,63,4,4381.3782,5,4,5,14,Champions
15802,71,5,4444.0682,5,5,5,15,Champions
15803,71,4,66.26,5,4,2,11,Loyal
15804,46,4,98.96000000000001,5,4,3,12,Loyal
15805,43,4,127.47,5,4,3,12,Loyal
15806,268,6,102.85,2,5,3,10,Loyal
15807,47,4,70.57000000000001,5,4,2,11,Loyal
15808,72,3,4424.0782,5,3,5,13,Champions
15809,193,2,62.59,3,1,2,6,At Risk
15810,109,4,67.17,4,4,2,10,Loyal
15811,196,5,71.16,3,5,2,10,Loyal
15812,87,5,81.25,4,5,2,11,Loyal
15813,139,2,30.97,3,1,1,5,At Risk
15814,111,3,93.97,4,3,3,10,Loyal
15815,35,7,141.83,5,5,3,13,Champions
15816,241,8,188.02,2,5,3,10,Loyal
15817,261,3,64.47,2,3,2,7,Potential
15818,45,1,4.99,5,1,1,7,Potential
15819,141,2,30.97,3,1,1,5,At Risk
15820,361,2,71.97,1,1,2,4,At Risk
15821,360,2,30.97,1,1,1,3,At Risk
15822,110,5,43.21,4,5,2,11,Loyal
15823,76,4,67.96000000000001,4,4,2,10,Loyal
15824,319,2,75.97,1,1,2,4,At Risk
15825,15,2,39.980000000000004,5,1,1,7,Recent Customer
15826,8,10,184.71,5,5,3,13,Recent Customer
15827,308,7,1418.92,1,5,4,10,Loyal
15828,77,6,172.25,4,5,3,12,Loyal
15829,232,3,187.98,2,3,3,8,Potential
15830,306,5,2680.3795999999998,1,5,4,10,Loyal
15831,330,5,2646.3582,1,5,4,10,Loyal
15832,298,2,2611.4096,1,1,4,6,At Risk
15833,271,2,2611.4096,2,1,4,7,Potential
15834,327,2,1322.98,1,1,4,6,At Risk
15835,54,3,93.97,5,3,3,11,Loyal
15836,107,2,7.28,4,1,1,6,At Risk
15837,198,2,39.980000000000004,3,1,1,5,At Risk
15838,275,2,56.97,2,1,2,5,At Risk
15839,268,2,24.27,2,1,1,4,At Risk
15840,138,3,3080.2699999999995,3,3,4,10,Loyal
15841,149,3,3105.2699999999995,3,3,4,10,Loyal
15842,137,5,3152.9599999999996,3,5,4,12,Loyal
15843,136,4,3142.9699999999993,3,4,4,11,Loyal
15844,127,4,3134.95,4,4,4,12,Loyal
15845,136,4,3244.96,3,4,4,11,Loyal
15846,45,8,4943.32,5,5,5,15,Champions
15847,9,6,240.44,5,5,3,13,Recent Customer
15848,33,2,39.980000000000004,5,1,1,7,Potential
15849,230,2,7.28,2,1,1,4,At Risk
15850,49,4,4813.039999999999,5,4,5,14,Champions
15851,146,5,3198.46,3,5,4,12,Loyal
15852,141,3,3222.9799999999996,3,3,4,10,Loyal
15853,216,2,59.980000000000004,2,1,2,5,At Risk
15854,230,4,41.95,2,4,2,8,Potential
15855,121,3,29.26,4,3,1,8,Potential
15856,22,8,153.20999999999998,5,5,3,13,Recent Customer
15857,98,1,4.99,4,1,1,6,At Risk
15858,191,2,7.28,3,1,1,5,At Risk
15859,115,6,74.14,4,5,2,11,Loyal
15860,318,2,1322.98,1,1,4,6,At Risk
15861,362,2,7.28,1,1,1,3,At Risk
15862,331,4,1379.95,1,4,4,9,Potential
15863,199,9,243.01000000000002,3,5,3,11,Loyal
15864,113,5,103.55000000000001,4,5,3,12,Loyal
15865,290,5,1416.95,1,5,4,10,Loyal
15866,71,8,145.82000000000002,5,5,3,13,Champions
15867,47,2,7.28,5,1,1,7,Potential
15868,1,9,166.51000000000002,5,5,3,13,Recent Customer
15869,330,2,13.98,1,1,1,3,At Risk
15870,256,2,7.28,2,1,1,4,At Risk
15871,306,2,39.980000000000004,1,1,1,3,At Risk
15872,45,8,235.54,5,5,3,13,Champions
15873,135,6,3123.93,3,5,4,12,Loyal
15874,87,6,225.44,4,5,3,12,Loyal
15875,296,3,15.23,1,3,1,5,At Risk
15876,59,5,4789.02,5,5,5,15,Champions
15877,34,2,39.980000000000004,5,1,1,7,Potential
15878,74,7,225.92000000000002,4,5,3,12,Loyal
15879,167,6,196.93,3,5,3,11,Loyal
15880,319,3,132.94,1,3,3,7,Potential
15881,327,1,564.99,1,1,3,5,At Risk
15882,289,4,1372.46,1,4,4,9,Potential
15883,300,4,89.95,1,4,2,7,Potential
15884,267,2,39.980000000000004,2,1,1,4,At Risk
15885,277,5,1397.95,2,5,4,11,Loyal
15886,293,4,1422.46,1,4,4,9,Potential
15887,35,2,39.980000000000004,5,1,1,7,Potential
15888,136,4,3178.95,3,4,4,11,Loyal
15889,52,6,4848.03,5,5,5,15,Champions
15890,251,4,1375.26,2,4,4,10,Loyal
15891,34,2,39.980000000000004,5,1,1,7,Potential
15892,216,5,1401.46,2,5,4,11,Loyal
15893,220,5,1428.94,2,5,4,11,Loyal
15894,299,3,89.97,1,3,2,6,At Risk
15895,219,3,61.96,2,3,2,7,Potential
15896,147,2,7.28,3,1,1,5,At Risk
15897,149,5,3114.9399999999996,3,5,4,12,Loyal
15898,85,2,7.28,4,1,1,6,At Risk
15899,153,4,3133.95,3,4,4,11,Loyal
15900,327,4,699.97,1,4,3,8,Potential
15901,241,3,1376.97,2,3,4,9,Potential
15902,238,5,1397.95,2,5,4,11,Loyal
15903,238,5,1372.95,2,5,4,11,Loyal
15904,243,4,1394.95,2,4,4,10,Loyal
15905,56,6,4899.0199999999995,5,5,5,15,Champions
15906,34,4,4761.03,5,4,5,14,Champions
15907,120,1,4.99,4,1,1,6,At Risk
15908,201,6,1413.93,3,5,4,12,Loyal
15909,194,5,1380.25,3,5,4,12,Loyal
15910,313,2,39.980000000000004,1,1,1,3,At Risk
15911,114,2,26.97,4,1,1,6,At Risk
15912,237,3,93.97,2,3,3,8,Potential
15913,308,4,712.27,1,4,3,8,Potential
15914,144,3,3080.2699999999995,3,3,4,10,Loyal
15915,123,2,3102.9799999999996,4,1,4,9,Potential
15916,55,8,4793.27,5,5,5,15,Champions
15917,36,2,4679.0599999999995,5,1,5,11,Loyal
15918,126,4,3149.95,4,4,4,12,Loyal
15919,36,3,83.97,5,3,2,10,Loyal
15920,193,5,6247.5225,3,5,5,13,Champions
15921,124,7,6549.289999999999,4,5,5,14,Champions
15922,122,6,148.2,4,5,3,12,Loyal
15923,48,8,6592.78,5,5,5,15,Champions
15924,182,6,5744.0025,3,5,5,13,Champions
15925,163,4,5905.8099999999995,3,4,5,12,Loyal
15926,204,9,6978.5625,3,5,5,13,Champions
15927,211,6,6932.9025,2,5,5,12,Loyal
15928,190,7,6960.0824999999995,3,5,5,13,Champions
15929,141,7,6944.5824999999995,3,5,5,13,Champions
15930,145,4,83.97,3,4,2,9,Potential
15931,172,7,5362.29,3,5,5,13,Champions
15932,161,5,7186.389999999999,3,5,5,13,Champions
15933,141,7,6931.8825,3,5,5,13,Champions
15934,143,5,3147.95,3,5,4,12,Loyal
15935,286,2,7.28,2,1,1,4,At Risk
15936,89,2,39.980000000000004,4,1,1,6,At Risk
15937,123,5,3145.2599999999993,4,5,4,13,Champions
15938,96,2,7.28,4,1,1,6,At Risk
15939,211,2,39.980000000000004,2,1,1,4,At Risk
15940,336,2,7.28,1,1,1,3,At Risk
15941,142,3,3105.2699999999995,3,3,4,10,Loyal
15942,130,7,191.87,4,5,3,12,Loyal
15943,156,9,365.40999999999997,3,5,3,11,Loyal
15944,152,6,3234.9399999999996,3,5,4,12,Loyal
15945,182,2,7.28,3,1,1,5,At Risk
15946,282,3,103.48,2,3,3,8,Potential
15947,152,2,7.28,3,1,1,5,At Risk
15948,139,4,3092.9599999999996,3,4,4,11,Loyal
15949,153,3,3157.9699999999993,3,3,4,10,Loyal
15950,112,2,7.28,4,1,1,6,At Risk
15951,283,2,39.980000000000004,2,1,1,4,At Risk
15952,142,4,3174.95,3,4,4,11,Loyal
15953,183,3,1357.97,3,3,4,10,Loyal
15954,137,4,3117.9599999999996,3,4,4,11,Loyal
15955,234,2,39.980000000000004,2,1,1,4,At Risk
15956,63,1,4.99,5,1,1,7,Potential
15957,191,2,163.99,3,1,3,7,Potential
15958,251,2,68.49,2,1,2,5,At Risk
15959,142,4,3117.9699999999993,3,4,4,11,Loyal
15960,35,1,4.99,5,1,1,7,Potential
15961,137,4,3127.25,3,4,4,11,Loyal
15962,67,3,61.96,5,3,2,10,Loyal
15963,301,3,89.97,1,3,2,6,At Risk
15964,130,4,3117.9599999999996,4,4,4,12,Loyal
15965,135,4,3108.95,3,4,4,11,Loyal
15966,152,1,4.99,3,1,1,5,At Risk
15967,259,1,4.99,2,1,1,4,At Risk
15968,127,3,3099.96,4,3,4,11,Loyal
15969,140,4,3109.95,3,4,4,11,Loyal
15970,246,2,39.980000000000004,2,1,1,4,At Risk
15971,224,2,39.980000000000004,2,1,1,4,At Risk
15972,123,6,3148.9399999999996,4,5,4,13,Champions
15973,57,2,39.980000000000004,5,1,1,7,Potential
15974,70,7,208.41,5,5,3,13,Champions
15975,133,3,166.28,4,3,3,10,Loyal
15976,137,3,3157.9699999999993,3,3,4,10,Loyal
15977,93,2,39.980000000000004,4,1,1,6,At Risk
15978,67,2,7.28,5,1,1,7,Potential
15979,217,1,4.99,2,1,1,4,At Risk
15980,138,2,3077.9799999999996,3,1,4,8,Potential
15981,270,2,124.99,2,1,3,6,At Risk
15982,120,1,4.99,4,1,1,6,At Risk
15983,152,4,3134.95,3,4,4,11,Loyal
15984,125,3,3124.96,4,3,4,11,Loyal
15985,149,4,3179.95,3,4,4,11,Loyal
15986,199,6,1422.94,3,5,4,12,Loyal
15987,158,4,1404.95,3,4,4,11,Loyal
15988,95,4,89.91,4,4,2,10,Loyal
15989,144,4,3140.92,3,4,4,11,Loyal
15990,131,3,3099.96,4,3,4,11,Loyal
15991,147,4,3127.25,3,4,4,11,Loyal
15992,151,6,3194.93,3,5,4,12,Loyal
15993,251,4,597.26,2,4,3,9,Potential
15994,182,5,1391.95,3,5,4,12,Loyal
15995,168,4,608.96,3,4,3,10,Loyal
15996,259,1,564.99,2,1,3,6,At Risk
15997,41,5,4746.34,5,5,5,15,Champions
15998,143,3,2371.9599999999996,3,3,4,10,Loyal
15999,145,2,2354.9799999999996,3,1,4,8,Potential
16000,55,8,4813.95,5,5,5,15,Champions
16001,327,2,7.28,1,1,1,3,At Risk
16002,332,3,61.96,1,3,2,6,At Risk
16003,301,1,4.99,1,1,1,3,At Risk
16004,140,6,2518.2499999999995,3,5,4,12,Loyal
16005,178,6,198.73,3,5,3,11,Loyal
16006,247,2,39.980000000000004,2,1,1,4,At Risk
16007,153,2,2329.99,3,1,4,8,Potential
16008,18,1,4.99,5,1,1,7,Recent Customer
16009,119,4,170.45,4,4,3,11,Loyal
16010,184,2,7.28,3,1,1,5,At Risk
16011,106,6,3657.2599999999993,4,5,5,14,Champions
16012,221,3,94.25999999999999,2,3,3,8,Potential
16013,346,3,89.97,1,3,2,6,At Risk
16014,180,2,7.28,3,1,1,5,At Risk
16015,373,2,574.98,1,1,3,5,At Risk
16016,107,7,117.93,4,5,3,12,Loyal
16017,182,2,59.980000000000004,3,1,2,6,At Risk
16018,359,3,89.97,1,3,2,6,At Risk
16019,172,2,573.98,3,1,3,7,Potential
16020,268,3,595.96,2,3,3,8,Potential
16021,216,1,539.99,2,1,3,6,At Risk
16022,176,4,589.96,3,4,3,10,Loyal
16023,173,7,166.89000000000001,3,5,3,11,Loyal
16024,20,1,4.99,5,1,1,7,Recent Customer
16025,54,4,3831.8896,5,4,5,14,Champions
16026,41,3,3804.0782,5,3,5,13,Champions
16027,55,3,3826.3996,5,3,5,13,Champions
16028,45,3,3807.3996,5,3,5,13,Champions
16029,54,3,3807.3996,5,3,5,13,Champions
16030,9,6,73.53999999999999,5,5,2,12,Recent Customer
16031,56,2,3750.0882,5,1,5,11,Loyal
16032,281,4,90.95,2,4,2,8,Potential
16033,33,4,3743.3925,5,4,5,14,Champions
16034,65,2,7.28,5,1,1,7,Potential
16035,5,3,51.46,5,3,2,10,Recent Customer
16036,217,3,61.96000000000001,2,3,2,7,Potential
16037,230,2,39.980000000000004,2,1,1,4,At Risk
16038,50,4,84.25,5,4,2,11,Loyal
16039,345,1,4.99,1,1,1,3,At Risk
16040,332,3,64.97,1,3,2,6,At Risk
16041,365,3,64.97,1,3,2,6,At Risk
16042,214,1,24.99,2,1,1,4,At Risk
16043,54,3,61.96000000000001,5,3,2,10,Loyal
16044,318,2,68.49,1,1,2,4,At Risk
16045,42,6,3802.3725,5,5,5,15,Champions
16046,60,4,3963.14,5,4,5,14,Champions
16047,62,1,4.99,5,1,1,7,Potential
16048,288,2,39.980000000000004,2,1,1,4,At Risk
16049,208,2,39.980000000000004,2,1,1,4,At Risk
16050,104,5,76.94,4,5,2,11,Loyal
16051,51,2,2746.5525,5,1,4,10,Loyal
16052,35,3,2731.5425,5,3,4,12,Loyal
16053,37,5,3752.3825,5,5,5,15,Champions
16054,42,6,3759.3625,5,5,5,15,Champions
16055,291,5,66.44,1,5,2,8,Potential
16056,126,2,27.279999999999998,4,1,1,6,At Risk
16057,351,2,39.980000000000004,1,1,1,3,At Risk
16058,84,4,38.25,4,4,1,9,Potential
16059,317,3,146.97,1,3,3,7,Potential
16060,6,2,7.28,5,1,1,7,Recent Customer
16061,170,3,592.27,3,3,3,9,Potential
16062,43,2,7.28,5,1,1,7,Potential
16063,194,1,4.99,3,1,1,5,At Risk
16064,154,2,7.28,3,1,1,5,At Risk
16065,141,4,572.26,3,4,3,10,Loyal
16066,139,5,611.94,3,5,3,11,Loyal
16067,150,6,664.89,3,5,3,11,Loyal
16068,133,4,563.96,4,4,3,11,Loyal
16069,139,3,579.97,3,3,3,9,Potential
16070,24,2,39.980000000000004,5,1,1,7,Recent Customer
16071,25,5,103.55000000000001,5,5,3,13,Recent Customer
16072,109,3,166.28,4,3,3,10,Loyal
16073,48,3,64.47,5,3,2,10,Loyal
16074,258,2,39.980000000000004,2,1,1,4,At Risk
16075,95,2,7.28,4,1,1,6,At Risk
16076,14,2,7.28,5,1,1,7,Recent Customer
16077,132,4,2401.4499999999994,4,4,4,12,Loyal
16078,140,6,2383.9499999999994,3,5,4,12,Loyal
16079,142,3,2324.9199999999996,3,3,4,10,Loyal
16080,143,3,567.27,3,3,3,9,Potential
16081,95,1,2319.99,4,1,4,9,Potential
16082,216,2,39.980000000000004,2,1,1,4,At Risk
16083,225,2,561.97,2,1,3,6,At Risk
16084,45,1,4.99,5,1,1,7,Potential
16085,211,7,143.53,2,5,3,10,Loyal
16086,93,4,2406.95,4,4,4,12,Loyal
16087,107,4,2369.9699999999993,4,4,4,12,Loyal
16088,253,2,7.28,2,1,1,4,At Risk
16089,88,8,342.03000000000003,4,5,3,12,Loyal
16090,106,4,604.96,4,4,3,11,Loyal
16091,217,2,39.980000000000004,2,1,1,4,At Risk
16092,127,2,7.28,4,1,1,6,At Risk
16093,123,3,554.97,4,3,3,10,Loyal
16094,137,3,567.27,3,3,3,9,Potential
16095,114,2,2329.99,4,1,4,9,Potential
16096,96,9,212.01,4,5,3,12,Loyal
16097,196,5,103.55000000000001,3,5,3,11,Loyal
16098,166,7,3101.2899999999995,3,5,4,12,Loyal
16099,61,3,89.97,5,3,2,10,Loyal
16100,115,4,2369.9599999999996,4,4,4,12,Loyal
16101,107,2,2322.2799999999997,4,1,4,9,Potential
16102,131,4,563.96,4,4,3,11,Loyal
16103,177,4,3142.3199999999997,3,4,4,11,Loyal
16104,93,4,2414.97,4,4,4,12,Loyal
16105,122,4,2361.9499999999994,4,4,4,12,Loyal
16106,16,9,157.51,5,5,3,13,Recent Customer
16107,260,2,39.980000000000004,2,1,1,4,At Risk
16108,102,4,633.96,4,4,3,11,Loyal
16109,96,2,548.98,4,1,3,8,Potential
16110,97,3,650.47,4,3,3,10,Loyal
16111,116,5,2340.9399999999996,4,5,4,13,Champions
16112,120,4,2373.4699999999993,4,4,4,12,Loyal
16113,109,5,2391.9499999999994,4,5,4,13,Champions
16114,104,1,2319.99,4,1,4,9,Potential
16115,307,2,7.28,1,1,1,3,At Risk
16116,96,2,2341.97,4,1,4,9,Potential
16117,69,4,86.45,5,4,2,11,Loyal
16118,100,5,2563.91,4,5,4,13,Champions
16119,355,2,13.98,1,1,1,3,At Risk
16120,91,2,7.28,4,1,1,6,At Risk
16121,67,3,614.47,5,3,3,11,Loyal
16122,115,3,569.97,4,3,3,10,Loyal
16123,85,3,629.97,4,3,3,10,Loyal
16124,72,5,614.45,5,5,3,13,Champions
16125,57,4,588.96,5,4,3,12,Loyal
16126,122,3,579.97,4,3,3,10,Loyal
16127,107,4,618.47,4,4,3,11,Loyal
16128,47,1,539.99,5,1,3,9,Potential
16129,78,1,564.99,4,1,3,8,Potential
16130,140,3,61.96,3,3,2,8,Potential
16131,85,3,166.28,4,3,3,10,Loyal
16132,376,4,2459.62,1,4,4,9,Potential
16133,25,8,164.82000000000002,5,5,3,13,Recent Customer
16134,278,2,13.98,2,1,1,4,At Risk
16135,86,3,579.97,4,3,3,10,Loyal
16136,63,1,564.99,5,1,3,9,Potential
16137,81,3,554.97,4,3,3,10,Loyal
16138,85,1,564.99,4,1,3,8,Potential
16139,81,5,654.95,4,5,3,12,Loyal
16140,310,3,2528.3299999999995,1,3,4,8,Potential
16141,91,4,589.96,4,4,3,11,Loyal
16142,84,4,563.96,4,4,3,11,Loyal
16143,289,2,26.97,1,1,1,3,At Risk
16144,106,3,2376.9599999999996,4,3,4,11,Loyal
16145,117,2,2322.2799999999997,4,1,4,9,Potential
16146,104,2,2329.9799999999996,4,1,4,9,Potential
16147,95,6,2367.2,4,5,4,13,Champions
16148,122,1,2319.99,4,1,4,9,Potential
16149,128,7,192.04,4,5,3,12,Loyal
16150,79,3,629.97,4,3,3,10,Loyal
16151,89,5,639.45,4,5,3,12,Loyal
16152,101,3,64.47,4,3,2,9,Potential
16153,170,2,39.980000000000004,3,1,1,5,At Risk
16154,202,1,4.99,3,1,1,5,At Risk
16155,72,5,4489.5682,5,5,5,15,Champions
16156,76,2,4344.0882,4,1,5,10,Loyal
16157,87,2,4391.4096,4,1,5,10,Loyal
16158,85,2,4369.0882,4,1,5,10,Loyal
16159,37,5,4411.6496,5,5,5,15,Champions
16160,225,4,2644.0681999999997,2,4,4,10,Loyal
16161,187,5,2700.0481999999997,3,5,4,12,Loyal
16162,75,7,185.04,4,5,3,12,Loyal
16163,147,4,2641.3896000000004,3,4,4,11,Loyal
16164,137,3,2639.0782,3,3,4,10,Loyal
16165,130,6,81.81,4,5,2,11,Loyal
16166,108,6,108.85,4,5,3,12,Loyal
16167,42,4,102.57,5,4,3,12,Loyal
16168,306,6,80.11,1,5,2,8,Potential
16169,61,3,4404.0782,5,3,5,13,Champions
16170,1,5,188.87,5,5,3,13,Recent Customer
16171,264,5,103.86,2,5,3,10,Loyal
16172,98,7,186.04,4,5,3,12,Loyal
16173,241,5,43.21,2,5,2,9,Potential
16174,225,6,140.45,2,5,3,10,Loyal
16175,3,5,70.25,5,5,2,12,Recent Customer
16176,56,3,4404.0782,5,3,5,13,Champions
16177,199,7,133.34,3,5,3,11,Loyal
16178,71,6,108.85,5,5,3,13,Champions
16179,69,5,72.16,5,5,2,12,Loyal
16180,56,5,4386.3682,5,5,5,15,Champions
16181,38,6,170.06,5,5,3,13,Champions
16182,41,3,83.97,5,3,2,10,Loyal
16183,261,3,31.27,2,3,1,6,At Risk
16184,87,6,78.2,4,5,2,11,Loyal
16185,254,2,28.979999999999997,2,1,1,4,At Risk
16186,214,3,64.97,2,3,2,7,Potential
16187,67,3,34.92,5,3,1,9,Potential
16188,22,4,96.95,5,4,3,12,Recent Customer
16189,52,5,105.94000000000001,5,5,3,13,Champions
16190,57,4,79.25,5,4,2,11,Loyal
16191,31,2,26.97,5,1,1,7,Potential
16192,276,4,101.45,2,4,3,9,Potential
16193,278,3,90.47,2,3,2,7,Potential
16194,311,2,49.48,1,1,2,4,At Risk
16195,252,3,92.48,2,3,3,8,Potential
16196,155,7,7237.36,3,5,5,13,Champions
16197,90,3,2756.5424999999996,4,3,4,11,Loyal
16198,203,4,114.96,3,4,3,10,Loyal
16199,163,5,6917.5925,3,5,5,13,Champions
16200,280,4,96.95,2,4,3,9,Potential
16201,192,5,3058.0125,3,5,4,12,Loyal
16202,112,3,31.27,4,3,1,8,Potential
16203,103,8,6939.8724999999995,4,5,5,14,Champions
16204,87,5,7162.389999999999,4,5,5,14,Champions
16205,79,7,6950.572499999999,4,5,5,14,Champions
16206,157,8,7203.349999999999,3,5,5,13,Champions
16207,149,7,7226.369999999999,3,5,5,13,Champions
16208,331,4,119.96000000000001,1,4,3,8,Potential
16209,360,2,30.97,1,1,1,3,At Risk
16210,44,5,645.94,5,5,3,13,Champions
16211,58,2,586.97,5,1,3,9,Potential
16212,44,2,39.980000000000004,5,1,1,7,Potential
16213,109,6,154.54000000000002,4,5,3,12,Loyal
16214,304,3,15.23,1,3,1,5,At Risk
16215,38,5,617.9100000000001,5,5,3,13,Champions
16216,55,3,614.47,5,3,3,11,Loyal
16217,153,2,124.99,3,1,3,7,Potential
16218,382,2,574.98,1,1,3,5,At Risk
16219,234,3,553.97,2,3,3,8,Potential
16220,189,4,562.96,3,4,3,10,Loyal
16221,348,4,588.96,1,4,3,8,Potential
16222,349,2,561.48,1,1,3,5,At Risk
16223,349,4,562.96,1,4,3,8,Potential
16224,337,4,556.26,1,4,3,8,Potential
16225,332,3,553.97,1,3,3,7,Potential
16226,332,3,553.97,1,3,3,7,Potential
16227,364,3,80.96000000000001,1,3,2,6,At Risk
16228,49,3,569.97,5,3,3,11,Loyal
16229,53,4,572.26,5,4,3,12,Loyal
16230,42,2,618.98,5,1,3,9,Potential
16231,383,3,2525.94,1,3,4,8,Potential
16232,346,2,2475.95,1,1,4,6,At Risk
16233,15,4,114.46,5,4,3,12,Recent Customer
16234,241,2,13.98,2,1,1,4,At Risk
16235,345,1,2443.35,1,1,4,6,At Risk
16236,126,4,98.96000000000001,4,4,3,11,Loyal
16237,333,4,2514.93,1,4,4,9,Potential
16238,295,2,12.940000000000001,1,1,1,3,At Risk
16239,24,2,39.980000000000004,5,1,1,7,Recent Customer
16240,27,1,4.99,5,1,1,7,Recent Customer
16241,138,3,126.96000000000001,3,3,3,9,Potential
16242,220,2,7.28,2,1,1,4,At Risk
16243,156,2,91.97,3,1,2,6,At Risk
16244,107,4,2369.9699999999993,4,4,4,12,Loyal
16245,6,1,4.99,5,1,1,7,Recent Customer
16246,236,2,12.940000000000001,2,1,1,4,At Risk
16247,191,8,95.82000000000001,3,5,3,11,Loyal
16248,272,2,39.980000000000004,2,1,1,4,At Risk
16249,275,2,13.98,2,1,1,4,At Risk
16250,32,3,4511.5425,5,3,5,13,Champions
16251,42,2,26.97,5,1,1,7,Potential
16252,88,3,2781.5424999999996,4,3,4,11,Loyal
16253,73,2,2721.5525,5,1,4,10,Loyal
16254,342,1,24.99,1,1,1,3,At Risk
16255,287,3,187.98,2,3,3,8,Potential
16256,147,3,81.96000000000001,3,3,2,8,Potential
16257,14,4,72.96000000000001,5,4,2,11,Recent Customer
16258,41,3,63.97,5,3,2,10,Loyal
16259,52,3,2756.5424999999996,5,3,4,12,Loyal
16260,175,5,3001.0225,3,5,4,12,Loyal
16261,78,7,7170.87,4,5,5,14,Champions
16262,47,8,6949.572499999999,5,5,5,15,Champions
16263,132,7,7243.36,4,5,5,14,Champions
16264,66,3,61.96000000000001,5,3,2,10,Loyal
16265,119,2,27.279999999999998,4,1,1,6,At Risk
16266,208,3,63.97,2,3,2,7,Potential
16267,68,3,3037.3299999999995,5,3,4,12,Loyal
16268,45,5,2778.8225,5,5,4,14,Champions
16269,49,5,2778.8225,5,5,4,14,Champions
16270,58,5,2771.5225,5,5,4,14,Champions
16271,45,4,3014.31,5,4,4,13,Champions
16272,168,3,3021.0424999999996,3,3,4,10,Loyal
16273,60,4,2803.5225,5,4,4,13,Champions
16274,27,1,4.99,5,1,1,7,Recent Customer
16275,172,3,3282.8299999999995,3,3,5,11,Loyal
16276,48,2,7.28,5,1,1,7,Potential
16277,176,4,3010.0325000000003,3,4,4,11,Loyal
16278,54,3,2992.33,5,3,4,12,Loyal
16279,124,3,48.97,4,3,2,9,Potential
16280,86,2,12.940000000000001,4,1,1,6,At Risk
16281,216,3,63.97,2,3,2,7,Potential
16282,214,4,64.25,2,4,2,8,Potential
16283,118,3,63.97,4,3,2,9,Potential
16284,231,2,7.28,2,1,1,4,At Risk
16285,13,5,76.94,5,5,2,12,Recent Customer
16286,58,4,6920.612499999999,5,4,5,14,Champions
16287,60,4,4538.8425,5,4,5,14,Champions
16288,50,3,2768.5325000000003,5,3,4,12,Loyal
16289,34,4,2778.5225,5,4,4,13,Champions
16290,60,6,2822.0125,5,5,4,14,Champions
16291,373,3,4921.69,1,3,5,9,Potential
16292,310,2,32.28,1,1,1,3,At Risk
16293,212,1,4.99,2,1,1,4,At Risk
16294,208,2,13.98,2,1,1,4,At Risk
16295,318,5,138.45,1,5,3,9,Potential
16296,58,5,122.95,5,5,3,13,Champions
16297,97,4,6889.612499999999,4,4,5,13,Champions
16298,120,9,7000.8724999999995,4,5,5,14,Champions
16299,280,1,4.99,2,1,1,4,At Risk
16300,40,4,111.95,5,4,3,12,Loyal
16301,319,4,72.96000000000001,1,4,2,7,Potential
16302,281,1,24.99,2,1,1,4,At Risk
16303,3,3,149.98,5,3,3,11,Recent Customer
16304,274,2,49.48,2,1,2,5,At Risk
16305,46,2,2983.34,5,1,4,10,Loyal
16306,98,3,29.26,4,3,1,8,Potential
16307,100,5,6917.5925,4,5,5,14,Champions
16308,37,5,4551.522499999999,5,5,5,15,Champions
16309,121,6,6910.5925,4,5,5,14,Champions
16310,100,5,6010.16,4,5,5,14,Champions
16311,390,5,2988.3225,1,5,4,10,Loyal
16312,68,3,63.97,5,3,2,10,Loyal
16313,397,6,4985.66,1,5,5,11,Loyal
16314,211,4,111.95,2,4,3,9,Potential
16315,99,2,28.979999999999997,4,1,1,6,At Risk
16316,378,4,4659.8025,1,4,5,10,Loyal
16317,136,3,3001.0425,3,3,4,10,Loyal
16318,149,5,3021.0225,3,5,4,12,Loyal
16319,311,2,27.279999999999998,1,1,1,3,At Risk
16320,334,2,49.48,1,1,2,4,At Risk
16321,29,5,97.25,5,5,3,13,Recent Customer
16322,166,2,28.979999999999997,3,1,1,5,At Risk
16323,163,1,24.99,3,1,1,5,At Risk
16324,354,5,3282.81,1,5,5,11,Loyal
16325,68,4,171.27,5,4,3,12,Loyal
16326,295,1,24.99,1,1,1,3,At Risk
16327,368,5,4647.8825,1,5,5,11,Loyal
16328,133,3,3001.0425,4,3,4,11,Loyal
16329,132,6,3272.09,4,5,5,14,Champions
16330,254,3,31.27,2,3,1,6,At Risk
16331,8,8,118.78,5,5,3,13,Recent Customer
16332,37,6,147.23,5,5,3,13,Champions
16333,239,2,56.97,2,1,2,5,At Risk
16334,364,3,84.92,1,3,2,6,At Risk
16335,128,3,36.96,4,3,1,8,Potential
16336,120,3,64.47,4,3,2,9,Potential
16337,64,2,7.28,5,1,1,7,Potential
16338,274,6,169.43,2,5,3,10,Loyal
16339,387,2,3169.5882,1,1,4,6,At Risk
16340,307,4,608.96,1,4,3,8,Potential
16341,113,4,88.25,4,4,2,10,Loyal
16342,30,6,143.39,5,5,3,13,Recent Customer
16343,90,4,58.25,4,4,2,10,Loyal
16344,100,1,2294.99,4,1,4,9,Potential
16345,104,4,4173.24,4,4,5,13,Champions
16346,37,5,37.55,5,5,1,11,Loyal
16347,38,5,5918.5,5,5,5,15,Champions
16348,37,4,5918.24,5,4,5,14,Champions
16349,42,2,5898.26,5,1,5,11,Loyal
16350,37,4,5903.19,5,4,5,14,Champions
16351,57,2,5873.26,5,1,5,11,Loyal
16352,59,6,5948.49,5,5,5,15,Champions
16353,234,3,106.96000000000001,2,3,3,8,Potential
16354,326,2,574.98,1,1,3,5,At Risk
16355,315,3,89.97,1,3,2,6,At Risk
16356,198,2,7.28,3,1,1,5,At Risk
16357,156,1,4.99,3,1,1,5,At Risk
16358,126,6,87.95,4,5,2,11,Loyal
16359,169,2,7.28,3,1,1,5,At Risk
16360,334,3,553.97,1,3,3,7,Potential
16361,324,4,2514.93,1,4,4,9,Potential
16362,286,4,2482.23,2,4,4,10,Loyal
16363,316,4,2481.8199999999997,1,4,4,9,Potential
16364,281,4,2482.23,2,4,4,10,Loyal
16365,74,5,2490.18,4,5,4,13,Champions
16366,79,2,2563.35,4,1,4,9,Potential
16367,93,2,39.980000000000004,4,1,1,6,At Risk
16368,28,4,98.96000000000001,5,4,3,12,Recent Customer
16369,149,2,26.97,3,1,1,5,At Risk
16370,2,6,132.5,5,5,3,13,Recent Customer
16371,228,2,54.980000000000004,2,1,2,5,At Risk
16372,300,4,2482.23,1,4,4,9,Potential
16373,288,5,2578.43,2,5,4,11,Loyal
16374,40,3,15.23,5,3,1,9,Potential
16375,259,2,2478.3399999999997,2,1,4,7,Potential
16376,88,2,7.28,4,1,1,6,At Risk
16377,340,2,13.98,1,1,1,3,At Risk
16378,46,2,13.98,5,1,1,7,Potential
16379,57,2,58.980000000000004,5,1,2,8,Potential
16380,58,4,195.95,5,4,3,12,Loyal
16381,335,1,4.99,1,1,1,3,At Risk
16382,297,2,59.980000000000004,1,1,2,4,At Risk
16383,332,2,58.980000000000004,1,1,2,4,At Risk
16384,363,2,7.28,1,1,1,3,At Risk
16385,238,3,64.47,2,3,2,7,Potential
16386,157,5,129.95000000000002,3,5,3,11,Loyal
16387,41,4,94.96000000000001,5,4,3,12,Loyal
16388,384,5,4673.8825,1,5,5,11,Loyal
16389,289,4,4638.8925,1,4,5,10,Loyal
16390,294,3,4657.512500000001,1,3,5,9,Potential
16391,376,2,4624.9125,1,1,5,7,Potential
16392,120,5,5786.3825,4,5,5,14,Champions
16393,106,7,5841.3724999999995,4,5,5,14,Champions
16394,384,3,4659.9025,1,3,5,9,Potential
16395,336,3,63.97,1,3,2,6,At Risk
16396,300,3,32.269999999999996,1,3,1,5,At Risk
16397,182,3,64.97,3,3,2,8,Potential
16398,324,3,53.47,1,3,2,6,At Risk
16399,319,3,32.269999999999996,1,3,1,5,At Risk
16400,367,5,4958.28,1,5,5,11,Loyal
16401,82,5,102.25,4,5,3,12,Loyal
16402,1,2,9.98,5,1,1,7,Recent Customer
16403,50,3,37.97,5,3,1,9,Potential
16404,94,6,6002.16,4,5,5,14,Champions
16405,350,3,3262.83,1,3,4,8,Potential
16406,363,3,3110.0525,1,3,4,8,Potential
16407,105,5,3250.1099999999997,4,5,4,13,Champions
16408,316,5,4692.8825,1,5,5,11,Loyal
16409,263,5,4925.17,2,5,5,12,Loyal
16410,111,4,3242.77,4,4,4,12,Loyal
16411,272,3,4659.9025,2,3,5,10,Loyal
16412,285,4,4921.59,2,4,5,11,Loyal
16413,330,3,37.93,1,3,1,5,At Risk
16414,246,3,4919.299999999999,2,3,5,10,Loyal
16415,280,4,4930.679999999999,2,4,5,11,Loyal
16416,285,4,4971.679999999999,2,4,5,11,Loyal
16417,110,3,3001.0425,4,3,4,11,Loyal
16418,350,2,27.279999999999998,1,1,1,3,At Risk
16419,92,2,27.279999999999998,4,1,1,6,At Risk
16420,109,3,2959.0025,4,3,4,11,Loyal
16421,91,3,31.27,4,3,1,8,Potential
16422,212,3,4632.862499999999,2,3,5,10,Loyal
16423,120,3,83.97,4,3,2,9,Potential
16424,116,4,5738.3825,4,4,5,13,Champions
16425,119,4,5718.692499999999,4,4,5,13,Champions
16426,88,7,5768.362499999999,4,5,5,14,Champions
16427,363,5,2975.0225,1,5,4,10,Loyal
16428,116,5,3021.0225,4,5,4,13,Champions
16429,192,5,4958.28,3,5,5,13,Champions
16430,265,4,4638.8925,2,4,5,11,Loyal
16431,267,4,4769.4025,2,4,5,11,Loyal
16432,225,3,4633.9025,2,3,5,10,Loyal
16433,241,5,4696.4925,2,5,5,12,Loyal
16434,241,3,69.97,2,3,2,7,Potential
16435,43,2,6.28,5,1,1,7,Potential
16436,211,5,4696.4925,2,5,5,12,Loyal
16437,231,4,47.260000000000005,2,4,2,8,Potential
16438,278,1,24.99,2,1,1,4,At Risk
16439,153,1,24.99,3,1,1,5,At Risk
16440,337,2,28.979999999999997,1,1,1,3,At Risk
16441,348,1,24.99,1,1,1,3,At Risk
16442,187,4,4923.29,3,4,5,12,Loyal
16443,6,4,66.95,5,4,2,11,Recent Customer
16444,324,4,3271.8199999999997,1,4,4,9,Potential
16445,83,3,3242.83,4,3,4,11,Loyal
16446,87,4,3093.0325000000003,4,4,4,12,Loyal
16447,245,5,3001.0225,2,5,4,11,Loyal
16448,105,6,6906.8925,4,5,5,14,Champions
16449,249,4,47.260000000000005,2,4,2,8,Potential
16450,109,3,37.97,4,3,1,8,Potential
16451,157,3,4632.862499999999,3,3,5,11,Loyal
16452,82,6,3071.0125,4,5,4,13,Champions
16453,96,4,14.56,4,4,1,9,Potential
16454,281,4,47.260000000000005,2,4,2,8,Potential
16455,308,2,28.979999999999997,1,1,1,3,At Risk
16456,145,3,64.97,3,3,2,8,Potential
16457,169,3,149.98,3,3,3,9,Potential
16458,308,1,24.99,1,1,1,3,At Risk
16459,300,4,47.260000000000005,1,4,2,7,Potential
16460,67,4,47.260000000000005,5,4,2,11,Loyal
16461,67,4,3287.3199999999997,5,4,5,14,Champions
16462,19,2,49.48,5,1,2,8,Recent Customer
16463,232,4,59.91,2,4,2,8,Potential
16464,144,3,44.970000000000006,3,3,2,8,Potential
16465,89,7,3271.7899999999995,4,5,4,13,Champions
16466,124,2,4624.9125,4,1,5,10,Loyal
16467,14,3,12.27,5,3,1,9,Recent Customer
16468,143,3,63.97,3,3,2,8,Potential
16469,288,3,63.97,2,3,2,7,Potential
16470,263,3,3021.0424999999996,2,3,4,9,Potential
16471,57,3,53.47,5,3,2,10,Loyal
16472,89,2,27.279999999999998,4,1,1,6,At Risk
16473,116,1,24.99,4,1,1,6,At Risk
16474,307,1,24.99,1,1,1,3,At Risk
16475,142,5,4673.8825,3,5,5,13,Champions
16476,167,5,4715.4925,3,5,5,13,Champions
16477,348,2,39.980000000000004,1,1,1,3,At Risk
16478,109,5,2385.9399999999996,4,5,4,13,Champions
16479,68,9,158.51000000000002,5,5,3,13,Champions
16480,17,5,144.94,5,5,3,13,Recent Customer
16481,39,8,194.91,5,5,3,13,Champions
16482,343,4,4783.74,1,4,5,10,Loyal
16483,69,2,4118.26,5,1,5,11,Loyal
16484,88,5,4175.53,4,5,5,14,Champions
16485,109,2,39.980000000000004,4,1,1,6,At Risk
16486,28,5,113.24000000000001,5,5,3,13,Recent Customer
16487,196,5,73.24,3,5,2,10,Loyal
16488,22,8,232.42000000000002,5,5,3,13,Recent Customer
16489,265,6,112.73,2,5,3,10,Loyal
16490,255,2,2478.3399999999997,2,1,4,7,Potential
16491,166,4,3106.3299999999995,3,4,4,11,Loyal
16492,7,6,130.94,5,5,3,13,Recent Customer
16493,40,3,4197.25,5,3,5,13,Champions
16494,44,4,5961.2,5,4,5,14,Champions
16495,55,6,6002.23,5,5,5,15,Champions
16496,35,5,5960.23,5,5,5,15,Champions
16497,50,8,132.71,5,5,3,13,Champions
16498,144,2,39.980000000000004,3,1,1,5,At Risk
16499,37,1,4.99,5,1,1,7,Potential
16500,284,4,588.96,2,4,3,9,Potential
16501,149,1,4.99,3,1,1,5,At Risk
16502,17,2,39.980000000000004,5,1,1,7,Recent Customer
16503,257,1,4.99,2,1,1,4,At Risk
16504,299,4,588.96,1,4,3,8,Potential
16505,49,2,39.980000000000004,5,1,1,7,Potential
16506,6,6,102.04,5,5,3,13,Recent Customer
16507,199,3,35.23,3,3,1,7,Potential
16508,159,3,83.97,3,3,2,8,Potential
16509,83,6,3258.7899999999995,4,5,4,13,Champions
16510,296,2,27.279999999999998,1,1,1,3,At Risk
16511,198,4,47.260000000000005,3,4,2,9,Potential
16512,260,3,3262.83,2,3,4,9,Potential
16513,175,5,4669.452499999999,3,5,5,13,Champions
16514,353,4,4761.74,1,4,5,10,Loyal
16515,317,3,4733.75,1,3,5,9,Potential
16516,322,3,4733.75,1,3,5,9,Potential
16517,313,2,4698.76,1,1,5,7,Potential
16518,309,2,4698.76,1,1,5,7,Potential
16519,295,3,4752.75,1,3,5,9,Potential
16520,298,4,4727.74,1,4,5,10,Loyal
16521,303,2,4698.76,1,1,5,7,Potential
16522,296,2,4698.76,1,1,5,7,Potential
16523,298,2,4698.76,1,1,5,7,Potential
16524,276,3,4733.75,2,3,5,10,Loyal
16525,268,3,4752.75,2,3,5,10,Loyal
16526,232,4,4758.24,2,4,5,11,Loyal
16527,218,3,4752.75,2,3,5,10,Loyal
16528,222,2,4698.76,2,1,5,8,Potential
16529,225,3,4752.75,2,3,5,10,Loyal
16530,59,3,3001.0425,5,3,4,12,Loyal
16531,50,6,3291.7999999999997,5,5,5,15,Champions
16532,130,3,4921.69,4,3,5,12,Loyal
16533,127,5,4702.3925,4,5,5,14,Champions
16534,99,5,4820.5025000000005,4,5,5,14,Champions
16535,240,3,37.97,2,3,1,6,At Risk
16536,243,2,27.279999999999998,2,1,1,4,At Risk
16537,248,1,24.99,2,1,1,4,At Risk
16538,114,3,4659.9025,4,3,5,12,Loyal
16539,357,3,83.97,1,3,2,6,At Risk
16540,68,5,4696.4925,5,5,5,15,Champions
16541,50,4,3028.0225,5,4,4,13,Champions
16542,34,3,44.970000000000006,5,3,2,10,Loyal
16543,143,4,53.96000000000001,3,4,2,9,Potential
16544,181,2,28.979999999999997,3,1,1,5,At Risk
16545,109,3,31.27,4,3,1,8,Potential
16546,47,4,3036.5325000000003,5,4,4,13,Champions
16547,120,4,4900.679999999999,4,4,5,13,Champions
16548,70,2,4624.9125,5,1,5,11,Loyal
16549,88,4,4930.679999999999,4,4,5,13,Champions
16550,46,3,3001.0425,5,3,4,12,Loyal
16551,65,7,5032.76,5,5,5,15,Champions
16552,74,5,4986.79,4,5,5,14,Champions
16553,244,3,3001.0425,2,3,4,9,Potential
16554,45,5,2990.5225,5,5,4,14,Champions
16555,132,3,31.27,4,3,1,8,Potential
16556,222,4,86.95,2,4,2,8,Potential
16557,309,3,31.27,1,3,1,5,At Risk
16558,311,1,24.99,1,1,1,3,At Risk
16559,37,6,4705.4825,5,5,5,15,Champions
16560,36,3,4633.9025,5,3,5,13,Champions
16561,39,4,3030.0325,5,4,4,13,Champions
16562,219,3,3001.0425,2,3,4,9,Potential
16563,205,5,62.95,3,5,2,10,Loyal
16564,157,4,132.27,3,4,3,10,Loyal
16565,85,8,7203.66,4,5,5,14,Champions
16566,62,7,5806.352499999999,5,5,5,15,Champions
16567,86,5,7159.7,4,5,5,14,Champions
16568,352,3,69.97,1,3,2,6,At Risk
16569,389,3,3936.5425,1,3,5,9,Potential
16570,376,4,4219.32,1,4,5,10,Loyal
16571,46,4,52.92,5,4,2,11,Loyal
16572,44,2,4886.7,5,1,5,11,Loyal
16573,43,3,3001.0425,5,3,4,12,Loyal
16574,64,3,44.970000000000006,5,3,2,10,Loyal
16575,149,8,6994.572499999999,3,5,5,13,Champions
16576,23,5,149.46,5,5,3,13,Recent Customer
16577,180,3,74.98,3,3,2,8,Potential
16578,85,3,74.98,4,3,2,9,Potential
16579,86,5,97.94999999999999,4,5,3,12,Loyal
16580,178,9,5429.759999999999,3,5,5,13,Champions
16581,96,4,50.230000000000004,4,4,2,10,Loyal
16582,341,1,35.0,1,1,1,3,At Risk
16583,21,3,42.28,5,3,2,10,Recent Customer
16584,200,5,172.95,3,5,3,11,Loyal
16585,130,5,7192.389999999999,4,5,5,14,Champions
16586,188,2,69.99000000000001,3,1,2,6,At Risk
16587,155,10,7063.5625,3,5,5,13,Champions
16588,146,8,6994.5824999999995,3,5,5,13,Champions
16589,134,6,7343.69,3,5,5,13,Champions
16590,165,5,168.95,3,5,3,11,Loyal
16591,85,4,137.95999999999998,4,4,3,11,Loyal
16592,321,3,74.98,1,3,2,6,At Risk
16593,255,4,101.75999999999999,2,4,3,9,Potential
16594,149,7,7231.37,3,5,5,13,Champions
16595,144,7,6901.3825,3,5,5,13,Champions
16596,162,3,4486.5425,3,3,5,11,Loyal
16597,333,3,103.49,1,3,3,7,Potential
16598,125,4,7131.4,4,4,5,13,Champions
16599,41,4,149.45999999999998,5,4,3,12,Loyal
16600,258,4,124.97,2,4,3,9,Potential
16601,74,4,86.25999999999999,4,4,2,10,Loyal
16602,148,3,77.27,3,3,2,8,Potential
16603,170,9,7000.5525,3,5,5,13,Champions
16604,96,2,56.97,4,1,2,7,Potential
16605,37,4,66.26,5,4,2,11,Loyal
16606,166,4,67.17,3,4,2,9,Potential
16607,53,4,5897.53,5,4,5,14,Champions
16608,68,4,101.57,5,4,3,12,Loyal
16609,301,9,344.04,1,5,3,9,Potential
16610,298,3,67.58,1,3,2,6,At Risk
16611,62,4,75.53,5,4,2,11,Loyal
16612,33,2,5898.26,5,1,5,11,Loyal
16613,162,6,129.35,3,5,3,11,Loyal
16614,73,5,71.16,5,5,2,12,Loyal
16615,214,6,95.84,2,5,3,10,Loyal
16616,55,5,5915.539999999999,5,5,5,15,Champions
16617,137,6,160.55,3,5,3,11,Loyal
16618,59,6,76.15,5,5,2,12,Loyal
16619,192,3,97.58,3,3,3,9,Potential
16620,57,3,5895.24,5,3,5,13,Champions
16621,139,5,73.86,3,5,2,10,Loyal
16622,5,5,106.56,5,5,3,13,Recent Customer
16623,52,5,5973.24,5,5,5,15,Champions
16624,37,4,5938.25,5,4,5,14,Champions
16625,210,6,81.81,2,5,2,9,Potential
16626,254,4,71.57,2,4,2,8,Potential
16627,214,3,64.88,2,3,2,7,Potential
16628,38,4,187.58,5,4,3,12,Loyal
16629,50,3,5933.26,5,3,5,13,Champions
16630,55,5,5973.24,5,5,5,15,Champions
16631,38,3,5900.549999999999,5,3,5,13,Champions
16632,107,4,68.87,4,4,2,10,Loyal
16633,24,4,101.57,5,4,3,12,Recent Customer
16634,99,5,106.56,4,5,3,12,Loyal
16635,8,8,161.29,5,5,3,13,Recent Customer
16636,50,4,5932.74,5,4,5,14,Champions
16637,51,3,5900.549999999999,5,3,5,13,Champions
16638,46,4,5974.23,5,4,5,14,Champions
16639,41,3,5908.25,5,3,5,13,Champions
16640,2,4,102.57,5,4,3,12,Recent Customer
16641,95,6,2391.43,4,5,4,13,Champions
16642,64,2,39.980000000000004,5,1,1,7,Potential
16643,261,3,126.96000000000001,2,3,3,8,Potential
16644,186,1,4.99,3,1,1,5,At Risk
16645,111,3,2357.2799999999997,4,3,4,11,Loyal
16646,37,8,250.91000000000003,5,5,3,13,Champions
16647,133,2,54.980000000000004,4,1,2,7,Potential
16648,50,2,7.28,5,1,1,7,Potential
16649,37,5,115.94,5,5,3,13,Champions
16650,84,1,4.99,4,1,1,6,At Risk
16651,67,2,13.98,5,1,1,7,Potential
16652,189,3,48.97,3,3,2,8,Potential
16653,112,5,2411.95,4,5,4,13,Champions
16654,175,4,3056.3199999999997,3,4,4,11,Loyal
16655,138,2,39.980000000000004,3,1,1,5,At Risk
16656,42,4,5930.23,5,4,5,14,Champions
16657,54,3,5900.549999999999,5,3,5,13,Champions
16658,46,2,5873.26,5,1,5,11,Loyal
16659,51,2,5873.26,5,1,5,11,Loyal
16660,48,2,5898.26,5,1,5,11,Loyal
16661,51,3,5908.25,5,3,5,13,Champions
16662,377,3,4355.71,1,3,5,9,Potential
16663,351,4,4471.74,1,4,5,10,Loyal
16664,364,3,4377.75,1,3,5,9,Potential
16665,91,6,81.81,4,5,2,11,Loyal
16666,187,5,205.44,3,5,3,11,Loyal
16667,8,6,65.99,5,5,2,12,Recent Customer
16668,283,4,607.96,2,4,3,9,Potential
16669,88,1,4.99,4,1,1,6,At Risk
16670,251,2,2478.3399999999997,2,1,4,7,Potential
16671,47,1,4.99,5,1,1,7,Potential
16672,225,2,7.28,2,1,1,4,At Risk
16673,214,4,2466.3199999999997,2,4,4,10,Loyal
16674,153,6,76.15,3,5,2,10,Loyal
16675,347,5,4385.03,1,5,5,11,Loyal
16676,132,2,13.98,4,1,1,6,At Risk
16677,182,2,13.98,3,1,1,5,At Risk
16678,156,6,3162.31,3,5,4,12,Loyal
16679,304,5,106.56,1,5,3,9,Potential
16680,104,5,104.86,4,5,3,12,Loyal
16681,204,4,68.87,3,4,2,9,Potential
16682,81,3,66.58,4,3,2,9,Potential
16683,179,4,69.87,3,4,2,9,Potential
16684,59,4,4158.24,5,4,5,14,Champions
16685,50,5,4183.2300000000005,5,5,5,15,Champions
16686,36,5,4157.7300000000005,5,5,5,15,Champions
16687,378,5,6070.589999999999,1,5,5,11,Loyal
16688,396,4,6081.099999999999,1,4,5,10,Loyal
16689,162,6,290.46,3,5,3,11,Loyal
16690,120,5,165.07,4,5,3,12,Loyal
16691,322,4,4471.74,1,4,5,10,Loyal
16692,166,3,31.27,3,3,1,7,Potential
16693,391,5,6060.5,1,5,5,11,Loyal
16694,124,6,78.2,4,5,2,11,Loyal
16695,91,6,76.15,4,5,2,11,Loyal
16696,328,3,4506.76,1,3,5,9,Potential
16697,116,3,87.08,4,3,2,9,Potential
16698,19,6,230.16,5,5,3,13,Recent Customer
16699,124,3,67.58,4,3,2,9,Potential
16700,218,3,92.97,2,3,3,8,Potential
16701,315,4,4426.74,1,4,5,10,Loyal
16702,389,2,6021.62,1,1,5,7,Potential
16703,360,5,6090.59,1,5,5,11,Loyal
16704,201,4,91.25999999999999,3,4,2,9,Potential
16705,80,4,97.96000000000001,4,4,3,11,Loyal
16706,121,3,92.97,4,3,3,10,Loyal
16707,298,3,4377.75,1,3,5,9,Potential
16708,279,4,4406.74,2,4,5,11,Loyal
16709,188,5,143.94,3,5,3,11,Loyal
16710,33,4,91.25999999999999,5,4,2,11,Loyal
16711,201,5,132.95,3,5,3,11,Loyal
16712,289,3,4417.75,1,3,5,9,Potential
16713,355,5,6090.59,1,5,5,11,Loyal
16714,178,3,64.47,3,3,2,8,Potential
16715,158,2,7.28,3,1,1,5,At Risk
16716,296,4,27.92,1,4,1,6,At Risk
16717,134,10,233.81,3,5,3,11,Loyal
16718,72,2,13.98,5,1,1,7,Potential
16719,102,2,39.980000000000004,4,1,1,6,At Risk
16720,212,2,39.980000000000004,2,1,1,4,At Risk
16721,7,8,180.71,5,5,3,13,Recent Customer
16722,62,1,4.99,5,1,1,7,Potential
16723,8,2,7.28,5,1,1,7,Recent Customer
16724,88,2,39.980000000000004,4,1,1,6,At Risk
16725,51,2,13.98,5,1,1,7,Potential
16726,34,2,7.28,5,1,1,7,Potential
16727,243,2,2451.2999999999997,2,1,4,7,Potential
16728,234,1,2443.35,2,1,4,7,Potential
16729,106,3,38.92,4,3,1,8,Potential
16730,8,5,140.94,5,5,3,13,Recent Customer
16731,76,8,155.91,4,5,3,12,Loyal
16732,194,2,2451.2999999999997,3,1,4,8,Potential
16733,176,4,35.26,3,4,1,8,Potential
16734,232,3,128.97,2,3,3,8,Potential
16735,161,2,58.980000000000004,3,1,2,6,At Risk
16736,228,2,59.980000000000004,2,1,2,5,At Risk
16737,134,1,4.99,3,1,1,5,At Risk
16738,254,4,44.95,2,4,2,8,Potential
16739,95,4,81.26,4,4,2,10,Loyal
16740,349,5,6099.099999999999,1,5,5,11,Loyal
16741,315,3,6056.61,1,3,5,9,Potential
16742,321,5,6044.59,1,5,5,11,Loyal
16743,306,5,6070.589999999999,1,5,5,11,Loyal
16744,327,5,6070.589999999999,1,5,5,11,Loyal
16745,314,2,6021.62,1,1,5,7,Potential
16746,335,3,64.47,1,3,2,6,At Risk
16747,213,3,2479.94,2,3,4,9,Potential
16748,52,2,58.980000000000004,5,1,2,8,Potential
16749,55,3,61.96,5,3,2,10,Loyal
16750,314,2,7.28,1,1,1,3,At Risk
16751,193,4,2492.3199999999997,3,4,4,11,Loyal
16752,165,4,2512.3199999999997,3,4,4,11,Loyal
16753,102,1,2319.99,4,1,4,9,Potential
16754,180,7,3118.5999999999995,3,5,4,12,Loyal
16755,102,2,2316.97,4,1,4,9,Potential
16756,105,3,2395.9599999999996,4,3,4,11,Loyal
16757,29,1,4.99,5,1,1,7,Recent Customer
16758,160,2,3062.3399999999997,3,1,4,8,Potential
16759,98,2,7.28,4,1,1,6,At Risk
16760,325,3,67.97,1,3,2,6,At Risk
16761,130,2,2475.95,4,1,4,9,Potential
16762,129,3,2479.94,4,3,4,11,Loyal
16763,293,1,1700.99,1,1,4,6,At Risk
16764,253,3,1760.47,2,3,4,9,Potential
16765,185,1,4.99,3,1,1,5,At Risk
16766,86,1,4.99,4,1,1,6,At Risk
16767,321,2,59.980000000000004,1,1,2,4,At Risk
16768,9,1,4.99,5,1,1,7,Recent Customer
16769,104,1,4.99,4,1,1,6,At Risk
16770,144,2,2478.3399999999997,3,1,4,8,Potential
16771,130,5,104.55000000000001,4,5,3,12,Loyal
16772,20,7,158.53,5,5,3,13,Recent Customer
16773,205,2,13.98,3,1,1,5,At Risk
16774,228,2,54.980000000000004,2,1,2,5,At Risk
16775,132,1,4.99,4,1,1,6,At Risk
16776,123,1,2443.35,4,1,4,9,Potential
16777,339,2,124.99,1,1,3,5,At Risk
16778,94,4,2541.3199999999997,4,4,4,12,Loyal
16779,97,2,2297.2799999999997,4,1,4,9,Potential
16780,146,2,54.980000000000004,3,1,2,6,At Risk
16781,365,3,64.47,1,3,2,6,At Risk
16782,113,4,2482.23,4,4,4,12,Loyal
16783,68,3,2457.3299999999995,5,3,4,12,Loyal
16784,272,2,1735.98,2,1,4,7,Potential
16785,121,4,2342.9199999999996,4,4,4,12,Loyal
16786,95,1,2294.99,4,1,4,9,Potential
16787,65,2,39.980000000000004,5,1,1,7,Potential
16788,289,2,39.980000000000004,1,1,1,3,At Risk
16789,41,1,2443.35,5,1,4,10,Loyal
16790,35,5,2564.9199999999996,5,5,4,14,Champions
16791,251,3,1729.97,2,3,4,9,Potential
16792,377,2,1735.98,1,1,4,6,At Risk
16793,387,5,1788.95,1,5,4,10,Loyal
16794,379,3,1785.97,1,3,4,8,Potential
16795,66,3,67.93,5,3,2,10,Loyal
16796,257,2,54.980000000000004,2,1,2,5,At Risk
16797,386,4,1732.26,1,4,4,9,Potential
16798,378,4,1764.96,1,4,4,9,Potential
16799,371,1,1700.99,1,1,4,6,At Risk
16800,24,6,75.84,5,5,2,12,Recent Customer
16801,141,2,54.980000000000004,3,1,2,6,At Risk
16802,346,2,13.98,1,1,1,3,At Risk
16803,380,3,1759.97,1,3,4,8,Potential
16804,379,3,1728.27,1,3,4,8,Potential
16805,379,4,1768.96,1,4,4,9,Potential
16806,53,2,54.980000000000004,5,1,2,8,Potential
16807,380,3,1728.27,1,3,4,8,Potential
16808,135,2,13.98,3,1,1,5,At Risk
16809,105,2,13.98,4,1,1,6,At Risk
16810,92,3,3064.6299999999997,4,3,4,11,Loyal
16811,336,1,1700.99,1,1,4,6,At Risk
16812,347,2,1735.98,1,1,4,6,At Risk
16813,66,2,13.98,5,1,1,7,Potential
16814,360,2,39.980000000000004,1,1,1,3,At Risk
16815,19,1,4.99,5,1,1,7,Recent Customer
16816,25,1,4.99,5,1,1,7,Recent Customer
16817,108,1,4.99,4,1,1,6,At Risk
16818,114,5,2391.9399999999996,4,5,4,13,Champions
16819,108,2,2316.97,4,1,4,9,Potential
16820,51,7,3217.7899999999995,5,5,4,14,Champions
16821,163,9,7221.349999999999,3,5,5,13,Champions
16822,135,6,7176.379999999999,3,5,5,13,Champions
16823,127,8,7242.349999999999,4,5,5,14,Champions
16824,182,6,6938.592499999999,3,5,5,13,Champions
16825,73,4,61.45,5,4,2,11,Loyal
16826,159,8,6953.5824999999995,3,5,5,13,Champions
16827,99,8,7205.359999999999,4,5,5,14,Champions
16828,105,8,7182.66,4,5,5,14,Champions
16829,117,7,7185.369999999999,4,5,5,14,Champions
16830,159,6,7138.68,3,5,5,13,Champions
16831,104,7,7206.37,4,5,5,14,Champions
16832,99,4,2369.9599999999996,4,4,4,12,Loyal
16833,93,4,2343.9599999999996,4,4,4,12,Loyal
16834,248,2,1750.98,2,1,4,7,Potential
16835,109,1,2294.99,4,1,4,9,Potential
16836,42,6,3193.79,5,5,4,14,Champions
16837,43,3,155.47,5,3,3,11,Loyal
16838,121,2,13.98,4,1,1,6,At Risk
16839,111,1,2294.99,4,1,4,9,Potential
16840,216,4,176.95,2,4,3,9,Potential
16841,245,3,126.96000000000001,2,3,3,8,Potential
16842,96,1,4.99,4,1,1,6,At Risk
16843,94,3,89.97,4,3,2,9,Potential
16844,99,4,2369.9699999999993,4,4,4,12,Loyal
16845,116,3,2380.47,4,3,4,11,Loyal
16846,285,4,180.95,2,4,3,9,Potential
16847,68,5,189.94,5,5,3,13,Champions
16848,10,4,125.44999999999999,5,4,3,12,Recent Customer
16849,24,4,176.95,5,4,3,12,Recent Customer
16850,117,2,2354.9799999999996,4,1,4,9,Potential
16851,98,4,2369.9599999999996,4,4,4,12,Loyal
16852,106,3,2405.47,4,3,4,11,Loyal
16853,40,1,4.99,5,1,1,7,Potential
16854,117,4,2342.93,4,4,4,12,Loyal
16855,43,4,150.95,5,4,3,12,Loyal
16856,154,2,13.98,3,1,1,5,At Risk
16857,270,2,54.980000000000004,2,1,2,5,At Risk
16858,53,1,4.99,5,1,1,7,Potential
16859,104,3,2380.47,4,3,4,11,Loyal
16860,323,1,4.99,1,1,1,3,At Risk
16861,16,2,13.98,5,1,1,7,Recent Customer
16862,16,2,39.980000000000004,5,1,1,7,Recent Customer
16863,330,3,64.47,1,3,2,6,At Risk
16864,95,4,2369.9699999999993,4,4,4,12,Loyal
16865,99,4,2369.9599999999996,4,4,4,12,Loyal
16866,108,6,2444.4499999999994,4,5,4,13,Champions
16867,117,5,2381.9399999999996,4,5,4,13,Champions
16868,105,2,2322.2799999999997,4,1,4,9,Potential
16869,117,3,2376.9599999999996,4,3,4,11,Loyal
16870,221,6,149.04,2,5,3,10,Loyal
16871,114,2,2316.97,4,1,4,9,Potential
16872,105,5,2359.24,4,5,4,13,Champions
16873,190,4,578.46,3,4,3,10,Loyal
16874,258,1,4.99,2,1,1,4,At Risk
16875,219,2,39.980000000000004,2,1,1,4,At Risk
16876,55,6,151.84,5,5,3,13,Champions
16877,348,2,39.980000000000004,1,1,1,3,At Risk
16878,340,2,1735.98,1,1,4,6,At Risk
16879,337,3,1728.27,1,3,4,8,Potential
16880,97,4,2343.9599999999996,4,4,4,12,Loyal
16881,93,1,2319.99,4,1,4,9,Potential
16882,96,1,2294.99,4,1,4,9,Potential
16883,24,3,48.970000000000006,5,3,2,10,Recent Customer
16884,298,2,39.980000000000004,1,1,1,3,At Risk
16885,319,2,39.980000000000004,1,1,1,3,At Risk
16886,359,3,1729.97,1,3,4,8,Potential
16887,343,4,1769.96,1,4,4,9,Potential
16888,355,2,1754.98,1,1,4,6,At Risk
16889,325,3,1729.97,1,3,4,8,Potential
16890,321,5,1808.45,1,5,4,10,Loyal
16891,63,2,59.980000000000004,5,1,2,8,Potential
16892,96,2,2341.97,4,1,4,9,Potential
16893,104,3,2325.9599999999996,4,3,4,11,Loyal
16894,328,3,1763.97,1,3,4,8,Potential
16895,316,3,1760.47,1,3,4,8,Potential
16896,319,3,1714.97,1,3,4,8,Potential
16897,334,3,1763.97,1,3,4,8,Potential
16898,309,2,1750.98,1,1,4,6,At Risk
16899,227,1,4.99,2,1,1,4,At Risk
16900,165,2,7.28,3,1,1,5,At Risk
16901,126,2,39.980000000000004,4,1,1,6,At Risk
16902,20,3,211.97,5,3,3,11,Recent Customer
16903,78,1,4.99,4,1,1,6,At Risk
16904,111,1,4.99,4,1,1,6,At Risk
16905,179,1,4.99,3,1,1,5,At Risk
16906,172,3,2359.9799999999996,3,3,4,10,Loyal
16907,96,2,2341.97,4,1,4,9,Potential
16908,115,3,2366.9599999999996,4,3,4,11,Loyal
16909,94,3,2376.9599999999996,4,3,4,11,Loyal
16910,200,3,141.96,3,3,3,9,Potential
16911,140,2,58.980000000000004,3,1,2,6,At Risk
16912,64,3,2380.47,5,3,4,12,Loyal
16913,159,2,13.98,3,1,1,5,At Risk
16914,62,4,2361.9499999999994,5,4,4,13,Champions
16915,62,2,2374.9799999999996,5,1,4,10,Loyal
16916,77,8,2434.9199999999996,4,5,4,13,Champions
16917,51,1,4.99,5,1,1,7,Potential
16918,13,3,64.47,5,3,2,10,Recent Customer
16919,38,4,70.95,5,4,2,11,Loyal
16920,311,1,1700.99,1,1,4,6,At Risk
16921,261,2,1754.98,2,1,4,7,Potential
16922,7,4,98.96000000000001,5,4,3,12,Recent Customer
16923,54,2,59.980000000000004,5,1,2,8,Potential
16924,283,3,1775.47,2,3,4,9,Potential
16925,295,4,1764.96,1,4,4,9,Potential
16926,40,4,44.95,5,4,2,11,Loyal
16927,1,3,38.92,5,3,1,9,Recent Customer
16928,225,2,4698.76,2,1,5,8,Potential
16929,219,3,4733.75,2,3,5,10,Loyal
16930,27,3,54.42,5,3,2,10,Recent Customer
16931,233,5,4767.73,2,5,5,12,Loyal
16932,149,4,14.56,3,4,1,8,Potential
16933,45,4,94.96000000000001,5,4,3,12,Loyal
16934,100,4,86.95,4,4,2,10,Loyal
16935,127,4,94.96000000000001,4,4,3,11,Loyal
16936,345,3,63.97,1,3,2,6,At Risk
16937,378,4,3926.5325,1,4,5,10,Loyal
16938,36,3,3110.0525,5,3,4,12,Loyal
16939,160,2,29.979999999999997,3,1,1,5,At Risk
16940,34,3,5006.7,5,3,5,13,Champions
16941,53,3,64.97,5,3,2,10,Loyal
16942,346,3,2751.4175,1,3,4,8,Potential
16943,211,3,37.93,2,3,1,6,At Risk
16944,391,5,4253.8099999999995,1,5,5,11,Loyal
16945,41,3,3262.83,5,3,4,12,Loyal
16946,36,4,3071.0325,5,4,4,13,Champions
16947,288,2,1735.98,2,1,4,7,Potential
16948,24,9,248.01,5,5,3,13,Recent Customer
16949,284,3,1789.97,2,3,4,9,Potential
16950,190,10,211.01000000000002,3,5,3,11,Loyal
16951,301,2,1735.98,1,1,4,6,At Risk
16952,245,2,1735.98,2,1,4,7,Potential
16953,361,2,13.98,1,1,1,3,At Risk
16954,17,3,67.97,5,3,2,10,Recent Customer
16955,215,3,1760.47,2,3,4,9,Potential
16956,293,1,1700.99,1,1,4,6,At Risk
16957,39,2,39.980000000000004,5,1,1,7,Potential
16958,301,8,168.02,1,5,3,9,Potential
16959,160,6,135.35,3,5,3,11,Loyal
16960,120,1,4.99,4,1,1,6,At Risk
16961,91,4,2318.9599999999996,4,4,4,12,Loyal
16962,10,2,13.98,5,1,1,7,Recent Customer
16963,302,2,39.980000000000004,1,1,1,3,At Risk
16964,220,6,108.54,2,5,3,10,Loyal
16965,317,2,39.980000000000004,1,1,1,3,At Risk
16966,43,1,4.99,5,1,1,7,Potential
16967,80,2,2316.97,4,1,4,9,Potential
16968,72,3,2325.9599999999996,5,3,4,12,Loyal
16969,73,2,2439.99,5,1,4,10,Loyal
16970,292,2,1754.98,1,1,4,6,At Risk
16971,218,3,64.47,2,3,2,7,Potential
16972,292,2,1754.98,1,1,4,6,At Risk
16973,288,5,1857.92,2,5,4,11,Loyal
16974,295,3,1729.97,1,3,4,8,Potential
16975,145,3,67.97,3,3,2,8,Potential
16976,304,3,1785.97,1,3,4,8,Potential
16977,266,2,1709.98,2,1,4,7,Potential
16978,323,1,4.99,1,1,1,3,At Risk
16979,77,2,2322.2799999999997,4,1,4,9,Potential
16980,293,2,39.980000000000004,1,1,1,3,At Risk
16981,73,4,2317.9199999999996,5,4,4,13,Champions
16982,366,3,89.97,1,3,2,6,At Risk
16983,67,3,2357.2799999999997,5,3,4,12,Loyal
16984,259,3,1759.97,2,3,4,9,Potential
16985,157,2,13.98,3,1,1,5,At Risk
16986,210,2,68.49,2,1,2,5,At Risk
16987,169,2,2414.99,3,1,4,8,Potential
16988,59,1,4.99,5,1,1,7,Potential
16989,64,1,2319.99,5,1,4,10,Loyal
16990,216,2,59.980000000000004,2,1,2,5,At Risk
16991,314,2,39.980000000000004,1,1,1,3,At Risk
16992,304,1,4.99,1,1,1,3,At Risk
16993,218,2,124.99,2,1,3,6,At Risk
16994,151,2,39.980000000000004,3,1,1,5,At Risk
16995,232,2,1735.98,2,1,4,7,Potential
16996,228,2,1754.98,2,1,4,7,Potential
16997,255,3,1763.97,2,3,4,9,Potential
16998,256,2,1735.98,2,1,4,7,Potential
16999,262,2,1735.98,2,1,4,7,Potential
17000,78,1,2294.99,4,1,4,9,Potential
17001,83,2,2341.97,4,1,4,9,Potential
17002,72,4,2331.9499999999994,5,4,4,13,Champions
17003,92,4,2416.45,4,4,4,12,Loyal
17004,89,3,2418.4799999999996,4,3,4,11,Loyal
17005,69,4,2376.4499999999994,5,4,4,13,Champions
17006,68,4,2404.4599999999996,5,4,4,13,Champions
17007,79,2,2329.99,4,1,4,9,Potential
17008,75,2,2316.97,4,1,4,9,Potential
17009,82,3,2351.9599999999996,4,3,4,11,Loyal
17010,75,4,2384.97,4,4,4,12,Loyal
17011,266,2,1750.98,2,1,4,7,Potential
17012,249,2,1750.98,2,1,4,7,Potential
17013,72,4,2401.4499999999994,5,4,4,13,Champions
17014,352,1,4.99,1,1,1,3,At Risk
17015,271,1,4.99,2,1,1,4,At Risk
17016,347,4,98.96000000000001,1,4,3,8,Potential
17017,62,3,2332.2799999999997,5,3,4,12,Loyal
17018,265,3,93.97,2,3,3,8,Potential
17019,60,2,54.980000000000004,5,1,2,8,Potential
17020,272,3,1714.97,2,3,4,9,Potential
17021,253,1,1700.99,2,1,4,7,Potential
17022,245,3,1763.97,2,3,4,9,Potential
17023,231,2,1735.98,2,1,4,7,Potential
17024,265,3,1775.97,2,3,4,9,Potential
17025,198,2,1709.98,3,1,4,8,Potential
17026,315,10,261.39,1,5,3,9,Potential
17027,239,9,230.9,2,5,3,10,Loyal
17028,254,3,1763.97,2,3,4,9,Potential
17029,247,3,1759.97,2,3,4,9,Potential
17030,268,1,1700.99,2,1,4,7,Potential
17031,295,2,13.98,1,1,1,3,At Risk
17032,108,2,12.940000000000001,4,1,1,6,At Risk
17033,291,2,29.479999999999997,1,1,1,3,At Risk
17034,185,2,1750.98,3,1,4,8,Potential
17035,348,2,58.980000000000004,1,1,2,4,At Risk
17036,243,4,176.95,2,4,3,9,Potential
17037,147,3,2334.9699999999993,3,3,4,10,Loyal
17038,88,3,2442.2799999999997,4,3,4,11,Loyal
17039,268,3,1799.48,2,3,4,9,Potential
17040,248,3,1760.47,2,3,4,9,Potential
17041,253,1,1700.99,2,1,4,7,Potential
17042,247,2,1735.98,2,1,4,7,Potential
17043,272,3,1760.47,2,3,4,9,Potential
17044,137,2,39.980000000000004,3,1,1,5,At Risk
17045,284,5,4480.73,2,5,5,12,Loyal
17046,276,4,4467.74,2,4,5,11,Loyal
17047,302,2,4347.76,1,1,5,7,Potential
17048,254,3,4382.75,2,3,5,10,Loyal
17049,257,2,4347.76,2,1,5,8,Potential
17050,260,5,4496.23,2,5,5,12,Loyal
17051,277,5,6060.5,2,5,5,12,Loyal
17052,224,4,96.92,2,4,3,9,Potential
17053,138,4,123.96000000000001,3,4,3,10,Loyal
17054,98,2,83.98,4,1,2,7,Potential
17055,254,2,4347.76,2,1,5,8,Potential
17056,252,3,4417.75,2,3,5,10,Loyal
17057,20,3,86.27000000000001,5,3,2,10,Recent Customer
17058,50,2,83.98,5,1,2,8,Potential
17059,52,4,123.96000000000001,5,4,3,12,Loyal
17060,137,4,123.96000000000001,3,4,3,10,Loyal
17061,198,3,86.27000000000001,3,3,2,8,Potential
17062,325,4,91.25999999999999,1,4,2,7,Potential
17063,304,5,100.25,1,5,3,9,Potential
17064,263,3,4506.76,2,3,5,10,Loyal
17065,220,3,4417.75,2,3,5,10,Loyal
17066,120,5,105.75,4,5,3,12,Loyal
17067,39,4,113.96000000000001,5,4,3,12,Loyal
17068,21,3,92.97,5,3,3,11,Recent Customer
17069,215,4,4426.74,2,4,5,11,Loyal
17070,343,4,123.96000000000001,1,4,3,8,Potential
17071,225,3,4417.75,2,3,5,10,Loyal
17072,65,4,123.96,5,4,3,12,Loyal
17073,114,3,78.97,4,3,2,9,Potential
17074,218,5,90.25,2,5,2,9,Potential
17075,160,3,77.27,3,3,2,8,Potential
17076,34,4,103.46,5,4,3,12,Loyal
17077,204,5,138.45,3,5,3,11,Loyal
17078,316,6,186.94,1,5,3,9,Potential
17079,233,3,4417.75,2,3,5,10,Loyal
17080,337,5,2732.6975,1,5,4,10,Loyal
17081,206,2,74.98,3,1,2,6,At Risk
17082,347,3,3891.5424999999996,1,3,5,9,Potential
17083,308,3,51.96,1,3,2,6,At Risk
17084,113,3,31.27,4,3,1,8,Potential
17085,228,4,2986.0325000000003,2,4,4,10,Loyal
17086,350,3,4194.33,1,3,5,9,Potential
17087,186,5,75.21000000000001,3,5,2,10,Loyal
17088,193,1,24.99,3,1,1,5,At Risk
17089,235,3,64.97,2,3,2,7,Potential
17090,106,3,64.97,4,3,2,9,Potential
17091,41,3,32.269999999999996,5,3,1,9,Potential
17092,354,3,37.269999999999996,1,3,1,5,At Risk
17093,62,5,6917.5925,5,5,5,15,Champions
17094,220,3,3001.0425,2,3,4,9,Potential
17095,320,4,2760.4075000000003,1,4,4,9,Potential
17096,358,2,4144.34,1,1,5,7,Potential
17097,55,5,3021.0225,5,5,4,14,Champions
17098,378,3,2768.5325000000003,1,3,4,8,Potential
17099,322,2,2701.4275,1,1,4,6,At Risk
17100,128,5,95.94,4,5,3,12,Loyal
17101,119,6,163.94,4,5,3,12,Loyal
17102,323,3,32.269999999999996,1,3,1,5,At Risk
17103,65,7,6935.0824999999995,5,5,5,15,Champions
17104,306,1,4.99,1,1,1,3,At Risk
17105,239,6,83.44,2,5,2,9,Potential
17106,118,4,72.96000000000001,4,4,2,10,Loyal
17107,358,3,4179.33,1,3,5,9,Potential
17108,147,1,24.99,3,1,1,5,At Risk
17109,326,5,2769.3975,1,5,4,10,Loyal
17110,122,4,47.260000000000005,4,4,2,10,Loyal
17111,340,1,4.99,1,1,1,3,At Risk
17112,195,2,6.28,3,1,1,5,At Risk
17113,163,1,4.99,3,1,1,5,At Risk
17114,81,9,7275.36,4,5,5,14,Champions
17115,232,4,3008.0225,2,4,4,10,Loyal
17116,203,4,1764.96,3,4,4,11,Loyal
17117,81,2,39.980000000000004,4,1,1,6,At Risk
17118,251,4,562.96,2,4,3,9,Potential
17119,275,9,214.9,2,5,3,10,Loyal
17120,252,2,1735.98,2,1,4,7,Potential
17121,246,2,1735.98,2,1,4,7,Potential
17122,299,2,58.980000000000004,1,1,2,4,At Risk
17123,227,4,562.96,2,4,3,9,Potential
17124,230,4,562.96,2,4,3,9,Potential
17125,113,1,539.99,4,1,3,8,Potential
17126,22,3,126.96000000000001,5,3,3,11,Recent Customer
17127,252,4,1778.47,2,4,4,10,Loyal
17128,252,2,1735.98,2,1,4,7,Potential
17129,251,2,1735.98,2,1,4,7,Potential
17130,330,4,98.96000000000001,1,4,3,8,Potential
17131,50,1,4.99,5,1,1,7,Potential
17132,55,1,4.99,5,1,1,7,Potential
17133,88,3,2357.2799999999997,4,3,4,11,Loyal
17134,77,3,2376.9599999999996,4,3,4,11,Loyal
17135,70,3,2379.4699999999993,5,3,4,12,Loyal
17136,84,2,2297.2799999999997,4,1,4,9,Potential
17137,342,1,4.99,1,1,1,3,At Risk
17138,312,2,59.980000000000004,1,1,2,4,At Risk
17139,83,3,2309.9699999999993,4,3,4,11,Loyal
17140,73,1,2319.99,5,1,4,10,Loyal
17141,62,3,2376.9599999999996,5,3,4,12,Loyal
17142,248,3,1728.27,2,3,4,9,Potential
17143,207,3,1763.97,2,3,4,9,Potential
17144,247,5,1891.26,2,5,4,11,Loyal
17145,77,2,13.98,4,1,1,6,At Risk
17146,85,2,39.980000000000004,4,1,1,6,At Risk
17147,178,1,1700.99,3,1,4,8,Potential
17148,156,3,1775.47,3,3,4,10,Loyal
17149,233,2,1735.98,2,1,4,7,Potential
17150,225,4,1764.96,2,4,4,10,Loyal
17151,1,2,12.940000000000001,5,1,1,7,Recent Customer
17152,181,2,12.940000000000001,3,1,1,5,At Risk
17153,226,3,1744.97,2,3,4,9,Potential
17154,228,4,1764.96,2,4,4,10,Loyal
17155,180,2,13.98,3,1,1,5,At Risk
17156,84,5,2502.2699999999995,4,5,4,13,Champions
17157,92,3,2334.9799999999996,4,3,4,11,Loyal
17158,313,2,39.980000000000004,1,1,1,3,At Risk
17159,238,2,1735.98,2,1,4,7,Potential
17160,78,1,4.99,4,1,1,6,At Risk
17161,308,2,59.980000000000004,1,1,2,4,At Risk
17162,273,2,39.980000000000004,2,1,1,4,At Risk
17163,216,4,1732.26,2,4,4,10,Loyal
17164,75,2,12.940000000000001,4,1,1,6,At Risk
17165,350,1,4.99,1,1,1,3,At Risk
17166,95,1,4.99,4,1,1,6,At Risk
17167,227,2,1735.98,2,1,4,7,Potential
17168,234,1,4.99,2,1,1,4,At Risk
17169,316,1,4.99,1,1,1,3,At Risk
17170,290,2,13.98,1,1,1,3,At Risk
17171,87,2,2439.99,4,1,4,9,Potential
17172,175,2,68.49,3,1,2,6,At Risk
17173,78,1,4.99,4,1,1,6,At Risk
17174,225,1,4.99,2,1,1,4,At Risk
17175,142,3,2334.9799999999996,3,3,4,10,Loyal
17176,85,4,2369.9599999999996,4,4,4,12,Loyal
17177,219,2,13.98,2,1,1,4,At Risk
17178,44,2,13.98,5,1,1,7,Potential
17179,197,2,29.479999999999997,3,1,1,5,At Risk
17180,80,3,68.97,4,3,2,9,Potential
17181,160,7,6944.5824999999995,3,5,5,13,Champions
17182,107,5,6950.602499999999,4,5,5,14,Champions
17183,166,8,7175.86,3,5,5,13,Champions
17184,165,8,7253.349999999999,3,5,5,13,Champions
17185,95,8,6954.5725,4,5,5,14,Champions
17186,209,4,77.27,2,4,2,8,Potential
17187,182,4,3310.4074999999993,3,4,5,12,Loyal
17188,181,3,3350.4174999999996,3,3,5,11,Loyal
17189,326,2,46.47,1,1,2,4,At Risk
17190,15,2,24.27,5,1,1,7,Recent Customer
17191,169,4,6895.612499999999,3,4,5,12,Loyal
17192,99,6,6977.5825,4,5,5,14,Champions
17193,34,5,134.96,5,5,3,13,Champions
17194,190,4,111.45,3,4,3,10,Loyal
17195,180,4,3330.6674999999996,3,4,5,12,Loyal
17196,164,5,3318.3574999999996,3,5,5,13,Champions
17197,35,2,56.97,5,1,2,8,Potential
17198,161,7,7233.36,3,5,5,13,Champions
17199,175,9,6997.5625,3,5,5,13,Champions
17200,280,1,21.98,2,1,1,4,At Risk
17201,36,1,21.98,5,1,1,7,Potential
17202,76,9,6974.062499999999,4,5,5,14,Champions
17203,74,8,6952.532499999999,4,5,5,14,Champions
17204,81,5,114.96000000000001,4,5,3,12,Loyal
17205,81,3,74.98,4,3,2,9,Potential
17206,173,2,3295.4275,3,1,5,9,Potential
17207,68,9,6979.562499999999,5,5,5,15,Champions
17208,194,4,45.95,3,4,2,9,Potential
17209,176,4,7182.4,3,4,5,12,Loyal
17210,17,4,71.95,5,4,2,11,Recent Customer
17211,349,3,47.940000000000005,1,3,2,6,At Risk
17212,63,3,61.970000000000006,5,3,2,10,Loyal
17213,200,6,179.95000000000002,3,5,3,11,Loyal
17214,90,5,7211.389999999999,4,5,5,14,Champions
17215,143,2,31.97,3,1,1,5,At Risk
17216,124,5,3370.3974999999996,4,5,5,14,Champions
17217,277,3,80.96000000000001,2,3,2,7,Potential
17218,68,9,6907.562499999999,5,5,5,15,Champions
17219,155,1,35.0,3,1,1,5,At Risk
17220,156,7,6914.8525,3,5,5,13,Champions
17221,163,13,7292.3099999999995,3,5,5,13,Champions
17222,199,3,36.96,3,3,1,7,Potential
17223,151,1,21.98,3,1,1,5,At Risk
17224,256,3,66.96000000000001,2,3,2,7,Potential
17225,90,8,6986.8724999999995,4,5,5,14,Champions
17226,238,4,109.97,2,4,3,9,Potential
17227,234,3,83.97,2,3,2,7,Potential
17228,85,3,77.27,4,3,2,9,Potential
17229,199,4,4471.74,3,4,5,12,Loyal
17230,161,2,83.98,3,1,2,6,At Risk
17231,150,2,83.98,3,1,2,6,At Risk
17232,208,2,4347.76,2,1,5,8,Potential
17233,210,2,4347.76,2,1,5,8,Potential
17234,53,4,91.25999999999999,5,4,2,11,Loyal
17235,194,2,83.98,3,1,2,6,At Risk
17236,186,3,86.27000000000001,3,3,2,8,Potential
17237,26,6,173.93,5,5,3,13,Recent Customer
17238,306,3,147.48000000000002,1,3,3,7,Potential
17239,8,3,86.27000000000001,5,3,2,10,Recent Customer
17240,173,5,4385.03,3,5,5,13,Champions
17241,161,3,4382.75,3,3,5,11,Loyal
17242,162,5,4387.2300000000005,3,5,5,13,Champions
17243,237,2,83.98,2,1,2,5,At Risk
17244,216,3,86.27000000000001,2,3,2,7,Potential
17245,73,3,92.97,5,3,3,11,Loyal
17246,160,4,4380.04,3,4,5,12,Loyal
17247,180,5,4432.72,3,5,5,13,Champions
17248,150,3,4382.75,3,3,5,11,Loyal
17249,125,4,4426.74,4,4,5,13,Champions
17250,28,4,97.96000000000001,5,4,3,12,Recent Customer
17251,232,4,123.96000000000001,2,4,3,9,Potential
17252,123,3,92.97,4,3,3,10,Loyal
17253,8,2,83.98,5,1,2,8,Recent Customer
17254,294,3,147.48000000000002,1,3,3,7,Potential
17255,146,4,4442.24,3,4,5,12,Loyal
17256,128,4,4362.74,4,4,5,13,Champions
17257,128,5,4480.73,4,5,5,14,Champions
17258,120,2,4347.76,4,1,5,10,Loyal
17259,102,4,4404.7300000000005,4,4,5,13,Champions
17260,315,2,39.980000000000004,1,1,1,3,At Risk
17261,224,4,1764.96,2,4,4,10,Loyal
17262,244,2,1735.98,2,1,4,7,Potential
17263,165,1,1700.99,3,1,4,8,Potential
17264,69,3,2325.9599999999996,5,3,4,12,Loyal
17265,149,1,4.99,3,1,1,5,At Risk
17266,133,2,59.980000000000004,4,1,2,7,Potential
17267,81,2,2354.9799999999996,4,1,4,9,Potential
17268,72,1,2319.99,5,1,4,10,Loyal
17269,241,3,1728.27,2,3,4,9,Potential
17270,219,2,1735.98,2,1,4,7,Potential
17271,233,2,1725.98,2,1,4,7,Potential
17272,227,3,1714.97,2,3,4,9,Potential
17273,50,3,67.97,5,3,2,10,Loyal
17274,267,2,13.98,2,1,1,4,At Risk
17275,325,1,4.99,1,1,1,3,At Risk
17276,363,3,67.97,1,3,2,6,At Risk
17277,111,4,4426.74,4,4,5,13,Champions
17278,121,3,4382.75,4,3,5,12,Loyal
17279,294,2,6021.62,1,1,5,7,Potential
17280,301,5,6089.589999999999,1,5,5,11,Loyal
17281,116,3,83.97,4,3,2,9,Potential
17282,11,5,100.25,5,5,3,13,Recent Customer
17283,2,6,147.44,5,5,3,13,Recent Customer
17284,180,5,90.25,3,5,2,10,Loyal
17285,232,5,6093.2,2,5,5,12,Loyal
17286,240,3,6029.57,2,3,5,10,Loyal
17287,139,4,95.26,3,4,3,10,Loyal
17288,120,5,4426.24,4,5,5,14,Champions
17289,88,5,106.95,4,5,3,12,Loyal
17290,169,3,92.97,3,3,3,9,Potential
17291,285,3,86.27000000000001,2,3,2,7,Potential
17292,42,4,94.22,5,4,3,12,Loyal
17293,99,3,4417.75,4,3,5,12,Loyal
17294,85,3,4355.71,4,3,5,12,Loyal
17295,92,4,4392.74,4,4,5,13,Champions
17296,25,4,113.96000000000001,5,4,3,12,Recent Customer
17297,251,5,100.25,2,5,3,10,Loyal
17298,173,5,174.45,3,5,3,11,Loyal
17299,76,3,4382.75,4,3,5,12,Loyal
17300,239,4,94.22,2,4,3,9,Potential
17301,62,2,74.98,5,1,2,8,Potential
17302,121,6,147.44,4,5,3,12,Loyal
17303,142,5,123.45,3,5,3,11,Loyal
17304,31,3,62.269999999999996,5,3,2,10,Loyal
17305,4,5,231.96,5,5,3,13,Recent Customer
17306,250,4,117.96000000000001,2,4,3,9,Potential
17307,340,5,132.95,1,5,3,9,Potential
17308,214,2,6021.62,2,1,5,8,Potential
17309,236,3,6030.61,2,3,5,10,Loyal
17310,238,3,6029.57,2,3,5,10,Loyal
17311,11,4,78.96000000000001,5,4,2,11,Recent Customer
17312,78,4,4471.74,4,4,5,13,Champions
17313,218,4,51.92,2,4,2,8,Potential
17314,47,4,78.96000000000001,5,4,2,11,Loyal
17315,222,3,6030.61,2,3,5,10,Loyal
17316,62,5,97.45,5,5,3,13,Champions
17317,122,5,128.95,4,5,3,12,Loyal
17318,278,3,43.97,2,3,2,7,Potential
17319,43,2,38.98,5,1,1,7,Potential
17320,65,4,4391.74,5,4,5,14,Champions
17321,18,5,142.46,5,5,3,13,Recent Customer
17322,17,3,94.47,5,3,3,11,Recent Customer
17323,45,3,84.96000000000001,5,3,2,10,Loyal
17324,94,5,80.94,4,5,2,11,Loyal
17325,95,5,54.940000000000005,4,5,2,11,Loyal
17326,91,3,4467.76,4,3,5,12,Loyal
17327,69,5,99.94,5,5,3,13,Champions
17328,54,4,4387.74,5,4,5,14,Champions
17329,240,2,6021.62,2,1,5,8,Potential
17330,132,2,30.97,4,1,1,6,At Risk
17331,147,3,40.96,3,3,2,8,Potential
17332,48,5,4480.73,5,5,5,15,Champions
17333,146,5,80.94,3,5,2,10,Loyal
17334,53,2,4347.76,5,1,5,11,Loyal
17335,281,1,4.99,2,1,1,4,At Risk
17336,338,2,26.97,1,1,1,3,At Risk
17337,90,7,123.91,4,5,3,12,Loyal
17338,22,9,92.16,5,5,3,13,Recent Customer
17339,294,1,4.99,1,1,1,3,At Risk
17340,80,3,29.26,4,3,1,8,Potential
17341,147,3,35.96,3,3,1,7,Potential
17342,300,2,39.980000000000004,1,1,1,3,At Risk
17343,254,2,39.980000000000004,2,1,1,4,At Risk
17344,109,1,4.99,4,1,1,6,At Risk
17345,149,4,1764.96,3,4,4,11,Loyal
17346,218,3,81.46000000000001,2,3,2,7,Potential
17347,82,7,119.72,4,5,3,12,Loyal
17348,145,8,205.42000000000002,3,5,3,11,Loyal
17349,104,3,64.47,4,3,2,9,Potential
17350,117,4,127.47,4,4,3,11,Loyal
17351,199,6,6117.69,3,5,5,13,Champions
17352,190,2,6021.62,3,1,5,9,Potential
17353,203,4,6035.599999999999,3,4,5,12,Loyal
17354,199,3,6029.57,3,3,5,11,Loyal
17355,212,2,46.47,2,1,2,5,At Risk
17356,18,2,13.98,5,1,1,7,Recent Customer
17357,277,1,4.99,2,1,1,4,At Risk
17358,229,3,1728.27,2,3,4,9,Potential
17359,330,2,39.980000000000004,1,1,1,3,At Risk
17360,45,7,122.17999999999999,5,5,3,13,Champions
17361,237,3,1759.97,2,3,4,9,Potential
17362,66,3,2309.9699999999993,5,3,4,12,Loyal
17363,75,2,2341.97,4,1,4,9,Potential
17364,72,3,2351.9599999999996,5,3,4,12,Loyal
17365,78,4,2369.9599999999996,4,4,4,12,Loyal
17366,320,2,39.980000000000004,1,1,1,3,At Risk
17367,296,2,68.49,1,1,2,4,At Risk
17368,355,1,4.99,1,1,1,3,At Risk
17369,352,2,7.28,1,1,1,3,At Risk
17370,232,4,4742.74,2,4,5,11,Loyal
17371,50,7,151.92000000000002,5,5,3,13,Champions
17372,139,3,1729.97,3,3,4,10,Loyal
17373,133,2,1735.98,4,1,4,9,Potential
17374,202,12,206.63,3,5,3,11,Loyal
17375,26,2,46.47,5,1,2,8,Recent Customer
17376,235,1,4.99,2,1,1,4,At Risk
17377,124,1,4.99,4,1,1,6,At Risk
17378,12,2,39.980000000000004,5,1,1,7,Recent Customer
17379,328,2,124.99,1,1,3,5,At Risk
17380,323,2,39.980000000000004,1,1,1,3,At Risk
17381,9,4,347.93,5,4,3,12,Recent Customer
17382,102,2,29.479999999999997,4,1,1,6,At Risk
17383,134,2,7.28,3,1,1,5,At Risk
17384,230,3,1760.47,2,3,4,9,Potential
17385,107,10,208.69,4,5,3,12,Loyal
17386,230,2,1735.98,2,1,4,7,Potential
17387,301,10,148.19,1,5,3,9,Potential
17388,148,3,1763.97,3,3,4,10,Loyal
17389,238,3,1779.47,2,3,4,9,Potential
17390,266,2,39.980000000000004,2,1,1,4,At Risk
17391,4,1,4.99,5,1,1,7,Recent Customer
17392,301,2,13.98,1,1,1,3,At Risk
17393,75,4,2404.91,4,4,4,12,Loyal
17394,100,2,68.49,4,1,2,7,Potential
17395,157,1,4.99,3,1,1,5,At Risk
17396,213,2,12.940000000000001,2,1,1,4,At Risk
17397,247,2,39.980000000000004,2,1,1,4,At Risk
17398,88,2,2354.9799999999996,4,1,4,9,Potential
17399,90,3,2366.9599999999996,4,3,4,11,Loyal
17400,140,4,2331.9499999999994,3,4,4,11,Loyal
17401,64,2,2329.99,5,1,4,10,Loyal
17402,132,2,2304.9799999999996,4,1,4,9,Potential
17403,153,2,2322.2799999999997,3,1,4,8,Potential
17404,127,2,1709.98,4,1,4,9,Potential
17405,223,2,1725.48,2,1,4,7,Potential
17406,117,2,7.28,4,1,1,6,At Risk
17407,266,2,54.980000000000004,2,1,2,5,At Risk
17408,158,1,4.99,3,1,1,5,At Risk
17409,122,4,219.92000000000002,4,4,3,11,Loyal
17410,145,5,168.74,3,5,3,11,Loyal
17411,96,3,155.47,4,3,3,10,Loyal
17412,77,2,2414.99,4,1,4,9,Potential
17413,77,5,2365.9399999999996,4,5,4,13,Champions
17414,81,1,2294.99,4,1,4,9,Potential
17415,92,2,2297.2799999999997,4,1,4,9,Potential
17416,92,3,2370.9599999999996,4,3,4,11,Loyal
17417,67,2,2354.99,5,1,4,10,Loyal
17418,271,2,39.980000000000004,2,1,1,4,At Risk
17419,328,2,39.980000000000004,1,1,1,3,At Risk
17420,68,5,2370.22,5,5,4,14,Champions
17421,68,3,2376.9599999999996,5,3,4,12,Loyal
17422,181,7,174.92000000000002,3,5,3,11,Loyal
17423,77,2,2297.2799999999997,4,1,4,9,Potential
17424,73,4,2423.4799999999996,5,4,4,13,Champions
17425,77,5,2394.95,4,5,4,13,Champions
17426,219,1,4.99,2,1,1,4,At Risk
17427,66,3,2371.9599999999996,5,3,4,12,Loyal
17428,243,2,39.980000000000004,2,1,1,4,At Risk
17429,60,1,4.99,5,1,1,7,Potential
17430,252,1,4.99,2,1,1,4,At Risk
17431,318,1,4.99,1,1,1,3,At Risk
17432,202,1,4.99,3,1,1,5,At Risk
17433,78,3,2341.4599999999996,4,3,4,11,Loyal
17434,222,1,4.99,2,1,1,4,At Risk
17435,114,3,67.97,4,3,2,9,Potential
17436,205,1,4.99,3,1,1,5,At Risk
17437,332,2,58.980000000000004,1,1,2,4,At Risk
17438,123,2,59.980000000000004,4,1,2,7,Potential
17439,92,2,2341.97,4,2,4,10,Loyal
17440,173,1,4.99,3,1,1,5,At Risk
17441,74,4,2404.9499999999994,4,4,4,12,Loyal
17442,39,11,319.88,5,5,3,13,Champions
17443,243,2,1754.98,2,2,4,8,Potential
17444,230,2,124.99,2,2,3,7,Potential
17445,235,3,1729.97,2,3,4,9,Potential
17446,62,4,2384.9599999999996,5,4,4,13,Champions
17447,359,2,13.98,1,2,1,4,At Risk
17448,126,3,64.47,4,3,2,9,Potential
17449,323,1,4.99,1,1,1,3,At Risk
17450,10,4,153.91,5,4,3,12,Recent Customer
17451,96,2,39.980000000000004,4,2,1,7,Potential
17452,67,1,4.99,5,1,1,7,Potential
17453,65,3,2376.9599999999996,5,3,4,12,Loyal
17454,148,1,4.99,3,1,1,5,At Risk
17455,272,2,7.28,2,2,1,5,At Risk
17456,231,1,4.99,2,1,1,4,At Risk
17457,60,2,54.980000000000004,5,2,2,9,Potential
17458,81,4,2369.9699999999993,4,4,4,12,Loyal
17459,217,2,59.980000000000004,2,2,2,6,At Risk
17460,84,3,2339.9699999999993,4,3,4,11,Loyal
17461,81,4,2406.95,4,4,4,12,Loyal
17462,77,3,2334.9799999999996,4,3,4,11,Loyal
17463,235,5,1773.95,2,5,4,11,Loyal
17464,221,4,1784.96,2,4,4,10,Loyal
17465,215,4,1764.96,2,4,4,10,Loyal
17466,105,2,68.49,4,2,2,8,Potential
17467,239,1,4.99,2,1,1,4,At Risk
17468,80,7,128.91,4,5,3,12,Loyal
17469,85,2,7.28,4,2,1,7,Potential
17470,75,2,2329.99,4,2,4,10,Loyal
17471,178,2,39.980000000000004,3,2,1,6,At Risk
17472,37,1,4.99,5,1,1,7,Potential
17473,128,1,4.99,4,1,1,6,At Risk
17474,84,2,2354.9799999999996,4,2,4,10,Loyal
17475,67,3,2370.9599999999996,5,3,4,12,Loyal
17476,121,1,1700.99,4,1,4,9,Potential
17477,228,1,1700.99,2,1,4,7,Potential
17478,237,4,4758.24,2,4,5,11,Loyal
17479,238,5,163.4,2,5,3,10,Loyal
17480,226,2,1725.98,2,2,4,8,Potential
17481,271,5,126.94,2,5,3,10,Loyal
17482,180,5,146.94,3,5,3,11,Loyal
17483,221,5,64.5,2,5,2,9,Potential
17484,283,3,126.96000000000001,2,3,3,8,Potential
17485,315,3,76.96000000000001,1,3,2,6,At Risk
17486,275,3,89.97,2,3,2,7,Potential
17487,158,2,7.28,3,2,1,6,At Risk
17488,318,1,4.99,1,1,1,3,At Risk
17489,245,2,58.980000000000004,2,2,2,6,At Risk
17490,85,2,12.940000000000001,4,2,1,7,Potential
17491,28,5,126.94,5,5,3,13,Recent Customer
17492,223,3,84.47,2,3,2,7,Potential
17493,48,3,130.96,5,3,3,11,Loyal
17494,247,3,111.96000000000001,2,3,3,8,Potential
17495,113,4,119.91,4,4,3,11,Loyal
17496,16,5,229.45,5,5,3,13,Recent Customer
17497,185,4,1717.26,3,4,4,11,Loyal
17498,227,3,565.47,2,3,3,8,Potential
17499,84,1,2294.99,4,1,4,9,Potential
17500,31,4,156.96,5,4,3,12,Loyal
17501,93,2,141.98,4,2,3,9,Potential
17502,166,5,6070.589999999999,3,5,5,13,Champions
17503,34,4,98.96000000000001,5,4,3,12,Loyal
17504,56,4,4362.74,5,4,5,14,Champions
17505,268,2,7.28,2,2,1,5,At Risk
17506,360,2,12.940000000000001,1,2,1,4,At Risk
17507,181,3,68.97,3,3,2,8,Potential
17508,68,3,2324.9199999999996,5,3,4,12,Loyal
17509,50,7,98.72,5,5,3,13,Champions
17510,42,3,4369.74,5,3,5,13,Champions
17511,374,5,4150.53,1,5,5,11,Loyal
17512,390,4,4170.54,1,4,5,10,Loyal
17513,383,4,4260.24,1,4,5,10,Loyal
17514,360,5,4142.2300000000005,1,5,5,11,Loyal
17515,276,2,4143.26,2,2,5,9,Potential
17516,35,2,39.980000000000004,5,2,1,8,Potential
17517,67,2,39.980000000000004,5,2,1,8,Potential
17518,218,1,539.99,2,1,3,6,At Risk
17519,313,2,58.980000000000004,1,2,2,5,At Risk
17520,112,1,4.99,4,1,1,6,At Risk
17521,209,2,1750.98,2,2,4,8,Potential
17522,80,4,74.95,4,4,2,10,Loyal
17523,34,1,4.99,5,1,1,7,Potential
17524,69,2,2316.97,5,2,4,11,Loyal
17525,164,1,4.99,3,1,1,5,At Risk
17526,302,1,4.99,1,1,1,3,At Risk
17527,92,2,12.940000000000001,4,2,1,7,Potential
17528,83,2,54.980000000000004,4,2,2,8,Potential
17529,125,2,13.98,4,2,1,7,Potential
17530,190,3,79.47,3,3,2,8,Potential
17531,230,2,13.98,2,2,1,5,At Risk
17532,204,1,4.99,3,1,1,5,At Risk
17533,186,2,1735.98,3,2,4,9,Potential
17534,144,1,4.99,3,1,1,5,At Risk
17535,84,3,2405.47,4,3,4,11,Loyal
17536,66,3,2376.9599999999996,5,3,4,12,Loyal
17537,73,1,2319.99,5,1,4,10,Loyal
17538,227,1,4.99,2,1,1,4,At Risk
17539,83,7,205.92000000000002,4,5,3,12,Loyal
17540,357,2,13.98,1,2,1,4,At Risk
17541,244,1,4.99,2,1,1,4,At Risk
17542,76,2,2341.97,4,2,4,10,Loyal
17543,85,2,2414.99,4,2,4,10,Loyal
17544,85,3,2359.9799999999996,4,3,4,11,Loyal
17545,73,2,2341.97,5,2,4,11,Loyal
17546,88,4,2318.9599999999996,4,4,4,12,Loyal
17547,200,1,4.99,3,1,1,5,At Risk
17548,192,1,1700.99,3,1,4,8,Potential
17549,24,2,39.980000000000004,5,2,1,8,Recent Customer
17550,41,1,4.99,5,1,1,7,Potential
17551,160,7,160.92000000000002,3,5,3,11,Loyal
17552,76,3,2357.2799999999997,4,3,4,11,Loyal
17553,68,4,2342.9199999999996,5,4,4,13,Champions
17554,348,2,39.980000000000004,1,2,1,4,At Risk
17555,92,4,2423.4799999999996,4,4,4,12,Loyal
17556,299,1,4.99,1,1,1,3,At Risk
17557,219,1,539.99,2,1,3,6,At Risk
17558,97,3,1750.47,4,3,4,11,Loyal
17559,204,4,1749.96,3,4,4,11,Loyal
17560,167,2,39.980000000000004,3,2,1,6,At Risk
17561,190,2,1735.98,3,2,4,9,Potential
17562,222,2,13.98,2,2,1,5,At Risk
17563,71,5,2397.9099999999994,5,5,4,14,Champions
17564,206,2,1735.98,3,2,4,9,Potential
17565,184,2,1750.98,3,2,4,9,Potential
17566,197,2,1735.98,3,2,4,9,Potential
17567,210,2,1709.98,2,2,4,8,Potential
17568,175,3,1714.97,3,3,4,10,Loyal
17569,337,3,64.47,1,3,2,6,At Risk
17570,337,3,68.97,1,3,2,6,At Risk
17571,165,3,1763.97,3,3,4,10,Loyal
17572,169,2,1735.98,3,2,4,9,Potential
17573,169,2,1735.98,3,2,4,9,Potential
17574,175,2,1709.98,3,2,4,9,Potential
17575,162,2,1735.98,3,2,4,9,Potential
17576,166,2,1750.98,3,2,4,9,Potential
17577,198,2,39.980000000000004,3,2,1,6,At Risk
17578,234,2,7.28,2,2,1,5,At Risk
17579,51,6,151.43,5,5,3,13,Champions
17580,73,3,2404.9699999999993,5,3,4,12,Loyal
17581,86,5,2369.45,4,5,4,13,Champions
17582,73,4,2398.4699999999993,5,4,4,13,Champions
17583,349,2,39.980000000000004,1,2,1,4,At Risk
17584,3,2,39.980000000000004,5,2,1,8,Recent Customer
17585,56,4,164.45999999999998,5,4,3,12,Loyal
17586,116,2,1750.98,4,2,4,10,Loyal
17587,86,1,4.99,4,1,1,6,At Risk
17588,79,2,13.98,4,2,1,7,Potential
17589,7,2,59.980000000000004,5,2,2,9,Recent Customer
17590,332,1,4.99,1,1,1,3,At Risk
17591,63,4,2337.2699999999995,5,4,4,13,Champions
17592,67,3,2334.9699999999993,5,3,4,12,Loyal
17593,86,3,2380.47,4,3,4,11,Loyal
17594,63,3,2376.9599999999996,5,3,4,12,Loyal
17595,75,3,1785.97,4,3,4,11,Loyal
17596,169,2,1750.98,3,2,4,9,Potential
17597,162,4,1723.96,3,4,4,11,Loyal
17598,177,2,39.980000000000004,3,2,1,6,At Risk
17599,177,2,13.98,3,2,1,6,At Risk
17600,172,3,1775.47,3,3,4,10,Loyal
17601,218,8,225.42,2,5,3,10,Loyal
17602,174,1,4.99,3,1,1,5,At Risk
17603,129,1,4.99,4,1,1,6,At Risk
17604,91,4,2369.9699999999993,4,4,4,12,Loyal
17605,286,2,39.980000000000004,2,2,1,5,At Risk
17606,135,1,4.99,3,1,1,5,At Risk
17607,152,2,54.980000000000004,3,2,2,7,Potential
17608,176,1,1700.99,3,1,4,8,Potential
17609,181,2,1725.98,3,2,4,9,Potential
17610,233,2,39.980000000000004,2,2,1,5,At Risk
17611,256,2,39.980000000000004,2,2,1,5,At Risk
17612,66,3,2351.9599999999996,5,3,4,12,Loyal
17613,126,4,2401.9499999999994,4,4,4,12,Loyal
17614,173,1,1700.99,3,1,4,8,Potential
17615,176,3,1763.97,3,3,4,10,Loyal
17616,279,1,4.99,2,1,1,4,At Risk
17617,175,2,1754.98,3,2,4,9,Potential
17618,165,2,39.980000000000004,3,2,1,6,At Risk
17619,69,6,163.92000000000002,5,5,3,13,Champions
17620,179,1,1700.99,3,1,4,8,Potential
17621,163,4,1732.26,3,4,4,11,Loyal
17622,135,2,2374.9799999999996,3,2,4,9,Potential
17623,85,3,2326.9599999999996,4,3,4,11,Loyal
17624,86,3,2357.2799999999997,4,3,4,11,Loyal
17625,124,5,2431.95,4,5,4,13,Champions
17626,227,3,3001.0425,2,3,4,9,Potential
17627,224,5,3021.0225,2,5,4,11,Loyal
17628,263,6,106.24,2,5,3,10,Loyal
17629,359,4,4173.32,1,4,5,10,Loyal
17630,356,1,4.99,1,1,1,3,At Risk
17631,317,4,97.96000000000001,1,4,3,8,Potential
17632,201,5,3001.0225,3,5,4,12,Loyal
17633,299,5,2732.6975,1,5,4,10,Loyal
17634,282,3,2736.4175,2,3,4,9,Potential
17635,317,3,4153.33,1,3,5,9,Potential
17636,117,4,73.96000000000001,4,4,2,10,Loyal
17637,351,3,149.98,1,3,3,7,Potential
17638,53,3,69.97,5,3,2,10,Loyal
17639,195,4,3075.0325,3,4,4,11,Loyal
17640,343,1,24.99,1,1,1,3,At Risk
17641,258,3,2736.4175,2,3,4,9,Potential
17642,47,5,32.95,5,5,1,11,Loyal
17643,83,3,69.97,4,3,2,9,Potential
17644,389,3,3017.33,1,3,4,8,Potential
17645,78,4,132.27,4,4,3,11,Loyal
17646,255,3,2751.4175,2,3,4,9,Potential
17647,89,5,4122.7575,4,5,5,14,Champions
17648,74,7,4122.737499999999,4,5,5,14,Champions
17649,349,1,3.99,1,1,1,3,At Risk
17650,81,2,38.980000000000004,4,2,1,7,Potential
17651,65,9,4180.2275,5,5,5,15,Champions
17652,281,3,14.23,2,3,1,6,At Risk
17653,264,2,39.980000000000004,2,2,1,5,At Risk
17654,74,3,1759.97,4,3,4,11,Loyal
17655,66,2,1750.98,5,2,4,11,Loyal
17656,70,4,578.46,5,4,3,12,Loyal
17657,26,5,113.24000000000001,5,5,3,13,Recent Customer
17658,156,2,7.28,3,2,1,6,At Risk
17659,178,2,1709.98,3,2,4,9,Potential
17660,175,3,1714.97,3,3,4,10,Loyal
17661,176,2,1709.98,3,2,4,9,Potential
17662,178,3,1763.97,3,3,4,10,Loyal
17663,312,2,7.28,1,2,1,4,At Risk
17664,239,5,624.95,2,5,3,10,Loyal
17665,87,2,39.980000000000004,4,2,1,7,Potential
17666,155,2,1735.98,3,2,4,9,Potential
17667,167,3,1760.47,3,3,4,10,Loyal
17668,219,3,553.97,2,3,3,8,Potential
17669,221,5,624.95,2,5,3,10,Loyal
17670,238,1,539.99,2,1,3,6,At Risk
17671,230,3,565.47,2,3,3,8,Potential
17672,230,1,539.99,2,1,3,6,At Risk
17673,17,1,4.99,5,1,1,7,Recent Customer
17674,133,2,39.980000000000004,4,2,1,7,Potential
17675,94,2,124.99,4,2,3,9,Potential
17676,242,2,603.49,2,2,3,7,Potential
17677,182,2,1735.98,3,2,4,9,Potential
17678,150,2,1735.98,3,2,4,9,Potential
17679,102,2,39.980000000000004,4,2,1,7,Potential
17680,14,7,222.19,5,5,3,13,Recent Customer
17681,135,2,1735.98,3,2,4,9,Potential
17682,205,2,68.49,3,2,2,7,Potential
17683,327,1,4.99,1,1,1,3,At Risk
17684,73,1,4.99,5,1,1,7,Potential
17685,362,1,4.99,1,1,1,3,At Risk
17686,4,6,104.23,5,5,3,13,Recent Customer
17687,55,2,39.980000000000004,5,2,1,8,Potential
17688,158,1,4.99,3,1,1,5,At Risk
17689,199,1,4.99,3,1,1,5,At Risk
17690,149,1,1700.99,3,1,4,8,Potential
17691,81,3,1779.47,4,3,4,11,Loyal
17692,147,2,13.98,3,2,1,6,At Risk
17693,305,2,13.98,1,2,1,4,At Risk
17694,285,1,4.99,2,1,1,4,At Risk
17695,272,3,67.93,2,3,2,7,Potential
17696,204,2,39.980000000000004,3,2,1,6,At Risk
17697,6,1,4.99,5,1,1,7,Recent Customer
17698,270,3,68.97,2,3,2,7,Potential
17699,211,3,67.93,2,3,2,7,Potential
17700,376,4,2805.5325000000003,1,4,4,9,Potential
17701,132,3,34.47,4,3,1,8,Potential
17702,113,4,56.76,4,4,2,10,Loyal
17703,243,4,78.96000000000001,2,4,2,8,Potential
17704,300,3,32.269999999999996,1,3,1,5,At Risk
17705,95,4,37.26,4,4,1,9,Potential
17706,30,5,77.91,5,5,2,12,Recent Customer
17707,190,3,32.269999999999996,3,3,1,7,Potential
17708,10,5,122.96,5,5,3,13,Recent Customer
17709,91,5,78.95,4,5,2,11,Loyal
17710,187,6,113.94,3,5,3,11,Loyal
17711,208,3,69.97,2,3,2,7,Potential
17712,200,3,56.96,3,3,2,8,Potential
17713,285,3,69.97,2,3,2,7,Potential
17714,269,3,2736.4175,2,3,4,9,Potential
17715,358,4,2831.5325,1,4,4,9,Potential
17716,258,2,2701.4275,2,2,4,8,Potential
17717,324,6,2840.0125000000003,1,5,4,10,Loyal
17718,194,3,32.269999999999996,3,3,1,7,Potential
17719,10,2,38.98,5,2,1,8,Recent Customer
17720,288,4,2790.5325,2,4,4,10,Loyal
17721,306,3,69.97,1,3,2,6,At Risk
17722,323,2,3882.5525,1,2,5,8,Potential
17723,116,6,83.94,4,5,2,11,Loyal
17724,171,3,36.96,3,3,1,7,Potential
17725,230,2,4698.76,2,2,5,9,Potential
17726,240,5,4721.73,2,5,5,12,Loyal
17727,299,1,21.98,1,1,1,3,At Risk
17728,208,5,4730.03,2,5,5,12,Loyal
17729,302,4,110.46000000000001,1,4,3,8,Potential
17730,210,5,4752.23,2,5,5,12,Loyal
17731,55,2,23.779999999999998,5,2,1,8,Potential
17732,197,3,4752.75,3,3,5,11,Loyal
17733,193,4,4758.24,3,4,5,12,Loyal
17734,211,2,4698.76,2,2,5,9,Potential
17735,174,3,4752.75,3,3,5,11,Loyal
17736,156,4,4742.74,3,4,5,12,Loyal
17737,241,1,29.99,2,1,1,4,At Risk
17738,342,1,24.99,1,1,1,3,At Risk
17739,228,3,2736.4175,2,3,4,9,Potential
17740,309,2,38.98,1,2,1,4,At Risk
17741,310,6,4217.299999999999,1,5,5,11,Loyal
17742,304,3,4198.33,1,3,5,9,Potential
17743,304,4,2793.5225,1,4,4,9,Potential
17744,276,4,2765.5325,2,4,4,10,Loyal
17745,233,3,32.269999999999996,2,3,1,6,At Risk
17746,303,2,29.979999999999997,1,2,1,4,At Risk
17747,281,3,2743.5325000000003,2,3,4,9,Potential
17748,166,2,32.28,3,2,1,6,At Risk
17749,176,3,69.97,3,3,2,8,Potential
17750,285,4,2888.5325000000003,2,4,4,10,Loyal
17751,257,2,93.49,2,2,3,7,Potential
17752,215,4,2776.4075000000003,2,4,4,10,Loyal
17753,253,6,3080.29,2,5,4,11,Loyal
17754,228,3,2755.4175,2,3,4,9,Potential
17755,261,3,2768.5325000000003,2,3,4,9,Potential
17756,243,4,2715.4075,2,4,4,10,Loyal
17757,70,3,79.97,5,3,2,10,Loyal
17758,187,3,32.269999999999996,3,3,1,7,Potential
17759,232,3,37.269999999999996,2,3,1,6,At Risk
17760,43,5,92.25,5,5,3,13,Champions
17761,253,4,3941.5325000000003,2,4,5,11,Loyal
17762,265,3,3936.5425,2,3,5,10,Loyal
17763,112,3,37.93,4,3,1,8,Potential
17764,260,4,3896.5325,2,4,5,11,Loyal
17765,265,4,3926.5325,2,4,5,11,Loyal
17766,66,5,4119.7474999999995,5,5,5,15,Champions
17767,45,5,4101.7575,5,5,5,15,Champions
17768,261,3,3907.0424999999996,2,3,5,10,Loyal
17769,240,4,3909.8325000000004,2,4,5,11,Loyal
17770,241,4,2715.4075,2,4,4,10,Loyal
17771,357,3,69.97,1,3,2,6,At Risk
17772,261,7,2846.0025,2,5,4,11,Loyal
17773,215,3,2751.4175,2,3,4,9,Potential
17774,13,2,27.279999999999998,5,2,1,8,Recent Customer
17775,238,5,2793.9075000000003,2,5,4,11,Loyal
17776,216,5,72.25,2,5,2,9,Potential
17777,237,3,4179.33,2,3,5,10,Loyal
17778,52,6,4175.7575,5,5,5,15,Champions
17779,41,10,4250.2074999999995,5,5,5,15,Champions
17780,51,4,4112.7675,5,4,5,14,Champions
17781,90,6,7187.369999999999,4,5,5,14,Champions
17782,198,3,3021.0424999999996,3,3,4,10,Loyal
17783,314,1,24.99,1,1,1,3,At Risk
17784,225,3,3891.5424999999996,2,3,5,10,Loyal
17785,315,4,67.26,1,4,2,7,Potential
17786,260,4,89.46,2,4,2,8,Potential
17787,198,3,2726.4175,3,3,4,10,Loyal
17788,303,3,64.97,1,3,2,6,At Risk
17789,221,3,3936.5425,2,3,5,10,Loyal
17790,265,4,3039.31,2,4,4,10,Loyal
17791,231,3,64.97,2,3,2,7,Potential
17792,170,5,3266.81,3,5,4,12,Loyal
17793,141,5,3250.1099999999997,3,5,4,12,Loyal
17794,228,4,2745.8225,2,4,4,10,Loyal
17795,219,2,2983.34,2,2,4,8,Potential
17796,230,5,3921.0225,2,5,5,12,Loyal
17797,180,3,64.97,3,3,2,8,Potential
17798,221,5,3058.31,2,5,4,11,Loyal
17799,243,3,3907.5424999999996,2,3,5,10,Loyal
17800,196,3,37.269999999999996,3,3,1,7,Potential
17801,67,6,125.92999999999999,5,5,3,13,Champions
17802,227,4,86.95,2,4,2,8,Potential
17803,242,5,2761.0225,2,5,4,11,Loyal
17804,216,4,73.96000000000001,2,4,2,8,Potential
17805,244,2,32.28,2,2,1,5,At Risk
17806,346,3,64.97,1,3,2,6,At Risk
17807,120,6,81.24,4,5,2,11,Loyal
17808,45,6,159.94,5,5,3,13,Champions
17809,208,5,205.26,2,5,3,10,Loyal
17810,247,6,87.94,2,5,2,9,Potential
17811,57,7,6989.5825,5,5,5,15,Champions
17812,130,4,2983.3325,4,4,4,12,Loyal
17813,238,5,3020.2999999999997,2,5,4,11,Loyal
17814,67,7,133.93,5,5,3,13,Champions
17815,221,7,3123.7799999999997,2,5,4,11,Loyal
17816,212,3,37.269999999999996,2,3,1,6,At Risk
17817,69,2,49.48,5,2,2,9,Potential
17818,135,1,3.99,3,1,1,5,At Risk
17819,17,1,3.99,5,1,1,7,Recent Customer
17820,286,1,3.99,2,1,1,4,At Risk
17821,286,2,6.28,2,2,1,5,At Risk
17822,149,1,29.99,3,1,1,5,At Risk
17823,180,3,40.23,3,3,2,8,Potential
17824,243,6,4334.61,2,5,5,12,Loyal
17825,47,9,7015.5525,5,5,5,15,Champions
17826,62,1,29.99,5,1,1,7,Potential
17827,188,3,2755.4175,3,3,4,10,Loyal
17828,148,3,3262.83,3,3,4,10,Loyal
17829,131,4,2983.3325,4,4,4,12,Loyal
17830,188,3,2751.4175,3,3,4,10,Loyal
17831,207,5,2750.3975,2,5,4,11,Loyal
17832,169,1,24.99,3,1,1,5,At Risk
17833,104,7,5999.449999999999,4,5,5,14,Champions
17834,51,8,4158.7175,5,5,5,15,Champions
17835,151,4,69.96,3,4,2,9,Potential
17836,163,2,32.28,3,2,1,6,At Risk
17837,187,4,73.96000000000001,3,4,2,9,Potential
17838,104,3,32.269999999999996,4,3,1,8,Potential
17839,42,3,34.97,5,3,1,9,Potential
17840,129,5,228.96,4,5,3,12,Loyal
17841,214,4,2803.5225,2,4,4,10,Loyal
17842,316,3,37.269999999999996,1,3,1,5,At Risk
17843,276,2,93.49,2,2,3,7,Potential
17844,262,5,196.26,2,5,3,10,Loyal
17845,330,1,24.99,1,1,1,3,At Risk
17846,183,3,69.97,3,3,2,8,Potential
17847,214,2,4144.34,2,2,5,9,Potential
17848,212,3,3917.5425,2,3,5,10,Loyal
17849,150,4,3025.5325000000003,3,4,4,11,Loyal
17850,347,4,78.96000000000001,1,4,2,7,Potential
17851,3,2,49.48,5,2,2,9,Recent Customer
17852,296,4,86.95,1,4,2,7,Potential
17853,186,2,29.979999999999997,3,2,1,6,At Risk
17854,57,3,64.97,5,3,2,10,Loyal
17855,44,5,189.96,5,5,3,13,Champions
17856,137,3,32.269999999999996,3,3,1,7,Potential
17857,214,1,24.99,2,1,1,4,At Risk
17858,71,1,1700.99,5,1,4,10,Loyal
17859,137,2,1735.98,3,2,4,9,Potential
17860,145,5,1777.95,3,5,4,12,Loyal
17861,67,4,1749.96,5,4,4,13,Champions
17862,142,2,1750.98,3,2,4,9,Potential
17863,150,3,67.93,3,3,2,8,Potential
17864,144,2,1750.98,3,2,4,9,Potential
17865,62,3,1789.97,5,3,4,12,Loyal
17866,140,2,1735.98,3,2,4,9,Potential
17867,27,6,176.93,5,5,3,13,Recent Customer
17868,134,2,1735.98,3,2,4,9,Potential
17869,145,3,1760.47,3,3,4,10,Loyal
17870,149,1,1700.99,3,1,4,8,Potential
17871,123,3,1729.97,4,3,4,11,Loyal
17872,100,2,39.980000000000004,4,2,1,7,Potential
17873,198,4,4203.32,3,4,5,12,Loyal
17874,70,2,34.98,5,2,1,8,Potential
17875,257,1,24.99,2,1,1,4,At Risk
17876,259,2,28.979999999999997,2,2,1,5,At Risk
17877,257,3,187.98,2,3,3,8,Potential
17878,83,3,69.97,4,3,2,9,Potential
17879,89,5,119.95,4,5,3,12,Loyal
17880,35,5,39.55,5,5,1,11,Loyal
17881,11,5,92.25,5,5,3,13,Recent Customer
17882,364,3,32.269999999999996,1,3,1,5,At Risk
17883,156,4,78.96000000000001,3,4,2,9,Potential
17884,179,2,29.979999999999997,3,2,1,6,At Risk
17885,169,2,2701.4275,3,2,4,9,Potential
17886,277,3,38.97,2,3,1,6,At Risk
17887,131,3,64.97,4,3,2,9,Potential
17888,142,2,29.979999999999997,3,2,1,6,At Risk
17889,189,3,3043.3299999999995,3,3,4,10,Loyal
17890,185,4,2753.5225,3,4,4,11,Loyal
17891,176,3,2736.4175,3,3,4,10,Loyal
17892,185,5,2787.5125,3,5,4,12,Loyal
17893,197,2,3882.5525,3,2,5,10,Loyal
17894,159,3,2710.4175,3,3,4,10,Loyal
17895,290,2,29.979999999999997,1,2,1,4,At Risk
17896,210,6,3044.7899999999995,2,5,4,11,Loyal
17897,164,4,2779.9075,3,4,4,11,Loyal
17898,194,5,4208.3099999999995,3,5,5,13,Champions
17899,252,1,29.99,2,1,1,4,At Risk
17900,170,3,2751.4175,3,3,4,10,Loyal
17901,89,3,31.27,4,3,1,8,Potential
17902,208,4,4158.32,2,4,5,11,Loyal
17903,97,3,32.269999999999996,4,3,1,8,Potential
17904,177,3,4733.75,3,3,5,11,Loyal
17905,81,2,25.479999999999997,4,2,1,7,Potential
17906,56,1,21.49,5,1,1,7,Potential
17907,114,3,27.77,4,3,1,8,Potential
17908,324,4,35.72,1,4,1,6,At Risk
17909,176,4,4761.74,3,4,5,12,Loyal
17910,129,2,4698.76,4,2,5,11,Loyal
17911,152,2,4698.76,3,2,5,10,Loyal
17912,127,3,4752.75,4,3,5,12,Loyal
17913,149,3,4733.75,3,3,5,11,Loyal
17914,138,2,4698.76,3,2,5,10,Loyal
17915,144,5,4792.73,3,5,5,13,Champions
17916,123,4,4787.74,4,4,5,13,Champions
17917,151,3,4733.75,3,3,5,11,Loyal
17918,144,3,4733.75,3,3,5,11,Loyal
17919,138,3,4733.75,3,3,5,11,Loyal
17920,117,3,4733.75,4,3,5,12,Loyal
17921,117,2,4698.76,4,2,5,11,Loyal
17922,116,6,4821.72,4,5,5,14,Champions
17923,97,3,4752.75,4,3,5,12,Loyal
17924,103,3,4733.75,4,3,5,12,Loyal
17925,98,2,4698.76,4,2,5,11,Loyal
17926,68,4,4715.7,5,4,5,14,Champions
17927,76,4,4726.04,4,4,5,13,Champions
17928,188,3,3917.5425,3,3,5,11,Loyal
17929,174,4,3896.5325,3,4,5,12,Loyal
17930,133,3,69.97,4,3,2,9,Potential
17931,155,1,29.99,3,1,1,5,At Risk
17932,158,5,2765.3975,3,5,4,12,Loyal
17933,196,5,3103.31,3,5,4,12,Loyal
17934,163,3,3907.0424999999996,3,3,5,11,Loyal
17935,221,3,63.97,2,3,2,7,Potential
17936,286,3,64.97,2,3,2,7,Potential
17937,177,4,3068.8199999999997,3,4,4,11,Loyal
17938,25,3,37.269999999999996,5,3,1,9,Recent Customer
17939,26,3,37.269999999999996,5,3,1,9,Recent Customer
17940,176,2,3882.5525,3,2,5,10,Loyal
17941,136,5,3931.5224999999996,3,5,5,13,Champions
17942,128,4,3896.5325,4,4,5,13,Champions
17943,166,3,2781.5424999999996,3,3,4,10,Loyal
17944,163,3,2751.4175,3,3,4,10,Loyal
17945,151,4,3961.0325,3,4,5,12,Loyal
17946,132,2,3882.5525,4,2,5,11,Loyal
17947,142,3,3932.5424999999996,3,3,5,11,Loyal
17948,168,5,3045.2999999999997,3,5,4,12,Loyal
17949,62,6,2606.2475,5,5,4,14,Champions
17950,178,5,2732.6975,3,5,4,12,Loyal
17951,208,2,27.279999999999998,2,2,1,5,At Risk
17952,96,4,3941.5325000000003,4,4,5,13,Champions
17953,163,3,84.97,3,3,2,8,Potential
17954,254,2,34.98,2,2,1,5,At Risk
17955,76,3,63.97,4,3,2,9,Potential
17956,145,5,2431.3582,3,5,4,12,Loyal
17957,128,3,2435.0782,4,3,4,11,Loyal
17958,160,5,2811.5225,3,5,4,12,Loyal
17959,157,4,2748.8325,3,4,4,11,Loyal
17960,101,3,3001.0425,4,3,4,11,Loyal
17961,86,4,73.96000000000001,4,4,2,10,Loyal
17962,163,4,2777.5225,3,4,4,11,Loyal
17963,110,3,3932.5424999999996,4,3,5,12,Loyal
17964,93,7,5750.362499999999,4,5,5,14,Champions
17965,116,3,3001.0425,4,3,4,11,Loyal
17966,64,3,3262.83,5,3,4,12,Loyal
17967,32,3,32.269999999999996,5,3,1,9,Potential
17968,157,3,3043.3299999999995,3,3,4,10,Loyal
17969,148,4,3040.31,3,4,4,11,Loyal
17970,303,2,27.279999999999998,1,2,1,4,At Risk
17971,125,3,2435.0782,4,3,4,11,Loyal
17972,151,4,2791.5325,3,4,4,11,Loyal
17973,144,6,2551.3582,3,5,4,12,Loyal
17974,130,6,2791.4624999999996,4,5,4,13,Champions
17975,354,3,1518.5782,1,3,4,8,Potential
17976,95,5,5801.3825,4,5,5,14,Champions
17977,90,4,2966.0325,4,4,4,12,Loyal
17978,51,5,3018.0125,5,5,4,14,Champions
17979,38,5,3001.0225,5,5,4,14,Champions
17980,103,3,4194.33,4,3,5,12,Loyal
17981,125,2,2983.34,4,2,4,10,Loyal
17982,300,5,1538.5582,1,5,4,10,Loyal
17983,113,8,5784.362499999999,4,5,5,14,Champions
17984,107,6,6083.17,4,5,5,14,Champions
17985,103,6,6016.659999999999,4,5,5,14,Champions
17986,69,7,5790.862499999999,5,5,5,15,Champions
17987,122,3,2450.0782,4,3,4,11,Loyal
17988,98,3,59.92,4,3,2,9,Potential
17989,121,3,3932.5424999999996,4,3,5,12,Loyal
17990,111,4,2778.5225,4,4,4,12,Loyal
17991,189,4,73.96000000000001,3,4,2,9,Potential
17992,336,3,31.27,1,3,1,5,At Risk
17993,360,2,78.98,1,2,2,5,At Risk
17994,347,2,27.279999999999998,1,2,1,4,At Risk
17995,148,2,27.279999999999998,3,2,1,6,At Risk
17996,122,3,2454.0782,4,3,4,11,Loyal
17997,286,3,69.97,2,3,2,7,Potential
17998,116,2,4144.34,4,2,5,11,Loyal
17999,119,3,2454.0782,4,3,4,11,Loyal
18000,104,6,3080.29,4,5,4,13,Champions
18001,79,3,31.27,4,3,1,8,Potential
18002,130,2,27.279999999999998,4,2,1,7,Potential
18003,5,3,63.97,5,3,2,10,Recent Customer
18004,273,3,1518.5782,2,3,4,9,Potential
18005,71,7,5804.8724999999995,5,5,5,15,Champions
18006,273,2,38.980000000000004,2,2,1,5,At Risk
18007,186,2,38.980000000000004,3,2,1,6,At Risk
18008,115,4,2459.0682,4,4,4,12,Loyal
18009,122,3,2435.0782,4,3,4,11,Loyal
18010,98,4,2485.0682,4,4,4,12,Loyal
18011,104,6,2590.3582,4,5,4,13,Champions
18012,88,2,25.479999999999997,4,2,1,7,Potential
18013,15,3,27.77,5,3,1,9,Recent Customer
18014,298,2,93.49,1,2,3,6,At Risk
18015,76,3,37.269999999999996,4,3,1,8,Potential
18016,76,2,34.98,4,2,1,7,Potential
18017,346,1,24.99,1,1,1,3,At Risk
18018,143,2,51.97,3,2,2,7,Potential
18019,63,5,5706.3825,5,5,5,15,Champions
18020,159,4,39.22,3,4,1,8,Potential
18021,93,4,2793.5225,4,4,4,12,Loyal
18022,336,3,63.97,1,3,2,6,At Risk
18023,120,3,187.98,4,3,3,10,Loyal
18024,303,3,149.98,1,3,3,7,Potential
18025,162,3,37.269999999999996,3,3,1,7,Potential
18026,58,5,2988.3225,5,5,4,14,Champions
18027,116,3,3917.5425,4,3,5,12,Loyal
18028,60,3,3001.0425,5,3,4,12,Loyal
18029,156,3,82.97,3,3,2,8,Potential
18030,329,3,64.97,1,3,2,6,At Risk
18031,258,1,24.99,2,1,1,4,At Risk
18032,269,5,144.45,2,5,3,10,Loyal
18033,150,1,24.99,3,1,1,5,At Risk
18034,253,3,63.97,2,3,2,7,Potential
18035,34,3,63.97,5,3,2,10,Loyal
18036,307,1,24.99,1,1,1,3,At Risk
18037,142,2,49.48,3,2,2,7,Potential
18038,114,3,2435.0782,4,3,4,11,Loyal
18039,119,3,2450.0782,4,3,4,11,Loyal
18040,214,3,193.98,2,3,3,8,Potential
18041,196,3,32.269999999999996,3,3,1,7,Potential
18042,303,2,29.979999999999997,1,2,1,4,At Risk
18043,254,2,34.98,2,2,1,5,At Risk
18044,144,3,32.269999999999996,3,3,1,7,Potential
18045,96,4,3941.5325000000003,4,4,5,13,Champions
18046,114,3,2435.0782,4,3,4,11,Loyal
18047,111,3,2736.4175,4,3,4,11,Loyal
18048,72,3,64.97,5,3,2,10,Loyal
18049,138,3,1785.97,3,3,4,10,Loyal
18050,142,2,1750.98,3,2,4,9,Potential
18051,58,2,1735.98,5,2,4,11,Loyal
18052,134,2,1735.98,3,2,4,9,Potential
18053,352,2,7.28,1,2,1,4,At Risk
18054,111,6,106.92999999999999,4,5,3,12,Loyal
18055,173,7,143.91,3,5,3,11,Loyal
18056,145,2,1725.98,3,2,4,9,Potential
18057,149,1,1700.99,3,1,4,8,Potential
18058,148,2,39.980000000000004,3,2,1,6,At Risk
18059,144,3,1714.97,3,3,4,10,Loyal
18060,150,1,1700.99,3,1,4,8,Potential
18061,199,1,4.99,3,1,1,5,At Risk
18062,129,3,63.970000000000006,4,3,2,9,Potential
18063,309,2,54.980000000000004,1,2,2,5,At Risk
18064,313,2,58.980000000000004,1,2,2,5,At Risk
18065,110,3,155.47,4,3,3,10,Loyal
18066,78,4,2344.9599999999996,4,4,4,12,Loyal
18067,73,3,2380.47,5,3,4,12,Loyal
18068,90,2,2439.99,4,2,4,10,Loyal
18069,181,1,4.99,3,1,1,5,At Risk
18070,6,1,4.99,5,1,1,7,Recent Customer
18071,279,2,68.49,2,2,2,6,At Risk
18072,144,1,4.99,3,1,1,5,At Risk
18073,9,2,13.98,5,2,1,8,Recent Customer
18074,194,2,58.980000000000004,3,2,2,7,Potential
18075,85,4,2394.9699999999993,4,4,4,12,Loyal
18076,92,3,67.93,4,3,2,9,Potential
18077,20,5,160.44,5,5,3,13,Recent Customer
18078,129,5,200.94,4,5,3,12,Loyal
18079,135,1,1700.99,3,1,4,8,Potential
18080,147,4,1737.92,3,4,4,11,Loyal
18081,183,2,51.97,3,2,2,7,Potential
18082,82,3,67.97,4,3,2,9,Potential
18083,213,3,89.97,2,3,2,7,Potential
18084,132,3,1775.47,4,3,4,11,Loyal
18085,124,4,1764.96,4,4,4,12,Loyal
18086,140,4,1723.96,3,4,4,11,Loyal
18087,153,2,13.98,3,2,1,6,At Risk
18088,139,2,1735.98,3,2,4,9,Potential
18089,61,2,1735.98,5,2,4,11,Loyal
18090,253,4,64.91,2,4,2,8,Potential
18091,55,2,1750.98,5,2,4,11,Loyal
18092,58,5,1789.45,5,5,4,14,Champions
18093,227,2,13.98,2,2,1,5,At Risk
18094,344,2,68.49,1,2,2,5,At Risk
18095,358,2,58.980000000000004,1,2,2,5,At Risk
18096,145,2,1735.98,3,2,4,9,Potential
18097,313,2,39.980000000000004,1,2,1,4,At Risk
18098,145,2,1754.98,3,2,4,9,Potential
18099,233,1,4.99,2,1,1,4,At Risk
18100,196,2,59.980000000000004,3,2,2,7,Potential
18101,72,3,64.47,5,3,2,10,Loyal
18102,359,1,4.99,1,1,1,3,At Risk
18103,50,2,1735.98,5,2,4,11,Loyal
18104,302,2,13.98,1,2,1,4,At Risk
18105,309,2,39.980000000000004,1,2,1,4,At Risk
18106,283,1,4.99,2,1,1,4,At Risk
18107,26,2,13.98,5,2,1,8,Recent Customer
18108,150,2,1735.98,3,2,4,9,Potential
18109,340,3,123.48,1,3,3,7,Potential
18110,360,2,12.940000000000001,1,2,1,4,At Risk
18111,348,1,4.99,1,1,1,3,At Risk
18112,233,3,64.47,2,3,2,7,Potential
18113,83,3,2391.9599999999996,4,3,4,11,Loyal
18114,15,2,58.980000000000004,5,2,2,9,Recent Customer
18115,67,2,13.98,5,2,1,8,Potential
18116,109,3,2376.9599999999996,4,3,4,11,Loyal
18117,37,2,13.98,5,2,1,8,Potential
18118,61,2,1750.98,5,2,4,11,Loyal
18119,102,2,13.98,4,2,1,7,Potential
18120,145,2,1725.98,3,2,4,9,Potential
18121,135,4,1793.47,3,4,4,11,Loyal
18122,96,2,2439.99,4,2,4,10,Loyal
18123,332,1,4.99,1,1,1,3,At Risk
18124,135,2,56.97,3,2,2,7,Potential
18125,180,4,5739.4974999999995,3,4,5,12,Loyal
18126,68,7,6945.5824999999995,5,5,5,15,Champions
18127,71,8,6982.0725,5,5,5,15,Champions
18128,289,2,85.48,1,2,2,5,At Risk
18129,238,3,96.46000000000001,2,3,3,8,Potential
18130,173,6,5743.9675,3,5,5,13,Champions
18131,143,3,3021.3781999999997,3,3,4,10,Loyal
18132,142,4,3034.0681999999997,3,4,4,11,Loyal
18133,142,5,5780.4675,3,5,5,13,Champions
18134,137,6,5732.4675,3,5,5,13,Champions
18135,73,6,6921.5824999999995,5,5,5,15,Champions
18136,69,5,6904.602499999999,5,5,5,15,Champions
18137,143,5,3043.0582,3,5,4,12,Loyal
18138,54,2,75.97,5,2,2,9,Potential
18139,143,9,5764.4275,3,5,5,13,Champions
18140,136,8,5741.407499999999,3,5,5,13,Champions
18141,44,8,6972.862499999999,5,5,5,15,Champions
18142,93,2,24.27,4,2,1,7,Potential
18143,144,5,3063.0581999999995,3,5,4,12,Loyal
18144,60,2,31.97,5,2,1,8,Potential
18145,353,2,71.97,1,2,2,5,At Risk
18146,98,2,31.97,4,2,1,7,Potential
18147,41,6,6930.5925,5,5,5,15,Champions
18148,265,3,1518.5782,2,3,4,9,Potential
18149,90,4,50.230000000000004,4,4,2,10,Loyal
18150,342,2,76.97,1,2,2,5,At Risk
18151,312,2,76.97,1,2,2,5,At Risk
18152,337,2,76.97,1,2,2,5,At Risk
18153,27,1,4.99,5,1,1,7,Recent Customer
18154,247,5,66.44,2,5,2,9,Potential
18155,22,7,135.43,5,5,3,13,Recent Customer
18156,35,5,82.26,5,5,2,12,Loyal
18157,140,5,3399.4074999999993,3,5,5,13,Champions
18158,57,4,6869.612499999999,5,4,5,14,Champions
18159,6,1,21.98,5,1,1,7,Recent Customer
18160,47,6,6914.592499999999,5,5,5,15,Champions
18161,250,2,7.28,2,2,1,5,At Risk
18162,111,2,7.28,4,2,1,7,Potential
18163,130,5,3044.0581999999995,4,5,4,13,Champions
18164,124,3,3330.4174999999996,4,3,5,12,Loyal
18165,117,5,82.26,4,5,2,11,Loyal
18166,49,7,7200.369999999999,5,5,5,15,Champions
18167,146,4,3405.4074999999993,3,4,5,12,Loyal
18168,42,6,6907.5525,5,5,5,15,Champions
18169,309,2,7.28,1,2,1,4,At Risk
18170,327,2,39.980000000000004,1,2,1,4,At Risk
18171,151,5,3319.3974999999996,3,5,5,13,Champions
18172,4,4,77.27,5,4,2,11,Recent Customer
18173,55,9,7189.349999999999,5,5,5,15,Champions
18174,364,2,7.28,1,2,1,4,At Risk
18175,126,4,3064.0681999999997,4,4,4,12,Loyal
18176,133,5,3345.3974999999996,4,5,5,14,Champions
18177,51,9,7043.5625,5,5,5,15,Champions
18178,1,3,51.46,5,3,2,10,Recent Customer
18179,287,1,4.99,2,1,1,4,At Risk
18180,264,2,12.940000000000001,2,2,1,5,At Risk
18181,237,7,185.92000000000002,2,5,3,10,Loyal
18182,295,1,4.99,1,1,1,3,At Risk
18183,142,5,3343.3574999999996,3,5,5,13,Champions
18184,105,3,89.97,4,3,2,9,Potential
18185,140,5,3332.3874999999994,3,5,5,13,Champions
18186,176,6,139.44,3,5,3,11,Loyal
18187,240,4,44.91,2,4,2,8,Potential
18188,174,5,6093.2,3,5,5,13,Champions
18189,248,2,4118.26,2,2,5,9,Potential
18190,131,2,30.97,4,2,1,7,Potential
18191,82,3,94.47,4,3,3,10,Loyal
18192,168,3,63.97,3,3,2,8,Potential
18193,180,4,4145.54,3,4,5,12,Loyal
18194,177,3,85.96000000000001,3,3,2,8,Potential
18195,63,3,94.47,5,3,3,11,Loyal
18196,160,4,4133.24,3,4,5,12,Loyal
18197,131,2,30.97,4,2,1,7,Potential
18198,97,3,4143.25,4,3,5,12,Loyal
18199,211,5,99.94,2,5,3,10,Loyal
18200,122,5,4150.53,4,5,5,14,Champions
18201,105,5,4157.7300000000005,4,5,5,14,Champions
18202,74,2,4143.26,4,2,5,11,Loyal
18203,74,3,4172.25,4,3,5,12,Loyal
18204,77,4,4133.24,4,4,5,13,Champions
18205,385,3,6056.61,1,3,5,9,Potential
18206,208,3,65.96000000000001,2,3,2,7,Potential
18207,372,5,6089.589999999999,1,5,5,11,Loyal
18208,395,4,6035.599999999999,1,4,5,10,Loyal
18209,385,3,6056.61,1,3,5,9,Potential
18210,374,5,6044.59,1,5,5,11,Loyal
18211,191,3,65.96000000000001,3,3,2,8,Potential
18212,391,3,6029.57,1,3,5,9,Potential
18213,378,5,6070.589999999999,1,5,5,11,Loyal
18214,383,5,6093.2,1,5,5,11,Loyal
18215,90,3,150.97,4,3,3,10,Loyal
18216,86,3,38.92,4,3,1,8,Potential
18217,382,3,6056.61,1,3,5,9,Potential
18218,385,2,6021.62,1,2,5,8,Potential
18219,375,4,6038.5599999999995,1,4,5,10,Loyal
18220,387,2,6021.62,1,2,5,8,Potential
18221,156,4,45.95,3,4,2,9,Potential
18222,375,5,6044.59,1,5,5,11,Loyal
18223,338,2,39.980000000000004,1,2,1,4,At Risk
18224,85,5,2394.45,4,5,4,13,Champions
18225,85,5,2349.9599999999996,4,5,4,13,Champions
18226,101,2,1725.98,4,2,4,10,Loyal
18227,122,3,1729.97,4,3,4,11,Loyal
18228,117,2,1709.98,4,2,4,10,Loyal
18229,95,1,1700.99,4,1,4,9,Potential
18230,68,1,4.99,5,1,1,7,Potential
18231,63,2,2414.99,5,2,4,11,Loyal
18232,82,4,2369.9699999999993,4,4,4,12,Loyal
18233,122,4,1732.26,4,4,4,12,Loyal
18234,114,2,1754.98,4,2,4,10,Loyal
18235,151,2,39.980000000000004,3,2,1,6,At Risk
18236,103,2,2414.99,4,2,4,10,Loyal
18237,121,4,2318.9599999999996,4,4,4,12,Loyal
18238,369,3,6030.61,1,3,5,9,Potential
18239,397,3,6030.61,1,3,5,9,Potential
18240,386,6,6098.58,1,5,5,11,Loyal
18241,376,4,6058.21,1,4,5,10,Loyal
18242,369,5,6121.71,1,5,5,11,Loyal
18243,387,4,6058.21,1,4,5,10,Loyal
18244,381,2,6021.62,1,2,5,8,Potential
18245,159,2,6021.62,3,2,5,10,Loyal
18246,388,3,6030.61,1,3,5,9,Potential
18247,98,3,84.96000000000001,4,3,2,9,Potential
18248,338,5,6037.89,1,5,5,11,Loyal
18249,358,5,6044.59,1,5,5,11,Loyal
18250,364,4,6058.21,1,4,5,10,Loyal
18251,360,4,6035.599999999999,1,4,5,10,Loyal
18252,355,2,6021.62,1,2,5,8,Potential
18253,168,4,45.95,3,4,2,9,Potential
18254,360,2,6021.62,1,2,5,8,Potential
18255,182,5,6067.2,3,5,5,13,Champions
18256,127,4,98.96000000000001,4,4,3,11,Loyal
18257,164,4,115.95000000000002,3,4,3,10,Loyal
18258,92,4,45.95,4,4,2,10,Loyal
18259,213,2,30.97,2,2,1,5,At Risk
18260,337,4,6035.599999999999,1,4,5,10,Loyal
18261,149,3,85.96000000000001,3,3,2,8,Potential
18262,37,5,142.45,5,5,3,13,Champions
18263,56,5,126.94,5,5,3,13,Champions
18264,103,3,69.97,4,3,2,9,Potential
18265,91,2,64.98,4,2,2,8,Potential
18266,163,4,72.25999999999999,3,4,2,9,Potential
18267,58,2,64.98,5,2,2,9,Potential
18268,155,6,6102.19,3,5,5,13,Champions
18269,134,5,6113.2,3,5,5,13,Champions
18270,202,3,94.47,3,3,3,9,Potential
18271,36,4,119.95000000000002,5,4,3,12,Loyal
18272,361,3,6056.61,1,3,5,9,Potential
18273,344,4,6104.21,1,4,5,10,Loyal
18274,95,2,30.97,4,2,1,7,Potential
18275,359,2,6021.62,1,2,5,8,Potential
18276,152,4,6106.599999999999,3,4,5,12,Loyal
18277,144,5,6070.589999999999,3,5,5,13,Champions
18278,197,5,158.95,3,5,3,11,Loyal
18279,49,8,162.02,5,5,3,13,Champions
18280,38,5,126.56,5,5,3,13,Champions
18281,135,4,6081.099999999999,3,4,5,12,Loyal
18282,134,2,30.97,3,2,1,6,At Risk
18283,29,5,128.94,5,5,3,13,Recent Customer
18284,337,3,6029.57,1,3,5,9,Potential
18285,164,6,141.55,3,5,3,11,Loyal
18286,56,6,141.55,5,5,3,13,Champions
18287,316,5,72.16,1,5,2,8,Potential
18288,358,5,6093.2,1,5,5,11,Loyal
18289,14,3,94.47,5,3,3,11,Recent Customer
18290,95,3,84.96000000000001,4,3,2,9,Potential
18291,108,2,30.97,4,2,1,7,Potential
18292,119,4,39.25,4,4,1,9,Potential
18293,363,5,74.24,1,5,2,8,Potential
18294,73,3,78.26,5,3,2,10,Loyal
18295,262,3,144.27,2,3,3,8,Potential
18296,347,6,6117.69,1,5,5,11,Loyal
18297,337,5,6119.589999999999,1,5,5,11,Loyal
18298,155,2,24.27,3,2,1,6,At Risk
18299,181,3,32.22,3,3,1,7,Potential
18300,168,3,64.88,3,3,2,8,Potential
18301,366,3,6056.61,1,3,5,9,Potential
18302,358,3,6029.57,1,3,5,9,Potential
18303,344,3,6030.61,1,3,5,9,Potential
18304,28,3,26.560000000000002,5,3,1,9,Recent Customer
18305,112,6,160.55,4,5,3,12,Loyal
18306,190,3,87.77,3,3,2,8,Potential
18307,356,2,6021.62,1,2,5,8,Potential
18308,360,5,6037.89,1,5,5,11,Loyal
18309,365,5,6090.59,1,5,5,11,Loyal
18310,231,1,21.49,2,1,1,4,At Risk
18311,45,2,13.98,5,2,1,8,Potential
18312,302,3,15.23,1,3,1,5,At Risk
18313,60,2,7.28,5,2,1,8,Potential
18314,210,6,115.72999999999999,2,5,3,10,Loyal
18315,216,2,7.28,2,2,1,5,At Risk
18316,96,2,7.28,4,2,1,7,Potential
18317,10,5,84.74,5,5,2,12,Recent Customer
18318,120,3,1760.47,4,3,4,11,Loyal
18319,280,3,60.47,2,3,2,7,Potential
18320,30,10,223.19,5,5,3,13,Recent Customer
18321,308,2,12.940000000000001,1,2,1,4,At Risk
18322,40,9,148.89,5,5,3,13,Champions
18323,194,2,39.980000000000004,3,2,1,6,At Risk
18324,42,2,1735.98,5,2,4,11,Loyal
18325,254,6,108.85,2,5,3,10,Loyal
18326,20,4,97.96000000000001,5,4,3,12,Recent Customer
18327,307,2,13.98,1,2,1,4,At Risk
18328,112,2,7.28,4,2,1,7,Potential
18329,97,7,146.53,4,5,3,12,Loyal
18330,24,3,88.97,5,3,2,10,Recent Customer
18331,72,3,4752.75,5,3,5,13,Champions
18332,68,3,4752.75,5,3,5,13,Champions
18333,36,3,27.77,5,3,1,9,Potential
18334,92,2,4698.76,4,2,5,11,Loyal
18335,70,4,6035.599999999999,5,4,5,14,Champions
18336,41,7,6145.07,5,5,5,15,Champions
18337,57,2,6021.62,5,2,5,12,Loyal
18338,48,6,6124.58,5,5,5,15,Champions
18339,108,2,13.98,4,2,1,7,Potential
18340,82,2,39.980000000000004,4,2,1,7,Potential
18341,17,3,67.93,5,3,2,10,Recent Customer
18342,248,2,39.980000000000004,2,2,1,5,At Risk
18343,166,2,39.980000000000004,3,2,1,6,At Risk
18344,102,3,1759.97,4,3,4,11,Loyal
18345,90,3,115.47,4,3,3,10,Loyal
18346,343,2,13.98,1,2,1,4,At Risk
18347,195,2,39.980000000000004,3,2,1,6,At Risk
18348,338,2,29.479999999999997,1,2,1,4,At Risk
18349,310,2,39.980000000000004,1,2,1,4,At Risk
18350,101,2,1735.98,4,2,4,10,Loyal
18351,67,1,2319.99,5,1,4,10,Loyal
18352,81,3,2334.9799999999996,4,3,4,11,Loyal
18353,83,2,2316.97,4,2,4,10,Loyal
18354,281,3,132.94,2,3,3,8,Potential
18355,39,4,150.95,5,4,3,12,Loyal
18356,31,4,149.91,5,4,3,12,Loyal
18357,90,3,2309.9699999999993,4,3,4,11,Loyal
18358,294,2,39.980000000000004,1,2,1,4,At Risk
18359,18,2,68.49,5,2,2,9,Recent Customer
18360,122,2,1750.98,4,2,4,10,Loyal
18361,114,2,1750.98,4,2,4,10,Loyal
18362,60,5,1725.21,5,5,4,14,Champions
18363,40,1,1700.99,5,1,4,10,Loyal
18364,325,2,124.99,1,2,3,6,At Risk
18365,240,2,39.980000000000004,2,2,1,5,At Risk
18366,106,3,1775.47,4,3,4,11,Loyal
18367,13,1,21.49,5,1,1,7,Recent Customer
18368,41,2,1754.98,5,2,4,11,Loyal
18369,109,2,1725.98,4,2,4,10,Loyal
18370,107,1,1700.99,4,1,4,9,Potential
18371,111,2,1754.98,4,2,4,10,Loyal
18372,48,3,1760.47,5,3,4,12,Loyal
18373,108,3,1763.97,4,3,4,11,Loyal
18374,318,2,12.940000000000001,1,2,1,4,At Risk
18375,40,4,2344.9599999999996,5,4,4,13,Champions
18376,44,4,2369.9699999999993,5,4,4,13,Champions
18377,115,4,2394.9699999999993,4,4,4,12,Loyal
18378,59,2,2439.99,5,2,4,11,Loyal
18379,96,4,2362.2699999999995,4,4,4,12,Loyal
18380,208,2,12.940000000000001,2,2,1,5,At Risk
18381,51,4,2359.4599999999996,5,4,4,13,Champions
18382,124,5,204.94,4,5,3,12,Loyal
18383,180,2,13.98,3,2,1,6,At Risk
18384,354,3,103.48,1,3,3,7,Potential
18385,15,1,4.99,5,1,1,7,Recent Customer
18386,50,3,2309.9699999999993,5,3,4,12,Loyal
18387,301,1,4.99,1,1,1,3,At Risk
18388,41,4,2337.2699999999995,5,4,4,13,Champions
18389,111,4,2401.4499999999994,4,4,4,12,Loyal
18390,88,3,141.96,4,3,3,10,Loyal
18391,299,3,100.96,1,3,3,7,Potential
18392,102,4,2342.93,4,4,4,12,Loyal
18393,58,1,2294.99,5,1,4,10,Loyal
18394,44,2,2297.2799999999997,5,2,4,11,Loyal
18395,54,2,2374.9799999999996,5,2,4,11,Loyal
18396,138,2,29.479999999999997,3,2,1,6,At Risk
18397,83,1,4.99,4,1,1,6,At Risk
18398,50,3,2350.9599999999996,5,3,4,12,Loyal
18399,57,3,2334.9699999999993,5,3,4,12,Loyal
18400,32,6,2409.95,5,5,4,14,Champions
18401,94,1,2294.99,4,1,4,9,Potential
18402,153,1,4.99,3,1,1,5,At Risk
18403,34,4,2318.9599999999996,5,4,4,13,Champions
18404,138,1,4.99,3,1,1,5,At Risk
18405,191,1,4.99,3,1,1,5,At Risk
18406,36,2,2354.99,5,2,4,11,Loyal
18407,106,4,63.25,4,4,2,10,Loyal
18408,84,2,12.940000000000001,4,2,1,7,Potential
18409,122,3,1728.27,4,3,4,11,Loyal
18410,121,2,58.980000000000004,4,2,2,8,Potential
18411,191,3,56.96,3,3,2,8,Potential
18412,40,1,2319.99,5,1,4,10,Loyal
18413,36,3,2395.9599999999996,5,3,4,12,Loyal
18414,114,3,1760.47,4,3,4,11,Loyal
18415,37,4,2454.9799999999996,5,4,4,13,Champions
18416,56,4,2369.9599999999996,5,4,4,13,Champions
18417,179,2,39.980000000000004,3,2,1,6,At Risk
18418,32,2,2322.2799999999997,5,2,4,11,Loyal
18419,13,2,39.980000000000004,5,2,1,8,Recent Customer
18420,53,2,2414.99,5,2,4,11,Loyal
18421,95,1,4.99,4,1,1,6,At Risk
18422,52,3,2351.9599999999996,5,3,4,12,Loyal
18423,310,1,4.99,1,1,1,3,At Risk
18424,327,1,4.99,1,1,1,3,At Risk
18425,140,1,4.99,3,1,1,5,At Risk
18426,35,4,2362.2699999999995,5,4,4,13,Champions
18427,49,4,2334.4599999999996,5,4,4,13,Champions
18428,52,3,2332.2799999999997,5,3,4,12,Loyal
18429,51,2,2341.97,5,2,4,11,Loyal
18430,99,3,1775.47,4,3,4,11,Loyal
18431,101,2,1754.98,4,2,4,10,Loyal
18432,53,3,2350.9599999999996,5,3,4,12,Loyal
18433,109,2,2329.9799999999996,4,2,4,10,Loyal
18434,33,1,4.99,5,1,1,7,Potential
18435,53,3,2376.9599999999996,5,3,4,12,Loyal
18436,47,1,2294.99,5,1,4,10,Loyal
18437,57,3,2359.9799999999996,5,3,4,12,Loyal
18438,98,2,1709.98,4,2,4,10,Loyal
18439,119,1,1700.99,4,1,4,9,Potential
18440,107,3,1775.47,4,3,4,11,Loyal
18441,48,3,2380.47,5,3,4,12,Loyal
18442,45,4,2312.2599999999998,5,4,4,13,Champions
18443,43,3,60.47,5,3,2,10,Loyal
18444,31,2,25.479999999999997,5,2,1,8,Potential
18445,232,1,21.49,2,1,1,4,At Risk
18446,129,1,21.49,4,1,1,6,At Risk
18447,257,1,21.49,2,1,1,4,At Risk
18448,108,2,1735.98,4,2,4,10,Loyal
18449,209,5,100.94,2,5,3,10,Loyal
18450,92,2,25.479999999999997,4,2,1,7,Potential
18451,69,3,75.47,5,3,2,10,Loyal
18452,81,3,4752.75,4,3,5,12,Loyal
18453,86,1,4.99,4,1,1,6,At Risk
18454,365,2,68.49,1,2,2,5,At Risk
18455,74,3,64.47,4,3,2,9,Potential
18456,86,2,12.940000000000001,4,2,1,7,Potential
18457,53,6,4826.23,5,5,5,15,Champions
18458,47,3,4733.75,5,3,5,13,Champions
18459,242,4,588.96,2,4,3,9,Potential
18460,55,2,2341.97,5,2,4,11,Loyal
18461,53,4,4748.24,5,4,5,14,Champions
18462,48,3,4752.75,5,3,5,13,Champions
18463,58,4,4726.04,5,4,5,14,Champions
18464,43,2,4698.76,5,2,5,12,Loyal
18465,42,3,4752.75,5,3,5,13,Champions
18466,20,4,97.96000000000001,5,4,3,12,Recent Customer
18467,394,2,5279.26,1,2,5,8,Potential
18468,391,3,5333.25,1,3,5,9,Potential
18469,349,2,6021.62,1,2,5,8,Potential
18470,364,2,6021.62,1,2,5,8,Potential
18471,195,1,539.99,3,1,3,7,Potential
18472,25,3,79.47,5,3,2,10,Recent Customer
18473,176,3,127.28,3,3,3,9,Potential
18474,119,2,39.980000000000004,4,2,1,7,Potential
18475,209,5,616.9100000000001,2,5,3,10,Loyal
18476,209,5,616.9100000000001,2,5,3,10,Loyal
18477,340,2,13.98,1,2,1,4,At Risk
18478,53,3,2380.47,5,3,4,12,Loyal
18479,42,3,2351.9599999999996,5,3,4,12,Loyal
18480,42,2,2329.99,5,2,4,11,Loyal
18481,56,4,2318.9599999999996,5,4,4,13,Champions
18482,359,3,6030.61,1,3,5,9,Potential
18483,350,3,6056.61,1,3,5,9,Potential
18484,358,5,6093.2,1,5,5,11,Loyal
18485,337,4,6063.21,1,4,5,10,Loyal
18486,332,2,6021.62,1,2,5,8,Potential
18487,316,2,6021.62,1,2,5,8,Potential
18488,331,3,6056.61,1,3,5,9,Potential
18489,333,4,6081.099999999999,1,4,5,10,Loyal
18490,309,3,6029.57,1,3,5,9,Potential
18491,306,3,6056.61,1,3,5,9,Potential
18492,179,4,218.26,3,4,3,10,Loyal
18493,316,3,6029.57,1,3,5,9,Potential
18494,325,5,6037.89,1,5,5,11,Loyal
18495,317,2,6021.62,1,2,5,8,Potential
18496,317,5,6121.71,1,5,5,11,Loyal
18497,50,2,2329.9799999999996,5,2,4,11,Loyal
18498,143,2,54.980000000000004,3,2,2,7,Potential
18499,11,1,4.99,5,1,1,7,Recent Customer
18500,49,2,39.980000000000004,5,2,1,8,Potential
18501,119,2,1750.98,4,2,4,10,Loyal
18502,117,3,1760.47,4,3,4,11,Loyal
18503,4,2,123.97999999999999,5,2,3,10,Recent Customer
18504,204,3,128.97,3,3,3,9,Potential
18505,8,2,13.98,5,2,1,8,Recent Customer
18506,118,5,101.94,4,5,3,12,Loyal
18507,26,3,103.48,5,3,3,11,Recent Customer
18508,47,4,2359.9599999999996,5,4,4,13,Champions
18509,253,2,59.980000000000004,2,2,2,6,At Risk
18510,273,1,4.99,2,1,1,4,At Risk
18511,45,6,2465.93,5,5,4,14,Champions
18512,54,2,2349.9799999999996,5,2,4,11,Loyal
18513,55,2,2341.97,5,2,4,11,Loyal
18514,53,4,2389.9599999999996,5,4,4,13,Champions
18515,45,6,2396.9399999999996,5,5,4,14,Champions
18516,34,4,2404.91,5,4,4,13,Champions
18517,135,2,78.97999999999999,3,2,2,7,Potential
18518,38,4,2379.9499999999994,5,4,4,13,Champions
18519,53,4,2362.2699999999995,5,4,4,13,Champions
18520,288,2,78.97999999999999,2,2,2,6,At Risk
18521,317,2,119.97999999999999,1,2,3,6,At Risk
18522,311,1,69.99,1,1,2,4,At Risk
18523,178,5,160.94,3,5,3,11,Loyal
18524,58,4,195.95,5,4,3,12,Loyal
18525,54,2,1735.98,5,2,4,11,Loyal
18526,36,4,2317.9199999999996,5,4,4,13,Champions
18527,61,1,2319.99,5,1,4,10,Loyal
18528,55,5,2381.9399999999996,5,5,4,14,Champions
18529,1,2,39.980000000000004,5,2,1,8,Recent Customer
18530,345,3,113.97,1,3,3,7,Potential
18531,142,1,4.99,3,1,1,5,At Risk
18532,44,5,2345.22,5,5,4,14,Champions
18533,37,3,2405.47,5,3,4,12,Loyal
18534,332,2,54.980000000000004,1,2,2,5,At Risk
18535,4,2,51.97,5,2,2,9,Recent Customer
18536,82,2,54.980000000000004,4,2,2,8,Potential
18537,54,1,2294.99,5,1,4,10,Loyal
18538,37,1,2319.99,5,1,4,10,Loyal
18539,34,4,2356.9499999999994,5,4,4,13,Champions
18540,35,4,2401.4499999999994,5,4,4,13,Champions
18541,117,3,94.25999999999999,4,3,3,10,Loyal
18542,205,2,123.97999999999999,3,2,3,8,Potential
18543,112,2,1735.98,4,2,4,10,Loyal
18544,393,2,1155.48,1,2,3,6,At Risk
18545,116,2,1725.98,4,2,4,10,Loyal
18546,291,2,29.479999999999997,1,2,1,4,At Risk
18547,36,3,2351.9599999999996,5,3,4,12,Loyal
18548,115,2,1754.98,4,2,4,10,Loyal
18549,343,4,1169.46,1,4,4,9,Potential
18550,54,3,64.47,5,3,2,10,Loyal
18551,122,2,1709.98,4,2,4,10,Loyal
18552,318,1,4.99,1,1,1,3,At Risk
18553,116,1,1700.99,4,1,4,9,Potential
18554,301,5,155.45,1,5,3,9,Potential
18555,21,1,4.99,5,1,1,7,Recent Customer
18556,93,1,1700.99,4,1,4,9,Potential
18557,352,3,1179.47,1,3,4,8,Potential
18558,104,2,1750.98,4,2,4,10,Loyal
18559,101,2,1735.98,4,2,4,10,Loyal
18560,55,3,2366.9599999999996,5,3,4,12,Loyal
18561,33,4,2389.9599999999996,5,4,4,13,Champions
18562,111,4,1732.26,4,4,4,12,Loyal
18563,65,2,1750.98,5,2,4,11,Loyal
18564,92,3,1714.97,4,3,4,11,Loyal
18565,68,5,1789.45,5,5,4,14,Champions
18566,45,3,2379.4799999999996,5,3,4,12,Loyal
18567,74,1,1700.99,4,1,4,9,Potential
18568,74,4,1732.26,4,4,4,12,Loyal
18569,357,1,4.99,1,1,1,3,At Risk
18570,326,2,1174.48,1,2,4,7,Potential
18571,316,1,1120.49,1,1,3,5,At Risk
18572,262,2,13.98,2,2,1,5,At Risk
18573,215,5,83.74,2,5,2,9,Potential
18574,306,2,39.980000000000004,1,2,1,4,At Risk
18575,106,2,78.97999999999999,4,2,2,8,Potential
18576,74,2,78.97999999999999,4,2,2,8,Potential
18577,330,1,69.99,1,1,2,4,At Risk
18578,50,3,2351.9599999999996,5,3,4,12,Loyal
18579,93,1,69.99,4,1,2,7,Potential
18580,291,2,1170.48,1,2,4,7,Potential
18581,48,3,2351.9599999999996,5,3,4,12,Loyal
18582,43,4,2318.9599999999996,5,4,4,13,Champions
18583,355,2,119.97999999999999,1,2,3,6,At Risk
18584,327,2,123.97999999999999,1,2,3,6,At Risk
18585,94,2,78.97999999999999,4,2,2,8,Potential
18586,34,2,2322.2799999999997,5,2,4,11,Loyal
18587,104,1,69.99,4,1,2,7,Potential
18588,118,2,119.97999999999999,4,2,3,9,Potential
18589,75,4,1768.96,4,4,4,12,Loyal
18590,252,2,119.97999999999999,2,2,3,7,Potential
18591,329,2,119.97999999999999,1,2,3,6,At Risk
18592,61,1,2294.99,5,1,4,10,Loyal
18593,331,1,69.99,1,1,2,4,At Risk
18594,44,3,2325.9599999999996,5,3,4,12,Loyal
18595,95,2,2329.99,4,2,4,10,Loyal
18596,73,3,1775.47,5,3,4,12,Loyal
18597,74,3,1760.47,4,3,4,11,Loyal
18598,74,1,1700.99,4,1,4,9,Potential
18599,264,2,78.97999999999999,2,2,2,6,At Risk
18600,199,2,51.97,3,2,2,7,Potential
18601,317,1,69.99,1,1,2,4,At Risk
18602,294,2,119.97999999999999,1,2,3,6,At Risk
18603,300,3,1205.47,1,3,4,8,Potential
18604,43,4,59.25,5,4,2,11,Loyal
18605,87,2,1735.98,4,2,4,10,Loyal
18606,79,2,1750.98,4,2,4,10,Loyal
18607,64,2,1750.98,5,2,4,11,Loyal
18608,65,3,1714.97,5,3,4,12,Loyal
18609,75,3,1785.97,4,3,4,11,Loyal
18610,34,2,2297.2799999999997,5,2,4,11,Loyal
18611,55,5,2391.9399999999996,5,5,4,14,Champions
18612,162,2,119.97999999999999,3,2,3,8,Potential
18613,44,2,2341.97,5,2,4,11,Loyal
18614,40,1,2319.99,5,1,4,10,Loyal
18615,47,3,2334.9699999999993,5,3,4,12,Loyal
18616,64,3,1729.97,5,3,4,12,Loyal
18617,292,3,1147.77,1,3,3,7,Potential
18618,8,2,32.28,5,2,1,8,Recent Customer
18619,200,2,38.980000000000004,3,2,1,6,At Risk
18620,45,3,3001.0425,5,3,4,12,Loyal
18621,326,3,3033.33,1,3,4,8,Potential
18622,66,3,64.97,5,3,2,10,Loyal
18623,172,3,37.269999999999996,3,3,1,7,Potential
18624,334,1,29.99,1,1,1,3,At Risk
18625,102,5,2753.8225,4,5,4,13,Champions
18626,90,6,4644.7474999999995,4,5,5,14,Champions
18627,215,4,3027.3199999999997,2,4,4,10,Loyal
18628,241,5,128.95,2,5,3,10,Loyal
18629,162,1,24.99,3,1,1,5,At Risk
18630,44,3,48.970000000000006,5,3,2,10,Loyal
18631,56,1,24.99,5,1,1,7,Potential
18632,343,3,32.269999999999996,1,3,1,5,At Risk
18633,106,6,2793.5025,4,5,4,13,Champions
18634,94,4,2427.3682,4,4,4,12,Loyal
18635,349,2,162.99,1,2,3,6,At Risk
18636,154,2,58.980000000000004,3,2,2,7,Potential
18637,95,5,121.94,4,5,3,12,Loyal
18638,68,3,1760.47,5,3,4,12,Loyal
18639,64,1,1700.99,5,1,4,10,Loyal
18640,327,2,39.980000000000004,1,2,1,4,At Risk
18641,298,1,1120.49,1,1,3,5,At Risk
18642,24,9,216.4,5,5,3,13,Recent Customer
18643,49,1,2319.99,5,1,4,10,Loyal
18644,204,6,135.44,3,5,3,11,Loyal
18645,83,1,1700.99,4,1,4,9,Potential
18646,74,2,1735.98,4,2,4,10,Loyal
18647,207,3,599.47,2,3,3,8,Potential
18648,165,3,556.9300000000001,3,3,3,9,Potential
18649,163,2,603.49,3,2,3,8,Potential
18650,157,2,561.48,3,2,3,8,Potential
18651,171,4,607.96,3,4,3,10,Loyal
18652,214,2,13.98,2,2,1,5,At Risk
18653,146,3,553.97,3,3,3,9,Potential
18654,79,3,1775.97,4,3,4,11,Loyal
18655,62,2,1735.98,5,2,4,11,Loyal
18656,147,2,564.48,3,2,3,8,Potential
18657,294,1,4.99,1,1,1,3,At Risk
18658,187,2,58.980000000000004,3,2,2,7,Potential
18659,263,2,78.97999999999999,2,2,2,6,At Risk
18660,74,1,69.99,4,1,2,7,Potential
18661,114,1,4.99,4,1,1,6,At Risk
18662,81,2,39.980000000000004,4,2,1,7,Potential
18663,189,2,13.98,3,2,1,6,At Risk
18664,361,2,13.98,1,2,1,4,At Risk
18665,181,3,67.93,3,3,2,8,Potential
18666,216,2,58.980000000000004,2,2,2,6,At Risk
18667,119,2,12.940000000000001,4,2,1,7,Potential
18668,5,1,4.99,5,1,1,7,Recent Customer
18669,174,1,69.99,3,1,2,6,At Risk
18670,80,4,1723.96,4,4,4,12,Loyal
18671,327,1,69.99,1,1,2,4,At Risk
18672,160,3,128.97,3,3,3,9,Potential
18673,203,3,128.97,3,3,3,9,Potential
18674,3,3,145.96,5,3,3,11,Recent Customer
18675,290,3,128.97,1,3,3,7,Potential
18676,269,2,119.97999999999999,2,2,3,7,Potential
18677,265,3,60.96,2,3,2,7,Potential
18678,228,2,78.97999999999999,2,2,2,6,At Risk
18679,70,1,1700.99,5,1,4,10,Loyal
18680,87,2,1735.98,4,2,4,10,Loyal
18681,311,1,69.99,1,1,2,4,At Risk
18682,125,1,69.99,4,1,2,7,Potential
18683,236,2,78.97999999999999,2,2,2,6,At Risk
18684,77,2,1754.98,4,2,4,10,Loyal
18685,46,4,124.46,5,4,3,12,Loyal
18686,178,4,91.95,3,4,2,9,Potential
18687,354,2,94.47999999999999,1,2,3,6,At Risk
18688,166,2,78.97999999999999,3,2,2,7,Potential
18689,235,2,78.97999999999999,2,2,2,6,At Risk
18690,104,2,119.97999999999999,4,2,3,9,Potential
18691,314,5,6070.589999999999,1,5,5,11,Loyal
18692,335,4,6035.599999999999,1,4,5,10,Loyal
18693,317,2,6021.62,1,2,5,8,Potential
18694,332,4,6035.599999999999,1,4,5,10,Loyal
18695,310,3,6029.57,1,3,5,9,Potential
18696,329,7,6149.57,1,5,5,11,Loyal
18697,391,2,5279.26,1,2,5,8,Potential
18698,375,3,5314.25,1,3,5,9,Potential
18699,363,4,5308.24,1,4,5,10,Loyal
18700,360,5,5328.23,1,5,5,11,Loyal
18701,355,4,5357.74,1,4,5,10,Loyal
18702,338,3,5333.25,1,3,5,9,Potential
18703,306,3,5314.25,1,3,5,9,Potential
18704,155,3,33.260000000000005,3,3,1,7,Potential
18705,188,3,59.260000000000005,3,3,2,8,Potential
18706,313,5,6060.5,1,5,5,11,Loyal
18707,136,4,122.76,3,4,3,10,Loyal
18708,326,4,6056.51,1,4,5,10,Loyal
18709,311,6,6098.54,1,5,5,11,Loyal
18710,318,6,6098.58,1,5,5,11,Loyal
18711,19,4,86.21000000000001,5,4,2,11,Recent Customer
18712,154,2,24.27,3,2,1,6,At Risk
18713,37,4,237.26,5,4,3,12,Loyal
18714,217,2,24.27,2,2,1,5,At Risk
18715,55,4,123.96000000000001,5,4,3,12,Loyal
18716,333,2,6021.62,1,2,5,8,Potential
18717,86,4,87.21000000000001,4,4,2,10,Loyal
18718,315,4,6035.599999999999,1,4,5,10,Loyal
18719,20,3,88.97,5,3,2,10,Recent Customer
18720,36,3,86.27000000000001,5,3,2,10,Loyal
18721,307,3,5333.25,1,3,5,9,Potential
18722,316,3,5333.25,1,3,5,9,Potential
18723,335,2,5279.26,1,2,5,8,Potential
18724,330,4,6056.51,1,4,5,10,Loyal
18725,309,5,6044.59,1,5,5,11,Loyal
18726,331,3,5314.25,1,3,5,9,Potential
18727,38,3,86.27000000000001,5,3,2,10,Loyal
18728,105,4,56.71,4,4,2,10,Loyal
18729,325,3,5333.25,1,3,5,9,Potential
18730,25,4,39.25,5,4,1,10,Recent Customer
18731,315,4,6054.0599999999995,1,4,5,10,Loyal
18732,2,4,114.46000000000001,5,4,3,12,Recent Customer
18733,292,2,24.27,1,2,1,4,At Risk
18734,67,2,24.27,5,2,1,8,Potential
18735,334,2,6021.62,1,2,5,8,Potential
18736,314,4,6035.599999999999,1,4,5,10,Loyal
18737,318,2,6021.62,1,2,5,8,Potential
18738,313,5,6089.589999999999,1,5,5,11,Loyal
18739,318,5,5371.74,1,5,5,11,Loyal
18740,324,3,6056.61,1,3,5,9,Potential
18741,73,3,60.47,5,3,2,10,Loyal
18742,18,2,24.27,5,2,1,8,Recent Customer
18743,92,4,67.21000000000001,4,4,2,10,Loyal
18744,37,3,32.22,5,3,1,9,Potential
18745,51,3,78.26,5,3,2,10,Loyal
18746,329,5,6135.089999999999,1,5,5,11,Loyal
18747,318,5,6089.589999999999,1,5,5,11,Loyal
18748,15,3,60.47,5,3,2,10,Recent Customer
18749,1,9,204.81,5,5,3,13,Recent Customer
18750,122,1,4.99,4,1,1,6,At Risk
18751,348,2,39.980000000000004,1,2,1,4,At Risk
18752,313,2,119.97999999999999,1,2,3,6,At Risk
18753,204,2,123.97999999999999,3,2,3,8,Potential
18754,324,1,69.99,1,1,2,4,At Risk
18755,308,3,86.96000000000001,1,3,2,6,At Risk
18756,153,5,128.41,3,5,3,11,Loyal
18757,355,2,78.97999999999999,1,2,2,5,At Risk
18758,248,9,158.51,2,5,3,10,Loyal
18759,1,8,302.03,5,5,3,13,Recent Customer
18760,336,2,54.980000000000004,1,2,2,5,At Risk
18761,159,2,13.98,3,2,1,6,At Risk
18762,73,4,1764.96,5,4,4,13,Champions
18763,83,4,123.96000000000001,4,4,3,11,Loyal
18764,193,1,69.99,3,1,2,6,At Risk
18765,119,2,119.97999999999999,4,2,3,9,Potential
18766,43,3,4752.75,5,3,5,13,Champions
18767,284,3,5314.25,2,3,5,10,Loyal
18768,276,3,5314.25,2,3,5,10,Loyal
18769,302,3,5304.25,1,3,5,9,Potential
18770,160,2,94.47999999999999,3,2,3,8,Potential
18771,99,1,69.99,4,1,2,7,Potential
18772,222,2,78.97999999999999,2,2,2,6,At Risk
18773,255,2,78.97999999999999,2,2,2,6,At Risk
18774,3,3,132.97,5,3,3,11,Recent Customer
18775,361,1,69.99,1,1,2,4,At Risk
18776,243,3,67.97,2,3,2,7,Potential
18777,321,2,29.479999999999997,1,2,1,4,At Risk
18778,129,2,39.980000000000004,4,2,1,7,Potential
18779,87,1,4.99,4,1,1,6,At Risk
18780,86,3,1759.97,4,3,4,11,Loyal
18781,34,4,2362.2699999999995,5,4,4,13,Champions
18782,42,5,2397.9099999999994,5,5,4,14,Champions
18783,34,4,2362.2699999999995,5,4,4,13,Champions
18784,106,3,128.97,4,3,3,10,Loyal
18785,62,3,2350.9599999999996,5,3,4,12,Loyal
18786,301,2,119.97999999999999,1,2,3,6,At Risk
18787,134,2,78.97999999999999,3,2,2,7,Potential
18788,69,3,2351.9599999999996,5,3,4,12,Loyal
18789,39,1,2294.99,5,1,4,10,Loyal
18790,72,3,1728.27,5,3,4,12,Loyal
18791,39,1,69.99,5,1,2,8,Potential
18792,66,3,1775.47,5,3,4,12,Loyal
18793,66,2,30.479999999999997,5,2,1,8,Potential
18794,88,2,1735.98,4,2,4,10,Loyal
18795,266,3,1198.97,2,3,4,9,Potential
18796,112,2,23.779999999999998,4,2,1,7,Potential
18797,8,2,78.97999999999999,5,2,2,9,Recent Customer
18798,90,3,1728.27,4,3,4,11,Loyal
18799,300,2,119.97999999999999,1,2,3,6,At Risk
18800,84,2,1754.98,4,2,4,10,Loyal
18801,91,3,1799.48,4,3,4,11,Loyal
18802,64,4,1793.47,5,4,4,13,Champions
18803,54,2,1750.98,5,2,4,11,Loyal
18804,44,4,1810.46,5,4,4,13,Champions
18805,2,2,133.49,5,2,3,10,Recent Customer
18806,60,3,1785.97,5,3,4,12,Loyal
18807,308,2,119.97999999999999,1,2,3,6,At Risk
18808,43,5,2411.9399999999996,5,5,4,14,Champions
18809,303,2,119.97999999999999,1,2,3,6,At Risk
18810,81,2,133.49,4,2,3,9,Potential
18811,311,3,100.96,1,3,3,7,Potential
18812,29,5,185.94,5,5,3,13,Recent Customer
18813,9,3,128.97,5,3,3,11,Recent Customer
18814,203,1,69.99,3,1,2,6,At Risk
18815,131,1,69.99,4,1,2,7,Potential
18816,335,3,148.46999999999997,1,3,3,7,Potential
18817,36,3,2357.2799999999997,5,3,4,12,Loyal
18818,40,3,2319.2599999999998,5,3,4,12,Loyal
18819,55,4,2344.9599999999996,5,4,4,13,Champions
18820,205,2,78.97999999999999,3,2,2,7,Potential
18821,84,2,91.97,4,2,2,8,Potential
18822,172,2,119.97999999999999,3,2,3,8,Potential
18823,237,2,94.47999999999999,2,2,3,7,Potential
18824,61,4,2394.9699999999993,5,4,4,13,Champions
18825,142,2,78.97999999999999,3,2,2,7,Potential
18826,73,6,166.43,5,5,3,13,Champions
18827,33,2,2329.9799999999996,5,2,4,11,Loyal
18828,136,2,119.97999999999999,3,2,3,8,Potential
18829,57,2,2354.9799999999996,5,2,4,11,Loyal
18830,73,2,119.97999999999999,5,2,3,10,Loyal
18831,34,5,2419.4599999999996,5,5,4,14,Champions
18832,48,3,2334.9799999999996,5,3,4,12,Loyal
18833,51,2,78.97999999999999,5,2,2,9,Potential
18834,32,2,119.97999999999999,5,2,3,10,Loyal
18835,365,2,78.97999999999999,1,2,2,5,At Risk
18836,308,3,128.97,1,3,3,7,Potential
18837,238,2,94.47999999999999,2,2,3,7,Potential
18838,43,3,2376.9599999999996,5,3,4,12,Loyal
18839,80,3,2384.97,4,3,4,11,Loyal
18840,61,1,2294.99,5,1,4,10,Loyal
18841,272,2,1145.48,2,2,3,7,Potential
18842,264,2,1155.48,2,2,3,7,Potential
18843,70,1,69.99,5,1,2,8,Potential
18844,222,2,123.97999999999999,2,2,3,7,Potential
18845,282,1,69.99,2,1,2,5,At Risk
18846,26,3,132.97,5,3,3,11,Recent Customer
18847,163,1,69.99,3,1,2,6,At Risk
18848,47,5,2496.2699999999995,5,5,4,14,Champions
18849,57,3,2366.9599999999996,5,3,4,12,Loyal
18850,55,4,2376.4499999999994,5,4,4,13,Champions
18851,48,1,69.99,5,1,2,8,Potential
18852,144,5,268.25,3,5,3,11,Loyal
18853,278,1,69.99,2,1,2,5,At Risk
18854,41,2,1754.98,5,2,4,11,Loyal
18855,255,2,1155.48,2,2,3,7,Potential
18856,37,2,1735.98,5,2,4,11,Loyal
18857,40,2,1735.98,5,2,4,11,Loyal
18858,41,4,1810.46,5,4,4,13,Champions
18859,225,2,1155.48,2,2,3,7,Potential
18860,54,4,2394.9699999999993,5,4,4,13,Champions
18861,111,2,133.49,4,2,3,9,Potential
18862,56,3,2354.4699999999993,5,3,4,12,Loyal
18863,40,4,2414.97,5,4,4,13,Champions
18864,55,4,2331.9499999999994,5,4,4,13,Champions
18865,48,3,1779.47,5,3,4,12,Loyal
18866,48,1,1700.99,5,1,4,10,Loyal
18867,57,2,1750.98,5,2,4,11,Loyal
18868,61,3,1759.97,5,3,4,12,Loyal
18869,60,2,1735.98,5,2,4,11,Loyal
18870,8,1,69.99,5,1,2,8,Recent Customer
18871,344,3,86.96000000000001,1,3,2,6,At Risk
18872,101,2,78.97999999999999,4,2,2,8,Potential
18873,171,3,128.97,3,3,3,9,Potential
18874,179,1,69.99,3,1,2,6,At Risk
18875,139,4,114.95,3,4,3,10,Loyal
18876,45,2,2329.9799999999996,5,2,4,11,Loyal
18877,266,1,69.99,2,1,2,5,At Risk
18878,59,5,2390.95,5,5,4,14,Champions
18879,85,1,69.99,4,1,2,7,Potential
18880,107,1,69.99,4,1,2,7,Potential
18881,37,3,2359.9799999999996,5,3,4,12,Loyal
18882,64,2,2322.2799999999997,5,2,4,11,Loyal
18883,91,3,86.96000000000001,4,3,2,9,Potential
18884,101,5,133.93,4,5,3,12,Loyal
18885,354,4,110.46000000000001,1,4,3,8,Potential
18886,125,1,69.99,4,1,2,7,Potential
18887,33,2,133.49,5,2,3,10,Loyal
18888,280,2,123.97999999999999,2,2,3,7,Potential
18889,362,2,78.97999999999999,1,2,2,5,At Risk
18890,196,2,78.97999999999999,3,2,2,7,Potential
18891,29,2,119.97999999999999,5,2,3,10,Recent Customer
18892,75,1,69.99,4,1,2,7,Potential
18893,319,1,69.99,1,1,2,4,At Risk
18894,46,2,2316.97,5,2,4,11,Loyal
18895,337,3,27.77,1,3,1,5,At Risk
18896,285,3,74.98,2,3,2,7,Potential
18897,150,2,37.29,3,2,1,6,At Risk
18898,327,3,74.98,1,3,2,6,At Risk
18899,379,2,4118.26,1,2,5,8,Potential
18900,373,4,4132.24,1,4,5,10,Loyal
18901,228,1,35.0,2,1,1,4,At Risk
18902,371,5,4186.23,1,5,5,11,Loyal
18903,383,4,4143.74,1,4,5,10,Loyal
18904,134,4,607.96,3,4,3,10,Loyal
18905,40,6,2416.43,5,5,4,14,Champions
18906,396,6,4217.22,1,5,5,11,Loyal
18907,379,5,4167.23,1,5,5,11,Loyal
18908,324,5,6090.59,1,5,5,11,Loyal
18909,306,4,6035.599999999999,1,4,5,10,Loyal
18910,79,2,59.980000000000004,4,2,2,8,Potential
18911,68,3,64.47,5,3,2,10,Loyal
18912,236,1,69.99,2,1,2,5,At Risk
18913,116,2,78.97999999999999,4,2,2,8,Potential
18914,48,2,1725.98,5,2,4,11,Loyal
18915,180,2,94.47999999999999,3,2,3,8,Potential
18916,147,5,658.95,3,5,3,11,Loyal
18917,131,4,607.96,4,4,3,11,Loyal
18918,164,2,78.97999999999999,3,2,2,7,Potential
18919,317,6,300.94,1,5,3,9,Potential
18920,11,3,128.97,5,3,3,11,Recent Customer
18921,184,2,94.47999999999999,3,2,3,8,Potential
18922,62,3,2326.9599999999996,5,3,4,12,Loyal
18923,308,2,804.48,1,2,3,6,At Risk
18924,238,2,839.48,2,2,3,7,Potential
18925,131,7,82.17999999999999,4,5,2,11,Loyal
18926,3,7,244.23000000000002,5,5,3,13,Recent Customer
18927,165,4,89.25,3,4,2,9,Potential
18928,280,6,6095.08,2,5,5,12,Loyal
18929,289,3,6029.57,1,3,5,9,Potential
18930,282,4,6035.599999999999,2,4,5,11,Loyal
18931,288,5,6060.5,2,5,5,12,Loyal
18932,259,3,59.260000000000005,2,3,2,7,Potential
18933,173,2,59.980000000000004,3,2,2,7,Potential
18934,133,2,123.97999999999999,4,2,3,9,Potential
18935,362,1,69.99,1,1,2,4,At Risk
18936,240,2,839.48,2,2,3,7,Potential
18937,59,1,69.99,5,1,2,8,Potential
18938,103,1,69.99,4,1,2,7,Potential
18939,7,1,69.99,5,1,2,8,Recent Customer
18940,83,2,78.97999999999999,4,2,2,8,Potential
18941,35,2,123.97999999999999,5,2,3,10,Loyal
18942,198,6,889.39,3,5,3,11,Loyal
18943,155,3,902.98,3,3,3,9,Potential
18944,41,5,146.94,5,5,3,13,Champions
18945,32,2,78.97999999999999,5,2,2,9,Potential
18946,170,1,69.99,3,1,2,6,At Risk
18947,182,2,804.48,3,2,3,8,Potential
18948,162,4,806.76,3,4,3,10,Loyal
18949,163,3,801.77,3,3,3,9,Potential
18950,84,3,2351.9599999999996,4,3,4,11,Loyal
18951,63,3,2334.9699999999993,5,3,4,12,Loyal
18952,16,2,78.97999999999999,5,2,2,9,Recent Customer
18953,136,2,777.44,3,2,3,8,Potential
18954,69,3,893.47,5,3,3,11,Loyal
18955,61,2,1754.98,5,2,4,11,Loyal
18956,39,3,848.47,5,3,3,11,Loyal
18957,370,3,589.26,1,3,3,7,Potential
18958,389,5,565.21,1,5,3,9,Potential
18959,87,3,2341.4599999999996,4,3,4,11,Loyal
18960,363,2,618.98,1,2,3,6,At Risk
18961,74,4,2369.9599999999996,4,4,4,12,Loyal
18962,360,3,567.27,1,3,3,7,Potential
18963,344,2,589.98,1,2,3,6,At Risk
18964,284,1,69.99,2,1,2,5,At Risk
18965,10,2,123.97999999999999,5,2,3,10,Recent Customer
18966,327,2,78.97999999999999,1,2,2,5,At Risk
18967,354,3,132.97,1,3,3,7,Potential
18968,64,6,151.43,5,5,3,13,Champions
18969,16,1,69.99,5,1,2,8,Recent Customer
18970,73,2,133.49,5,2,3,10,Loyal
18971,73,3,2351.9599999999996,5,3,4,12,Loyal
18972,88,4,2369.9699999999993,4,4,4,12,Loyal
18973,341,3,567.27,1,3,3,7,Potential
18974,338,5,585.94,1,5,3,9,Potential
18975,237,3,89.97,2,3,2,7,Potential
18976,60,2,1750.98,5,2,4,11,Loyal
18977,54,3,128.97,5,3,3,11,Loyal
18978,139,6,118.72999999999999,3,5,3,11,Loyal
18979,51,4,1749.96,5,4,4,13,Champions
18980,54,2,1750.98,5,2,4,11,Loyal
18981,176,2,78.97999999999999,3,2,2,7,Potential
18982,58,4,1783.96,5,4,4,13,Champions
18983,226,2,94.47999999999999,2,2,3,7,Potential
18984,312,2,94.47999999999999,1,2,3,6,At Risk
18985,68,2,94.47999999999999,5,2,3,10,Loyal
18986,353,2,56.97,1,2,2,5,At Risk
18987,364,2,119.97999999999999,1,2,3,6,At Risk
18988,89,1,69.99,4,1,2,7,Potential
18989,152,2,133.49,3,2,3,8,Potential
18990,350,2,561.97,1,2,3,6,At Risk
18991,59,1,69.99,5,1,2,8,Potential
18992,230,2,119.97999999999999,2,2,3,7,Potential
18993,52,3,128.97,5,3,3,11,Loyal
18994,84,2,123.97999999999999,4,2,3,9,Potential
18995,97,2,119.97999999999999,4,2,3,9,Potential
18996,33,1,69.99,5,1,2,8,Potential
18997,151,1,69.99,3,1,2,6,At Risk
18998,54,4,1784.96,5,4,4,13,Champions
18999,48,2,1754.98,5,2,4,11,Loyal
19000,13,3,54.26,5,3,2,10,Recent Customer
19001,178,4,91.95,3,4,2,9,Potential
19002,50,3,1729.97,5,3,4,12,Loyal
19003,38,4,1764.96,5,4,4,13,Champions
19004,33,4,1764.96,5,4,4,13,Champions
19005,341,2,94.47999999999999,1,2,3,6,At Risk
19006,41,1,69.99,5,1,2,8,Potential
19007,147,1,69.99,3,1,2,6,At Risk
19008,56,3,1760.47,5,3,4,12,Loyal
19009,17,2,78.97999999999999,5,2,2,9,Recent Customer
19010,347,2,78.97999999999999,1,2,2,5,At Risk
19011,200,2,78.97999999999999,3,2,2,7,Potential
19012,171,2,119.97999999999999,3,2,3,8,Potential
19013,310,4,636.45,1,4,3,8,Potential
19014,195,4,65.95,3,4,2,9,Potential
19015,264,6,125.43,2,5,3,10,Loyal
19016,46,2,1750.98,5,2,4,11,Loyal
19017,85,1,69.99,4,1,2,7,Potential
19018,209,2,133.49,2,2,3,7,Potential
19019,285,2,78.97999999999999,2,2,2,6,At Risk
19020,154,2,123.97999999999999,3,2,3,8,Potential
19021,317,4,614.96,1,4,3,8,Potential
19022,120,1,69.99,4,1,2,7,Potential
19023,327,3,579.97,1,3,3,7,Potential
19024,310,4,699.97,1,4,3,8,Potential
19025,321,2,119.97999999999999,1,2,3,6,At Risk
19026,70,5,113.24000000000001,5,5,3,13,Champions
19027,119,3,3029.0781999999995,4,3,4,11,Loyal
19028,108,5,3063.0581999999995,4,5,4,13,Champions
19029,141,4,3339.4074999999993,3,4,5,12,Loyal
19030,131,4,3310.4074999999993,4,4,5,13,Champions
19031,49,6,7226.379999999999,5,5,5,15,Champions
19032,47,7,6938.5824999999995,5,5,5,15,Champions
19033,96,5,3139.0681999999997,4,5,4,13,Champions
19034,130,3,3322.7174999999997,4,3,5,12,Loyal
19035,100,2,3320.4275,4,2,5,11,Loyal
19036,111,2,4763.34,4,2,5,11,Loyal
19037,117,3,4858.34,4,3,5,12,Loyal
19038,119,5,3318.3574999999996,4,5,5,14,Champions
19039,197,2,7.28,3,2,1,6,At Risk
19040,121,4,3310.4074999999993,4,4,5,13,Champions
19041,111,4,3089.0782,4,4,4,12,Loyal
19042,160,3,64.97,3,3,2,8,Potential
19043,9,1,24.99,5,1,1,7,Recent Customer
19044,80,2,29.93,4,2,1,7,Potential
19045,247,3,48.97,2,3,2,7,Potential
19046,104,2,3320.4275,4,2,5,11,Loyal
19047,299,4,71.95,1,4,2,7,Potential
19048,72,3,4765.629999999999,5,3,5,13,Champions
19049,89,6,4838.299999999999,4,5,5,14,Champions
19050,116,2,56.97,4,2,2,8,Potential
19051,100,4,3104.5681999999997,4,4,4,12,Loyal
19052,94,4,3140.2699999999995,4,4,4,12,Loyal
19053,47,1,24.99,5,1,1,7,Potential
19054,51,1,21.98,5,1,1,7,Potential
19055,50,4,45.95,5,4,2,11,Loyal
19056,345,3,37.93,1,3,1,5,At Risk
19057,115,3,3322.7174999999997,4,3,5,12,Loyal
19058,72,5,4524.4825,5,5,5,15,Champions
19059,15,2,85.48,5,2,2,9,Recent Customer
19060,322,2,29.93,1,2,1,4,At Risk
19061,173,3,64.97,3,3,2,8,Potential
19062,187,5,79.95,3,5,2,10,Loyal
19063,11,3,64.97,5,3,2,10,Recent Customer
19064,310,3,32.269999999999996,1,3,1,5,At Risk
19065,119,2,3295.4275,4,2,5,11,Loyal
19066,120,3,84.96000000000001,4,3,2,9,Potential
19067,117,4,3380.9075,4,4,5,13,Champions
19068,177,3,64.97,3,3,2,8,Potential
19069,107,3,3112.97,4,3,4,11,Loyal
19070,74,3,4748.33,4,3,5,12,Loyal
19071,271,4,115.95,2,4,3,9,Potential
19072,1,3,48.97,5,3,2,10,Recent Customer
19073,63,3,4760.32,5,3,5,13,Champions
19074,128,2,29.979999999999997,4,2,1,7,Potential
19075,277,3,64.97,2,3,2,7,Potential
19076,108,5,3177.9599999999996,4,5,4,13,Champions
19077,229,2,39.980000000000004,2,2,1,5,At Risk
19078,313,3,32.269999999999996,1,3,1,5,At Risk
19079,173,1,24.99,3,1,1,5,At Risk
19080,356,2,29.979999999999997,1,2,1,4,At Risk
19081,84,3,32.269999999999996,4,3,1,8,Potential
19082,209,2,39.980000000000004,2,2,1,5,At Risk
19083,293,2,6021.62,1,2,5,8,Potential
19084,298,5,6093.2,1,5,5,11,Loyal
19085,172,3,78.26,3,3,2,8,Potential
19086,6,3,78.26,5,3,2,10,Recent Customer
19087,357,5,47.2,1,5,2,8,Potential
19088,85,2,24.27,4,2,1,7,Potential
19089,281,5,6093.2,2,5,5,12,Loyal
19090,76,3,59.260000000000005,4,3,2,9,Potential
19091,28,2,24.27,5,2,1,8,Recent Customer
19092,74,3,78.26,4,3,2,9,Potential
19093,304,4,6035.599999999999,1,4,5,10,Loyal
19094,301,2,6021.62,1,2,5,8,Potential
19095,295,3,6056.61,1,3,5,9,Potential
19096,279,5,6090.59,2,5,5,12,Loyal
19097,130,2,24.27,4,2,1,7,Potential
19098,48,5,122.24000000000001,5,5,3,13,Champions
19099,286,4,6038.5599999999995,2,4,5,11,Loyal
19100,34,3,79.26,5,3,2,10,Loyal
19101,110,7,104.42,4,5,3,12,Loyal
19102,276,3,6029.57,2,3,5,10,Loyal
19103,155,4,63.91,3,4,2,9,Potential
19104,9,5,99.94,5,5,3,13,Recent Customer
19105,278,3,6056.61,2,3,5,10,Loyal
19106,262,4,64.95,2,4,2,8,Potential
19107,264,1,69.99,2,1,2,5,At Risk
19108,52,1,1700.99,5,1,4,10,Loyal
19109,45,3,1728.27,5,3,4,12,Loyal
19110,333,4,604.96,1,4,3,8,Potential
19111,298,5,609.95,1,5,3,9,Potential
19112,33,4,1764.96,5,4,4,13,Champions
19113,221,4,1184.46,2,4,4,10,Loyal
19114,36,2,1735.98,5,2,4,11,Loyal
19115,84,3,148.46999999999997,4,3,3,10,Loyal
19116,241,3,1183.47,2,3,4,9,Potential
19117,42,2,1750.98,5,2,4,11,Loyal
19118,238,1,1120.49,2,1,3,6,At Risk
19119,46,4,1764.96,5,4,4,13,Champions
19120,48,3,1729.97,5,3,4,12,Loyal
19121,301,5,656.94,1,5,3,9,Potential
19122,301,4,588.96,1,4,3,8,Potential
19123,214,2,1170.48,2,2,4,8,Potential
19124,36,2,1754.98,5,2,4,11,Loyal
19125,59,2,1735.98,5,2,4,11,Loyal
19126,125,1,69.99,4,1,2,7,Potential
19127,287,3,579.97,2,3,3,8,Potential
19128,291,5,642.9100000000001,1,5,3,9,Potential
19129,301,5,639.45,1,5,3,9,Potential
19130,270,5,664.95,2,5,3,10,Loyal
19131,48,2,1725.48,5,2,4,11,Loyal
19132,40,1,69.99,5,1,2,8,Potential
19133,49,1,1700.99,5,1,4,10,Loyal
19134,158,1,69.99,3,1,2,6,At Risk
19135,298,1,69.99,1,1,2,4,At Risk
19136,271,2,78.97999999999999,2,2,2,6,At Risk
19137,48,2,1735.98,5,2,4,11,Loyal
19138,60,1,69.99,5,1,2,8,Potential
19139,253,1,69.99,2,1,2,5,At Risk
19140,264,2,564.98,2,2,3,7,Potential
19141,272,3,579.97,2,3,3,8,Potential
19142,257,2,618.98,2,2,3,7,Potential
19143,253,5,605.2099999999999,2,5,3,10,Loyal
19144,253,4,614.96,2,4,3,9,Potential
19145,131,2,133.49,4,2,3,9,Potential
19146,35,4,1764.96,5,4,4,13,Champions
19147,120,8,133.71,4,5,3,12,Loyal
19148,46,2,1750.98,5,2,4,11,Loyal
19149,205,2,123.97999999999999,3,2,3,8,Potential
19150,22,4,65.95,5,4,2,11,Recent Customer
19151,123,1,69.99,4,1,2,7,Potential
19152,297,2,78.97999999999999,1,2,2,5,At Risk
19153,241,1,69.99,2,1,2,5,At Risk
19154,39,1,69.99,5,1,2,8,Potential
19155,269,2,78.97999999999999,2,2,2,6,At Risk
19156,52,3,1728.27,5,3,4,12,Loyal
19157,34,1,1700.99,5,1,4,10,Loyal
19158,48,2,1735.98,5,2,4,11,Loyal
19159,381,1,1120.49,1,1,3,5,At Risk
19160,375,3,1183.47,1,3,4,8,Potential
19161,273,5,584.9,2,5,3,10,Loyal
19162,274,4,563.96,2,4,3,9,Potential
19163,250,1,539.99,2,1,3,6,At Risk
19164,257,4,629.96,2,4,3,9,Potential
19165,245,4,633.96,2,4,3,9,Potential
19166,138,1,69.99,3,1,2,6,At Risk
19167,393,1,1120.49,1,1,3,5,At Risk
19168,360,2,119.97999999999999,1,2,3,6,At Risk
19169,369,2,1170.48,1,2,4,7,Potential
19170,378,4,1151.76,1,4,3,8,Potential
19171,383,2,1174.48,1,2,4,7,Potential
19172,237,4,1609.4075,2,4,4,10,Loyal
19173,192,3,1594.4175,3,3,4,10,Loyal
19174,69,2,2483.98,5,2,4,11,Loyal
19175,196,1,24.99,3,1,1,5,At Risk
19176,63,3,63.97,5,3,2,10,Loyal
19177,343,2,38.980000000000004,1,2,1,4,At Risk
19178,284,1,24.99,2,1,1,4,At Risk
19179,84,2,12.940000000000001,4,2,1,7,Potential
19180,116,2,39.980000000000004,4,2,1,7,Potential
19181,73,3,2518.97,5,3,4,12,Loyal
19182,314,2,39.980000000000004,1,2,1,4,At Risk
19183,144,3,48.970000000000006,3,3,2,8,Potential
19184,296,1,24.99,1,1,1,3,At Risk
19185,348,2,58.980000000000004,1,2,2,5,At Risk
19186,93,3,1562.4075,4,3,4,11,Loyal
19187,106,3,147.28,4,3,3,10,Loyal
19188,70,5,2732.6975,5,5,4,14,Champions
19189,249,2,29.479999999999997,2,2,1,5,At Risk
19190,144,2,27.279999999999998,3,2,1,6,At Risk
19191,235,2,74.98,2,2,2,6,At Risk
19192,130,4,1682.4075,4,4,4,12,Loyal
19193,108,5,1609.3975,4,5,4,13,Champions
19194,229,5,1589.75,2,5,4,11,Loyal
19195,95,6,1637.3775,4,5,4,13,Champions
19196,81,7,4657.737499999999,4,5,5,14,Champions
19197,75,7,4609.737499999999,4,5,5,14,Champions
19198,378,2,1155.48,1,2,3,6,At Risk
19199,370,3,1134.47,1,3,3,7,Potential
19200,31,5,109.24000000000001,5,5,3,13,Champions
19201,367,1,1120.49,1,1,3,5,At Risk
19202,379,2,1170.48,1,2,4,7,Potential
19203,133,1,539.99,4,1,3,8,Potential
19204,106,1,539.99,4,1,3,8,Potential
19205,46,2,1249.84,5,2,4,11,Loyal
19206,112,3,553.97,4,3,3,10,Loyal
19207,257,4,791.32,2,4,3,9,Potential
19208,204,4,98.96000000000001,3,4,3,10,Loyal
19209,97,2,574.98,4,2,3,9,Potential
19210,43,1,4.99,5,1,1,7,Potential
19211,370,1,1120.49,1,1,3,5,At Risk
19212,382,2,1174.48,1,2,4,7,Potential
19213,375,2,1155.48,1,2,3,6,At Risk
19214,327,1,4.99,1,1,1,3,At Risk
19215,95,3,123.48,4,3,3,10,Loyal
19216,275,2,54.980000000000004,2,2,2,6,At Risk
19217,62,8,185.02,5,5,3,13,Champions
19218,324,3,132.97,1,3,3,7,Potential
19219,282,2,78.97999999999999,2,2,2,6,At Risk
19220,16,8,97.62,5,5,3,13,Recent Customer
19221,72,2,59.980000000000004,5,2,2,9,Potential
19222,48,2,54.980000000000004,5,2,2,9,Potential
19223,29,6,84.64,5,5,2,12,Recent Customer
19224,89,9,352.52,4,5,3,12,Loyal
19225,394,3,1218.98,1,3,4,8,Potential
19226,6,2,119.97999999999999,5,2,3,10,Recent Customer
19227,322,1,69.99,1,1,2,4,At Risk
19228,131,2,123.97999999999999,4,2,3,9,Potential
19229,94,2,123.97999999999999,4,2,3,9,Potential
19230,39,2,78.97999999999999,5,2,2,9,Potential
19231,215,1,69.99,2,1,2,5,At Risk
19232,90,3,60.96,4,3,2,9,Potential
19233,295,1,69.99,1,1,2,4,At Risk
19234,49,2,119.97999999999999,5,2,3,10,Loyal
19235,107,2,119.97999999999999,4,2,3,9,Potential
19236,41,2,119.97999999999999,5,2,3,10,Loyal
19237,59,1,69.99,5,1,2,8,Potential
19238,261,1,69.99,2,1,2,5,At Risk
19239,40,2,78.97999999999999,5,2,2,9,Potential
19240,373,2,1155.48,1,2,3,6,At Risk
19241,348,3,148.46999999999997,1,3,3,7,Potential
19242,276,1,69.99,2,1,2,5,At Risk
19243,239,1,69.99,2,1,2,5,At Risk
19244,272,2,133.49,2,2,3,7,Potential
19245,207,2,119.97999999999999,2,2,3,7,Potential
19246,203,1,69.99,3,1,2,6,At Risk
19247,350,1,24.99,1,1,1,3,At Risk
19248,182,3,147.28,3,3,3,9,Potential
19249,153,3,63.97,3,3,2,8,Potential
19250,179,3,31.27,3,3,1,7,Potential
19251,176,2,27.279999999999998,3,2,1,6,At Risk
19252,305,3,94.97,1,3,3,7,Potential
19253,101,2,1540.4275,4,2,4,10,Loyal
19254,66,2,2701.4275,5,2,4,11,Loyal
19255,79,2,2483.98,4,2,4,10,Loyal
19256,74,3,2518.97,4,3,4,11,Loyal
19257,92,5,2739.8975,4,5,4,13,Champions
19258,82,3,1574.4175,4,3,4,11,Loyal
19259,281,2,28.979999999999997,2,2,1,5,At Risk
19260,72,4,1592.7075,5,4,4,13,Champions
19261,140,3,82.97,3,3,2,8,Potential
19262,351,1,24.99,1,1,1,3,At Risk
19263,74,3,1587.4075,4,3,4,11,Loyal
19264,368,4,4132.24,1,4,5,10,Loyal
19265,65,3,42.28,5,3,2,10,Loyal
19266,249,3,42.28,2,3,2,7,Potential
19267,45,3,42.28,5,3,2,10,Loyal
19268,14,2,39.99,5,2,2,9,Recent Customer
19269,370,2,4118.26,1,2,5,8,Potential
19270,386,3,4127.25,1,3,5,9,Potential
19271,374,3,4153.25,1,3,5,9,Potential
19272,214,2,13.98,2,2,1,5,At Risk
19273,184,2,39.980000000000004,3,2,1,6,At Risk
19274,71,2,2701.4275,5,2,4,11,Loyal
19275,309,2,13.98,1,2,1,4,At Risk
19276,34,5,2547.95,5,5,4,14,Champions
19277,353,2,39.980000000000004,1,2,1,4,At Risk
19278,87,3,1575.4175,4,3,4,11,Loyal
19279,147,3,63.97,3,3,2,8,Potential
19280,48,3,2537.97,5,3,4,12,Loyal
19281,151,3,67.97,3,3,2,8,Potential
19282,47,5,2520.91,5,5,4,14,Champions
19283,68,4,2764.4075,5,4,4,13,Champions
19284,92,3,2736.4175,4,3,4,11,Loyal
19285,73,3,2751.4175,5,3,4,12,Loyal
19286,79,3,2755.4175,4,3,4,11,Loyal
19287,35,3,2508.9700000000003,5,3,4,12,Loyal
19288,86,3,2736.4175,4,3,4,11,Loyal
19289,83,5,2765.3975,4,5,4,13,Champions
19290,63,5,1605.3975,5,5,4,14,Champions
19291,325,2,28.979999999999997,1,2,1,4,At Risk
19292,43,3,2518.97,5,3,4,12,Loyal
19293,56,3,2533.9700000000003,5,3,4,12,Loyal
19294,51,6,2820.3875,5,5,4,14,Champions
19295,53,2,2483.98,5,2,4,11,Loyal
19296,37,5,2547.95,5,5,4,14,Champions
19297,36,4,2542.96,5,4,4,13,Champions
19298,83,3,4535.2775,4,3,5,12,Loyal
19299,110,3,1587.4075,4,3,4,11,Loyal
19300,141,3,36.93,3,3,1,7,Potential
19301,44,3,1590.4175,5,3,4,12,Loyal
19302,51,5,1577.3875,5,5,4,14,Champions
19303,18,2,39.980000000000004,5,2,1,8,Recent Customer
19304,15,3,83.97,5,3,2,10,Recent Customer
19305,48,4,1622.3975,5,4,4,13,Champions
19306,200,2,29.479999999999997,3,2,1,6,At Risk
19307,94,3,148.98,4,3,3,10,Loyal
19308,47,3,1549.4175,5,3,4,12,Loyal
19309,44,3,2518.97,5,3,4,12,Loyal
19310,238,4,1611.46,2,4,4,10,Loyal
19311,62,6,4640.2575,5,5,5,15,Champions
19312,85,4,1564.6975,4,4,4,12,Loyal
19313,39,4,2533.46,5,4,4,13,Champions
19314,39,4,2730.4075000000003,5,4,4,13,Champions
19315,58,3,2537.97,5,3,4,12,Loyal
19316,61,2,2701.4275,5,2,4,11,Loyal
19317,288,1,4.99,2,1,1,4,At Risk
19318,48,3,2537.97,5,3,4,12,Loyal
19319,38,4,2562.46,5,4,4,13,Champions
19320,389,4,1981.96,1,4,4,9,Potential
19321,59,3,2736.4175,5,3,4,12,Loyal
19322,51,2,1565.4275,5,2,4,11,Loyal
19323,185,4,1584.76,3,4,4,11,Loyal
19324,202,3,1602.47,3,3,4,10,Loyal
19325,76,5,4245.218199999999,4,5,5,14,Champions
19326,370,2,1903.48,1,2,4,7,Potential
19327,354,1,4.99,1,1,1,3,At Risk
19328,290,2,27.279999999999998,1,2,1,4,At Risk
19329,61,4,2459.0682,5,4,4,13,Champions
19330,150,3,31.27,3,3,1,7,Potential
19331,32,2,28.979999999999997,5,2,1,8,Potential
19332,322,3,82.97,1,3,2,6,At Risk
19333,63,3,35.23,5,3,1,9,Potential
19334,323,3,63.97,1,3,2,6,At Risk
19335,388,3,1957.47,1,3,4,8,Potential
19336,349,3,1957.47,1,3,4,8,Potential
19337,45,3,1575.4175,5,3,4,12,Loyal
19338,166,4,1583.45,3,4,4,11,Loyal
19339,76,6,4315.8982,4,5,5,14,Champions
19340,52,8,4313.888199999999,5,5,5,15,Champions
19341,391,3,3498.7774999999997,1,3,5,9,Potential
19342,268,3,31.27,2,3,1,6,At Risk
19343,338,5,1952.45,1,5,4,10,Loyal
19344,366,3,186.28,1,3,3,7,Potential
19345,304,3,69.97,1,3,2,6,At Risk
19346,361,1,21.49,1,1,1,3,At Risk
19347,18,3,27.77,5,3,1,9,Recent Customer
19348,336,1,21.49,1,1,1,3,At Risk
19349,143,3,69.97,3,3,2,8,Potential
19350,284,2,23.779999999999998,2,2,1,5,At Risk
19351,282,1,4.99,2,1,1,4,At Risk
19352,283,2,13.98,2,2,1,5,At Risk
19353,46,2,2400.0882,5,2,4,11,Loyal
19354,60,3,37.269999999999996,5,3,1,9,Potential
19355,157,1,24.99,3,1,1,5,At Risk
19356,33,4,78.96000000000001,5,4,2,11,Loyal
19357,53,4,2478.5682,5,4,4,13,Champions
19358,141,2,13.98,3,2,1,6,At Risk
19359,387,3,3478.7774999999997,1,3,5,9,Potential
19360,393,5,3511.7574999999997,1,5,5,11,Loyal
19361,369,3,3478.7774999999997,1,3,5,9,Potential
19362,375,2,3443.7875,1,2,5,8,Potential
19363,258,1,4.99,2,1,1,4,At Risk
19364,59,6,4312.9082,5,5,5,15,Champions
19365,39,8,4321.888199999999,5,5,5,15,Champions
19366,138,4,1617.46,3,4,4,11,Loyal
19367,38,2,58.980000000000004,5,2,2,9,Potential
19368,76,2,32.28,4,2,1,7,Potential
19369,304,3,63.97,1,3,2,6,At Risk
19370,159,1,4.99,3,1,1,5,At Risk
19371,90,2,32.28,4,2,1,7,Potential
19372,157,2,29.479999999999997,3,2,1,6,At Risk
19373,208,3,89.97,2,3,2,7,Potential
19374,114,2,29.479999999999997,4,2,1,7,Potential
19375,288,4,120.46,2,4,3,9,Potential
19376,68,2,29.479999999999997,5,2,1,8,Potential
19377,9,7,115.92,5,5,3,13,Recent Customer
19378,37,1,24.99,5,1,1,7,Potential
19379,104,4,103.46,4,4,3,11,Loyal
19380,346,5,1934.75,1,5,4,10,Loyal
19381,349,3,1953.47,1,3,4,8,Potential
19382,374,2,3443.7875,1,2,5,8,Potential
19383,329,4,119.96000000000001,1,4,3,8,Potential
19384,39,2,32.28,5,2,1,8,Potential
19385,59,4,116.95,5,4,3,12,Loyal
19386,325,3,1938.47,1,3,4,8,Potential
19387,41,5,2464.0582,5,5,4,14,Champions
19388,287,4,45.22,2,4,2,8,Potential
19389,253,5,138.45,2,5,3,10,Loyal
19390,180,1,4.99,3,1,1,5,At Risk
19391,127,3,42.93,4,3,2,9,Potential
19392,347,2,27.279999999999998,1,2,1,4,At Risk
19393,387,3,1134.47,1,3,3,7,Potential
19394,231,2,1155.48,2,2,3,7,Potential
19395,339,2,1155.48,1,2,3,6,At Risk
19396,336,4,1169.46,1,4,4,9,Potential
19397,144,2,78.97999999999999,3,2,2,7,Potential
19398,81,1,69.99,4,1,2,7,Potential
19399,232,6,151.43,2,5,3,10,Loyal
19400,227,3,1179.47,2,3,4,9,Potential
19401,341,2,1170.48,1,2,4,7,Potential
19402,353,4,1254.47,1,4,4,9,Potential
19403,364,2,1155.48,1,2,3,6,At Risk
19404,35,1,4.99,5,1,1,7,Potential
19405,354,2,1170.48,1,2,4,7,Potential
19406,337,4,1188.46,1,4,4,9,Potential
19407,341,2,1155.48,1,2,3,6,At Risk
19408,343,2,1129.48,1,2,3,6,At Risk
19409,355,3,1183.47,1,3,4,8,Potential
19410,338,1,1120.49,1,1,3,5,At Risk
19411,21,3,69.97,5,3,2,10,Recent Customer
19412,255,4,618.47,2,4,3,9,Potential
19413,366,2,1145.48,1,2,3,6,At Risk
19414,242,2,1145.48,2,2,3,7,Potential
19415,36,3,2435.0782,5,3,4,12,Loyal
19416,384,3,3476.3875,1,3,5,9,Potential
19417,390,3,1854.5782,1,3,4,8,Potential
19418,391,3,3476.3875,1,3,5,9,Potential
19419,115,3,1602.47,4,3,4,11,Loyal
19420,54,8,4314.878199999999,5,5,5,15,Champions
19421,324,4,1930.76,1,4,4,9,Potential
19422,370,2,1819.5882000000001,1,2,4,7,Potential
19423,323,3,1938.47,1,3,4,8,Potential
19424,374,5,3511.7574999999997,1,5,5,11,Loyal
19425,235,3,31.27,2,3,1,6,At Risk
19426,294,3,1938.47,1,3,4,8,Potential
19427,230,5,1967.45,2,5,4,11,Loyal
19428,385,4,1878.5682000000002,1,4,4,9,Potential
19429,338,3,1854.5782,1,3,4,8,Potential
19430,68,3,63.97,5,3,2,10,Loyal
19431,129,1,4.99,4,1,1,6,At Risk
19432,348,3,1869.5782,1,3,4,8,Potential
19433,378,3,3478.7774999999997,1,3,5,9,Potential
19434,218,5,1934.75,2,5,4,11,Loyal
19435,367,4,3457.7674999999995,1,4,5,10,Loyal
19436,240,6,1942.7,2,5,4,11,Loyal
19437,384,4,3480.3775,1,4,5,10,Loyal
19438,58,7,4337.8982,5,5,5,15,Champions
19439,58,7,4349.888199999999,5,5,5,15,Champions
19440,342,5,3492.7574999999997,1,5,5,11,Loyal
19441,90,4,1567.46,4,4,4,12,Loyal
19442,64,3,1602.47,5,3,4,12,Loyal
19443,357,4,1863.5682,1,4,4,9,Potential
19444,109,2,58.980000000000004,4,2,2,8,Potential
19445,94,3,63.97,4,3,2,9,Potential
19446,48,3,1560.43,5,3,4,12,Loyal
19447,58,4,1587.46,5,4,4,13,Champions
19448,348,5,3543.8775,1,5,5,11,Loyal
19449,216,4,45.22,2,4,2,8,Potential
19450,342,5,1887.5582,1,5,4,10,Loyal
19451,351,3,1869.5782,1,3,4,8,Potential
19452,40,4,1611.46,5,4,4,13,Champions
19453,46,7,4267.8982,5,5,5,15,Champions
19454,34,6,4363.8982,5,5,5,15,Champions
19455,354,3,3478.7774999999997,1,3,5,9,Potential
19456,40,3,37.269999999999996,5,3,1,9,Potential
19457,47,3,92.48,5,3,3,11,Loyal
19458,230,3,1957.47,2,3,4,9,Potential
19459,349,3,3478.7774999999997,1,3,5,9,Potential
19460,327,2,29.479999999999997,1,2,1,4,At Risk
19461,143,1,24.99,3,1,1,5,At Risk
19462,325,2,29.479999999999997,1,2,1,4,At Risk
19463,326,1,4.99,1,1,1,3,At Risk
19464,104,2,58.980000000000004,4,2,2,8,Potential
19465,255,1,4.99,2,1,1,4,At Risk
19466,254,3,63.97,2,3,2,7,Potential
19467,330,4,3485.3775,1,4,5,10,Loyal
19468,67,2,6.28,5,2,1,8,Potential
19469,21,2,38.980000000000004,5,2,1,8,Recent Customer
19470,150,2,74.98,3,2,2,7,Potential
19471,323,3,3478.7774999999997,1,3,5,9,Potential
19472,324,3,1854.5782,1,3,4,8,Potential
19473,242,4,1917.46,2,4,4,10,Loyal
19474,53,5,1589.75,5,5,4,14,Champions
19475,377,6,1394.93,1,5,4,10,Loyal
19476,51,7,4346.4182,5,5,5,15,Champions
19477,364,4,3533.7674999999995,1,4,5,10,Loyal
19478,120,2,23.779999999999998,4,2,1,7,Potential
19479,333,2,3443.7875,1,2,5,8,Potential
19480,222,5,1934.75,2,5,4,11,Loyal
19481,147,1,3.99,3,1,1,5,At Risk
19482,320,3,1854.5782,1,3,4,8,Potential
19483,156,2,33.98,3,2,1,6,At Risk
19484,73,2,38.980000000000004,5,2,1,8,Potential
19485,51,2,6.28,5,2,1,8,Potential
19486,13,4,118.96000000000001,5,4,3,12,Recent Customer
19487,147,2,6.28,3,2,1,6,At Risk
19488,104,3,47.97,4,3,2,9,Potential
19489,153,2,38.980000000000004,3,2,1,6,At Risk
19490,300,3,62.97,1,3,2,6,At Risk
19491,10,2,6.28,5,2,1,8,Recent Customer
19492,179,2,6.28,3,2,1,6,At Risk
19493,359,5,3515.3675,1,5,5,11,Loyal
19494,107,2,6.28,4,2,1,7,Potential
19495,221,2,38.980000000000004,2,2,1,5,At Risk
19496,314,3,1854.5782,1,3,4,8,Potential
19497,165,2,28.979999999999997,3,2,1,6,At Risk
19498,215,3,31.27,2,3,1,6,At Risk
19499,360,5,3492.7574999999997,1,5,5,11,Loyal
19500,312,3,3478.7774999999997,1,3,5,9,Potential
19501,309,2,1819.5882000000001,1,2,4,7,Potential
19502,327,6,3565.3574999999996,1,5,5,11,Loyal
19503,334,5,1391.95,1,5,4,10,Loyal
19504,279,3,1382.97,2,3,4,9,Potential
19505,226,3,53.47,2,3,2,7,Potential
19506,248,4,3480.3775,2,4,5,11,Loyal
19507,201,2,6.28,3,2,1,6,At Risk
19508,144,2,6.28,3,2,1,6,At Risk
19509,88,3,43.97,4,3,2,9,Potential
19510,263,3,3451.7374999999997,2,3,5,10,Loyal
19511,260,6,3524.3574999999996,2,5,5,12,Loyal
19512,294,4,86.26,1,4,2,7,Potential
19513,165,1,24.99,3,1,1,5,At Risk
19514,190,4,78.96000000000001,3,4,2,9,Potential
19515,307,2,6.28,1,2,1,4,At Risk
19516,311,1,3.99,1,1,1,3,At Risk
19517,230,3,1938.47,2,3,4,9,Potential
19518,278,4,1894.0682000000002,2,4,4,10,Loyal
19519,241,2,38.980000000000004,2,2,1,5,At Risk
19520,322,3,87.97,1,3,2,6,At Risk
19521,349,2,53.980000000000004,1,2,2,5,At Risk
19522,258,3,63.97,2,3,2,7,Potential
19523,257,3,31.27,2,3,1,6,At Risk
19524,218,4,23.22,2,4,1,7,Potential
19525,26,5,80.21000000000001,5,5,2,12,Recent Customer
19526,240,3,1179.47,2,3,4,9,Potential
19527,215,5,1219.45,2,5,4,11,Loyal
19528,173,2,78.97999999999999,3,2,2,7,Potential
19529,353,4,1169.46,1,4,4,9,Potential
19530,338,1,1120.49,1,1,3,5,At Risk
19531,355,3,1179.97,1,3,4,8,Potential
19532,363,3,1205.47,1,3,4,8,Potential
19533,346,2,1155.48,1,2,3,6,At Risk
19534,356,3,1179.47,1,3,4,8,Potential
19535,348,2,1170.48,1,2,4,7,Potential
19536,225,1,1120.49,2,1,3,6,At Risk
19537,315,2,1155.48,1,2,3,6,At Risk
19538,327,2,1155.48,1,2,3,6,At Risk
19539,323,1,1120.49,1,1,3,5,At Risk
19540,89,1,69.99,4,1,2,7,Potential
19541,79,6,131.24,4,5,3,12,Loyal
19542,233,3,579.97,2,3,3,8,Potential
19543,273,2,133.49,2,2,3,7,Potential
19544,349,3,132.97,1,3,3,7,Potential
19545,326,3,1179.47,1,3,4,8,Potential
19546,229,2,1174.48,2,2,4,8,Potential
19547,316,3,1179.97,1,3,4,8,Potential
19548,323,3,1183.47,1,3,4,8,Potential
19549,317,3,1183.47,1,3,4,8,Potential
19550,325,4,1269.47,1,4,4,9,Potential
19551,124,1,69.99,4,1,2,7,Potential
19552,323,1,69.99,1,1,2,4,At Risk
19553,229,2,31.97,2,2,1,5,At Risk
19554,127,4,86.95,4,4,2,10,Loyal
19555,288,4,6110.599999999999,2,4,5,11,Loyal
19556,290,4,6035.599999999999,1,4,5,10,Loyal
19557,289,4,5358.24,1,4,5,10,Loyal
19558,285,3,6029.57,2,3,5,10,Loyal
19559,298,3,6056.61,1,3,5,9,Potential
19560,289,6,6117.69,1,5,5,11,Loyal
19561,294,2,6021.62,1,2,5,8,Potential
19562,256,3,5314.25,2,3,5,10,Loyal
19563,274,3,5333.25,2,3,5,10,Loyal
19564,248,4,5293.24,2,4,5,11,Loyal
19565,246,4,5308.24,2,4,5,11,Loyal
19566,227,8,164.91000000000003,2,5,3,10,Loyal
19567,251,3,104.96000000000001,2,3,3,8,Potential
19568,278,5,6060.5,2,5,5,12,Loyal
19569,72,5,112.24,5,5,3,13,Champions
19570,141,5,74.94,3,5,2,10,Loyal
19571,114,4,90.95,4,4,2,10,Loyal
19572,225,5,82.25,2,5,2,9,Potential
19573,11,4,57.76,5,4,2,11,Recent Customer
19574,263,6,96.74,2,5,3,10,Loyal
19575,84,5,60.05,4,5,2,11,Loyal
19576,289,4,6058.21,1,4,5,10,Loyal
19577,278,5,6037.89,2,5,5,12,Loyal
19578,54,4,91.25999999999999,5,4,2,11,Loyal
19579,76,2,83.98,4,2,2,8,Potential
19580,54,6,173.93,5,5,3,13,Champions
19581,15,4,109.46,5,4,3,12,Recent Customer
19582,5,5,61.75,5,5,2,12,Recent Customer
19583,15,5,119.45,5,5,3,13,Recent Customer
19584,300,6,116.74,1,5,3,9,Potential
19585,1,4,89.46,5,4,2,11,Recent Customer
19586,302,3,6056.61,1,3,5,9,Potential
19587,25,5,114.95,5,5,3,13,Recent Customer
19588,302,3,6056.61,1,3,5,9,Potential
19589,145,4,95.26,3,4,3,10,Loyal
19590,334,2,32.28,1,2,1,4,At Risk
19591,215,4,63.419999999999995,2,4,2,8,Potential
19592,261,5,5377.23,2,5,5,12,Loyal
19593,246,4,5306.54,2,4,5,11,Loyal
19594,292,2,6021.62,1,2,5,8,Potential
19595,292,6,6095.08,1,5,5,11,Loyal
19596,279,3,6056.61,2,3,5,10,Loyal
19597,30,4,59.46,5,4,2,11,Recent Customer
19598,226,5,5310.53,2,5,5,12,Loyal
19599,224,2,5279.26,2,2,5,9,Potential
19600,284,4,94.46000000000001,2,4,3,9,Potential
19601,231,3,5314.25,2,3,5,10,Loyal
19602,245,5,6093.2,2,5,5,12,Loyal
19603,21,4,59.46,5,4,2,11,Recent Customer
19604,73,7,171.73000000000002,5,5,3,13,Champions
19605,219,3,5314.25,2,3,5,10,Loyal
19606,312,4,83.97,1,4,2,7,Potential
19607,268,3,6054.219999999999,2,3,5,10,Loyal
19608,182,5,68.45,3,5,2,10,Loyal
19609,253,5,6093.2,2,5,5,12,Loyal
19610,166,6,118.94,3,5,3,11,Loyal
19611,246,3,6054.219999999999,2,3,5,10,Loyal
19612,251,3,6029.57,2,3,5,10,Loyal
19613,260,5,6093.2,2,5,5,12,Loyal
19614,265,5,6217.21,2,5,5,12,Loyal
19615,232,2,5279.26,2,2,5,9,Potential
19616,231,2,5279.26,2,2,5,9,Potential
19617,38,5,61.75,5,5,2,12,Loyal
19618,183,5,119.45,3,5,3,11,Loyal
19619,194,5,112.75,3,5,3,11,Loyal
19620,234,2,5279.26,2,2,5,9,Potential
19621,269,2,6021.62,2,2,5,9,Potential
19622,185,5,61.75,3,5,2,10,Loyal
19623,53,7,153.93,5,5,3,13,Champions
19624,13,5,112.75,5,5,3,13,Recent Customer
19625,295,3,52.769999999999996,1,3,2,6,At Risk
19626,191,4,39.46,3,4,1,8,Potential
19627,278,5,41.75,2,5,2,9,Potential
19628,266,4,6035.599999999999,2,4,5,11,Loyal
19629,180,6,109.44,3,5,3,11,Loyal
19630,249,5,74.45,2,5,2,9,Potential
19631,240,2,5279.26,2,2,5,9,Potential
19632,342,2,56.980000000000004,1,2,2,5,At Risk
19633,228,2,59.980000000000004,2,2,2,6,At Risk
19634,132,1,69.99,4,1,2,7,Potential
19635,64,2,94.47999999999999,5,2,3,10,Loyal
19636,149,2,133.49,3,2,3,8,Potential
19637,159,2,78.97999999999999,3,2,2,7,Potential
19638,34,1,4.99,5,1,1,7,Potential
19639,349,3,64.47,1,3,2,6,At Risk
19640,4,9,252.32,5,5,3,13,Recent Customer
19641,291,2,68.49,1,2,2,5,At Risk
19642,65,6,133.54000000000002,5,5,3,13,Champions
19643,346,2,123.97999999999999,1,2,3,6,At Risk
19644,140,1,4.99,3,1,1,5,At Risk
19645,222,6,134.44,2,5,3,10,Loyal
19646,40,7,197.04,5,5,3,13,Champions
19647,44,7,282.04,5,5,3,13,Champions
19648,161,6,100.84,3,5,3,11,Loyal
19649,126,2,78.97999999999999,4,2,2,8,Potential
19650,45,3,42.28,5,3,2,10,Loyal
19651,24,4,59.25,5,4,2,11,Recent Customer
19652,233,3,5314.25,2,3,5,10,Loyal
19653,238,3,5314.25,2,3,5,10,Loyal
19654,214,2,78.97999999999999,2,2,2,6,At Risk
19655,257,3,128.97,2,3,3,8,Potential
19656,153,2,13.98,3,2,1,6,At Risk
19657,221,5,756.26,2,5,3,10,Loyal
19658,227,1,539.99,2,1,3,6,At Risk
19659,227,4,557.26,2,4,3,9,Potential
19660,245,2,119.97999999999999,2,2,3,7,Potential
19661,79,5,2521.2699999999995,4,5,4,13,Champions
19662,188,2,75.97,3,2,2,7,Potential
19663,157,1,69.99,3,1,2,6,At Risk
19664,38,2,78.97999999999999,5,2,2,9,Potential
19665,82,1,69.99,4,1,2,7,Potential
19666,112,1,35.0,4,1,1,6,At Risk
19667,71,5,150.95000000000002,5,5,3,13,Champions
19668,42,2,119.97999999999999,5,2,3,10,Loyal
19669,219,2,78.97999999999999,2,2,2,6,At Risk
19670,322,3,1134.47,1,3,3,7,Potential
19671,309,2,1170.48,1,2,4,7,Potential
19672,99,3,74.98,4,3,2,9,Potential
19673,158,2,37.29,3,2,1,6,At Risk
19674,120,3,42.28,4,3,2,9,Potential
19675,141,3,198.99,3,3,3,9,Potential
19676,254,3,67.97,2,3,2,7,Potential
19677,285,2,58.980000000000004,2,2,2,6,At Risk
19678,314,1,1120.49,1,1,3,5,At Risk
19679,325,2,1155.48,1,2,3,6,At Risk
19680,312,2,1170.48,1,2,4,7,Potential
19681,198,3,1179.97,3,3,4,10,Loyal
19682,321,2,1155.48,1,2,3,6,At Risk
19683,334,4,1143.46,1,4,3,8,Potential
19684,312,2,78.97999999999999,1,2,2,5,At Risk
19685,107,2,78.97999999999999,4,2,2,8,Potential
19686,169,1,69.99,3,1,2,6,At Risk
19687,244,3,592.27,2,3,3,8,Potential
19688,204,2,119.97999999999999,3,2,3,8,Potential
19689,228,5,680.94,2,5,3,10,Loyal
19690,239,4,572.26,2,4,3,9,Potential
19691,242,3,569.97,2,3,3,8,Potential
19692,241,2,94.47999999999999,2,2,3,7,Potential
19693,254,4,71.95,2,4,2,8,Potential
19694,186,1,69.99,3,1,2,6,At Risk
19695,356,2,94.47999999999999,1,2,3,6,At Risk
19696,241,4,597.26,2,4,3,9,Potential
19697,217,1,539.99,2,1,3,6,At Risk
19698,225,4,726.27,2,4,3,9,Potential
19699,108,2,133.49,4,2,3,9,Potential
19700,152,2,119.97999999999999,3,2,3,8,Potential
19701,313,4,1184.46,1,4,4,9,Potential
19702,253,1,69.99,2,1,2,5,At Risk
19703,345,1,69.99,1,1,2,4,At Risk
19704,187,4,1143.46,3,4,3,10,Loyal
19705,85,2,2341.97,4,2,4,10,Loyal
19706,217,5,617.95,2,5,3,10,Loyal
19707,241,2,78.97999999999999,2,2,2,6,At Risk
19708,233,1,564.99,2,1,3,6,At Risk
19709,36,6,197.25,5,5,3,13,Champions
19710,71,3,2351.9599999999996,5,3,4,12,Loyal
19711,20,2,78.97999999999999,5,2,2,9,Recent Customer
19712,224,2,119.97999999999999,2,2,3,7,Potential
19713,362,2,78.97999999999999,1,2,2,5,At Risk
19714,199,2,548.98,3,2,3,8,Potential
19715,200,2,123.97999999999999,3,2,3,8,Potential
19716,306,2,1155.48,1,2,3,6,At Risk
19717,320,3,1137.43,1,3,3,7,Potential
19718,199,3,579.97,3,3,3,9,Potential
19719,210,5,659.94,2,5,3,10,Loyal
19720,175,2,78.97999999999999,3,2,2,7,Potential
19721,198,3,564.26,3,3,3,9,Potential
19722,183,3,586.46,3,3,3,9,Potential
19723,196,2,574.98,3,2,3,8,Potential
19724,335,2,1155.48,1,2,3,6,At Risk
19725,315,3,1179.97,1,3,4,8,Potential
19726,337,5,64.24,1,5,2,8,Potential
19727,360,1,69.99,1,1,2,4,At Risk
19728,335,2,119.97999999999999,1,2,3,6,At Risk
19729,196,3,37.269999999999996,3,3,1,7,Potential
19730,204,5,639.45,3,5,3,11,Loyal
19731,56,2,78.97999999999999,5,2,2,9,Potential
19732,272,2,78.97999999999999,2,2,2,6,At Risk
19733,359,1,69.99,1,1,2,4,At Risk
19734,94,2,119.97999999999999,4,2,3,9,Potential
19735,200,4,572.26,3,4,3,10,Loyal
19736,198,5,663.95,3,5,3,11,Loyal
19737,188,3,621.96,3,3,3,9,Potential
19738,182,4,604.96,3,4,3,10,Loyal
19739,159,4,614.96,3,4,3,10,Loyal
19740,174,4,589.96,3,4,3,10,Loyal
19741,105,2,78.97999999999999,4,2,2,8,Potential
19742,100,2,94.47999999999999,4,2,3,9,Potential
19743,294,3,1194.97,1,3,4,8,Potential
19744,275,3,1179.47,2,3,4,9,Potential
19745,301,2,1174.48,1,2,4,7,Potential
19746,80,2,2329.99,4,2,4,10,Loyal
19747,335,3,148.46999999999997,1,3,3,7,Potential
19748,141,1,4.99,3,1,1,5,At Risk
19749,165,5,682.9200000000001,3,5,3,11,Loyal
19750,105,5,77.25,4,5,2,11,Loyal
19751,155,3,37.269999999999996,3,3,1,7,Potential
19752,8,2,58.980000000000004,5,2,2,9,Recent Customer
19753,111,1,4.99,4,1,1,6,At Risk
19754,100,2,78.97999999999999,4,2,2,8,Potential
19755,95,1,69.99,4,1,2,7,Potential
19756,168,2,78.97999999999999,3,2,2,7,Potential
19757,153,3,37.269999999999996,3,3,1,7,Potential
19758,329,2,78.97999999999999,1,2,2,5,At Risk
19759,245,2,78.97999999999999,2,2,2,6,At Risk
19760,248,3,128.97,2,3,3,8,Potential
19761,48,3,67.93,5,3,2,10,Loyal
19762,193,3,48.970000000000006,3,3,2,8,Potential
19763,386,3,4153.25,1,3,5,9,Potential
19764,321,2,12.940000000000001,1,2,1,4,At Risk
19765,395,4,4132.24,1,4,5,10,Loyal
19766,353,5,4167.23,1,5,5,11,Loyal
19767,114,2,94.47999999999999,4,2,3,9,Potential
19768,283,4,1143.46,2,4,3,9,Potential
19769,106,1,539.99,4,1,3,8,Potential
19770,342,3,4127.25,1,3,5,9,Potential
19771,357,5,4167.23,1,5,5,11,Loyal
19772,256,3,6030.61,2,3,5,10,Loyal
19773,254,3,6056.61,2,3,5,10,Loyal
19774,332,3,148.46999999999997,1,3,3,7,Potential
19775,299,3,1183.47,1,3,4,8,Potential
19776,237,2,94.47999999999999,2,2,3,7,Potential
19777,185,2,119.97999999999999,3,2,3,8,Potential
19778,343,1,69.99,1,1,2,4,At Risk
19779,213,1,69.99,2,1,2,5,At Risk
19780,154,4,614.96,3,4,3,10,Loyal
19781,253,4,46.26,2,4,2,8,Potential
19782,269,5,6089.589999999999,2,5,5,12,Loyal
19783,260,2,6021.62,2,2,5,9,Potential
19784,261,2,6021.62,2,2,5,9,Potential
19785,247,3,6076.61,2,3,5,10,Loyal
19786,265,2,6021.62,2,2,5,9,Potential
19787,274,3,6054.219999999999,2,3,5,10,Loyal
19788,262,3,6056.61,2,3,5,10,Loyal
19789,274,4,6058.21,2,4,5,11,Loyal
19790,250,5,6089.589999999999,2,5,5,12,Loyal
19791,272,4,6058.21,2,4,5,11,Loyal
19792,258,3,6056.61,2,3,5,10,Loyal
19793,266,3,6056.61,2,3,5,10,Loyal
19794,253,6,6098.58,2,5,5,12,Loyal
19795,256,5,6044.59,2,5,5,12,Loyal
19796,17,6,98.94,5,5,3,13,Recent Customer
19797,250,2,6021.62,2,2,5,9,Potential
19798,118,6,128.44,4,5,3,12,Loyal
19799,115,2,78.97999999999999,4,2,2,8,Potential
19800,222,1,69.99,2,1,2,5,At Risk
19801,130,9,193.01,4,5,3,12,Loyal
19802,1098,1,3374.99,1,1,5,7,Potential
19803,97,2,574.98,4,2,3,9,Potential
19804,181,2,123.97999999999999,3,2,3,8,Potential
19805,220,1,69.99,2,1,2,5,At Risk
19806,156,2,119.97999999999999,3,2,3,8,Potential
19807,67,3,35.47,5,3,1,9,Potential
19808,163,2,589.98,3,2,3,8,Potential
19809,282,1,69.99,2,1,2,5,At Risk
19810,79,2,78.97999999999999,4,2,2,8,Potential
19811,163,1,69.99,3,1,2,6,At Risk
19812,155,4,589.96,3,4,3,10,Loyal
19813,158,1,539.99,3,1,3,7,Potential
19814,179,2,589.98,3,2,3,8,Potential
19815,129,4,597.26,4,4,3,11,Loyal
19816,140,2,123.97999999999999,3,2,3,8,Potential
19817,106,6,118.94,4,5,3,12,Loyal
19818,165,2,78.97999999999999,3,2,2,7,Potential
19819,97,2,123.97999999999999,4,2,3,9,Potential
19820,285,2,1155.48,2,2,3,7,Potential
19821,127,1,564.99,4,1,3,8,Potential
19822,214,3,36.96,2,3,1,6,At Risk
19823,57,2,46.47,5,2,2,9,Potential
19824,144,5,629.45,3,5,3,11,Loyal
19825,227,1,69.99,2,1,2,5,At Risk
19826,352,2,71.97,1,2,2,5,At Risk
19827,180,1,21.98,3,1,1,5,At Risk
19828,163,1,21.98,3,1,1,5,At Risk
19829,186,5,4533.45,3,5,5,13,Champions
19830,89,7,5765.919999999999,4,5,5,14,Champions
19831,140,3,579.97,3,3,3,9,Potential
19832,43,1,69.99,5,1,2,8,Potential
19833,292,1,69.99,1,1,2,4,At Risk
19834,228,2,119.97999999999999,2,2,3,7,Potential
19835,43,2,78.97999999999999,5,2,2,9,Potential
19836,94,4,78.96000000000001,4,4,2,10,Loyal
19837,131,2,589.98,4,2,3,9,Potential
19838,148,4,604.96,3,4,3,10,Loyal
19839,126,5,194.96,4,5,3,12,Loyal
19840,32,2,119.97999999999999,5,2,3,10,Loyal
19841,131,4,604.46,4,4,3,11,Loyal
19842,93,3,564.26,4,3,3,10,Loyal
19843,116,1,564.99,4,1,3,8,Potential
19844,82,7,5807.929999999999,4,5,5,14,Champions
19845,110,5,639.95,4,5,3,12,Loyal
19846,118,1,69.99,4,1,2,7,Potential
19847,74,1,21.98,4,1,1,6,At Risk
19848,40,2,123.97999999999999,5,2,3,10,Loyal
19849,281,3,1147.77,2,3,3,8,Potential
19850,37,2,119.97999999999999,5,2,3,10,Loyal
19851,241,2,123.97999999999999,2,2,3,7,Potential
19852,318,1,69.99,1,1,2,4,At Risk
19853,110,2,119.97999999999999,4,2,3,9,Potential
19854,120,3,554.97,4,3,3,10,Loyal
19855,69,4,5709.959999999999,5,4,5,14,Champions
19856,243,3,144.46999999999997,2,3,3,8,Potential
19857,282,1,69.99,2,1,2,5,At Risk
19858,57,2,94.47999999999999,5,2,3,10,Loyal
19859,255,1,69.99,2,1,2,5,At Risk
19860,337,3,132.97,1,3,3,7,Potential
19861,231,2,78.97999999999999,2,2,2,6,At Risk
19862,196,3,98.48,3,3,3,9,Potential
19863,22,1,69.99,5,1,2,8,Recent Customer
19864,212,1,69.99,2,1,2,5,At Risk
19865,300,2,1155.48,1,2,3,6,At Risk
19866,123,1,69.99,4,1,2,7,Potential
19867,275,2,1155.48,2,2,3,7,Potential
19868,94,2,119.97999999999999,4,2,3,9,Potential
19869,109,4,608.96,4,4,3,11,Loyal
19870,53,5,77.25,5,5,2,12,Loyal
19871,157,1,69.99,3,1,2,6,At Risk
19872,12,2,7.28,5,2,1,8,Recent Customer
19873,297,2,7.28,1,2,1,4,At Risk
19874,204,5,4544.45,3,5,5,13,Champions
19875,280,4,1199.46,2,4,4,10,Loyal
19876,212,2,78.97999999999999,2,2,2,6,At Risk
19877,148,1,69.99,3,1,2,6,At Risk
19878,52,1,69.99,5,1,2,8,Potential
19879,331,1,69.99,1,1,2,4,At Risk
19880,305,1,69.99,1,1,2,4,At Risk
19881,306,2,78.97999999999999,1,2,2,5,At Risk
19882,199,2,123.97999999999999,3,2,3,8,Potential
19883,98,2,548.98,4,2,3,9,Potential
19884,189,5,4588.45,3,5,5,13,Champions
19885,31,2,123.97999999999999,5,2,3,10,Loyal
19886,292,2,78.97999999999999,1,2,2,5,At Risk
19887,42,2,78.97999999999999,5,2,2,9,Potential
19888,189,2,119.97999999999999,3,2,3,8,Potential
19889,97,1,539.99,4,1,3,8,Potential
19890,196,2,119.97999999999999,3,2,3,8,Potential
19891,289,2,1174.48,1,2,4,7,Potential
19892,276,2,1155.48,2,2,3,7,Potential
19893,1,2,119.97999999999999,5,2,3,10,Recent Customer
19894,244,1,69.99,2,1,2,5,At Risk
19895,15,3,128.97,5,3,3,11,Recent Customer
19896,307,1,69.99,1,1,2,4,At Risk
19897,71,3,596.96,5,3,3,11,Loyal
19898,40,2,27.279999999999998,5,2,1,8,Potential
19899,94,5,3127.9499999999994,4,5,4,13,Champions
19900,155,2,27.279999999999998,3,2,1,6,At Risk
19901,108,3,3016.0681999999997,4,3,4,11,Loyal
19902,97,3,3080.2699999999995,4,3,4,11,Loyal
19903,76,6,3177.9399999999996,4,5,4,13,Champions
19904,112,4,3018.3581999999997,4,4,4,12,Loyal
19905,89,2,7.28,4,2,1,7,Potential
19906,173,2,13.98,3,2,1,6,At Risk
19907,117,3,32.269999999999996,4,3,1,8,Potential
19908,36,2,49.48,5,2,2,9,Potential
19909,244,3,63.97,2,3,2,7,Potential
19910,114,4,3188.46,4,4,4,12,Loyal
19911,83,4,3335.4074999999993,4,4,5,13,Champions
19912,65,5,3427.3874999999994,5,5,5,15,Champions
19913,338,2,28.979999999999997,1,2,1,4,At Risk
19914,229,3,31.27,2,3,1,6,At Risk
19915,12,3,78.97,5,3,2,10,Recent Customer
19916,74,6,3354.3875,4,5,5,14,Champions
19917,82,5,3369.4074999999993,4,5,5,14,Champions
19918,32,4,3360.4075,5,4,5,14,Champions
19919,261,1,4.99,2,1,1,4,At Risk
19920,344,4,91.96000000000001,1,4,2,7,Potential
19921,291,3,63.97,1,3,2,6,At Risk
19922,86,3,3137.97,4,3,4,11,Loyal
19923,274,1,24.99,2,1,1,4,At Risk
19924,99,5,3171.9499999999994,4,5,4,13,Champions
19925,205,3,83.97,3,3,2,8,Potential
19926,298,2,39.980000000000004,1,2,1,4,At Risk
19927,184,1,4.99,3,1,1,5,At Risk
19928,271,1,4.99,2,1,1,4,At Risk
19929,305,3,63.97,1,3,2,6,At Risk
19930,65,4,3115.2699999999995,5,4,4,13,Champions
19931,82,5,3125.91,4,5,4,13,Champions
19932,15,1,24.99,5,1,1,7,Recent Customer
19933,311,1,4.99,1,1,1,3,At Risk
19934,260,6,193.44,2,5,3,10,Loyal
19935,165,3,82.97,3,3,2,8,Potential
19936,33,2,28.979999999999997,5,2,1,8,Potential
19937,25,4,72.96000000000001,5,4,2,11,Recent Customer
19938,138,1,4.99,3,1,1,5,At Risk
19939,51,3,48.97,5,3,2,10,Loyal
19940,34,3,3440.4275,5,3,5,13,Champions
19941,54,6,3078.0582,5,5,4,14,Champions
19942,41,4,3034.0681999999997,5,4,4,13,Champions
19943,84,3,3112.9699999999993,4,3,4,11,Loyal
19944,73,3,3105.2699999999995,5,3,4,12,Loyal
19945,70,3,3137.97,5,3,4,12,Loyal
19946,289,4,86.95,1,4,2,7,Potential
19947,262,4,6056.51,2,4,5,11,Loyal
19948,267,2,6021.62,2,2,5,9,Potential
19949,265,3,6054.219999999999,2,3,5,10,Loyal
19950,225,6,6098.54,2,5,5,12,Loyal
19951,221,2,6021.62,2,2,5,9,Potential
19952,51,4,39.46,5,4,1,10,Loyal
19953,23,5,48.45,5,5,2,12,Recent Customer
19954,228,5,74.45,2,5,2,9,Potential
19955,157,6,173.45,3,5,3,11,Loyal
19956,218,5,6060.5,2,5,5,12,Loyal
19957,228,4,6035.599999999999,2,4,5,11,Loyal
19958,215,4,6056.51,2,4,5,11,Loyal
19959,220,3,6056.61,2,3,5,10,Loyal
19960,229,4,6120.11,2,4,5,11,Loyal
19961,52,4,97.97,5,4,3,12,Loyal
19962,194,5,46.75,3,5,2,10,Loyal
19963,230,3,6054.219999999999,2,3,5,10,Loyal
19964,225,3,6056.61,2,3,5,10,Loyal
19965,217,3,6056.61,2,3,5,10,Loyal
19966,236,2,6021.62,2,2,5,9,Potential
19967,218,3,6029.57,2,3,5,10,Loyal
19968,234,2,6021.62,2,2,5,9,Potential
19969,237,5,98.45,2,5,3,10,Loyal
19970,217,5,6099.099999999999,2,5,5,12,Loyal
19971,228,3,6056.61,2,3,5,10,Loyal
19972,117,6,49.7,4,5,2,11,Loyal
19973,145,6,83.44,3,5,2,10,Loyal
19974,224,2,6021.62,2,2,5,9,Potential
19975,214,3,6056.61,2,3,5,10,Loyal
19976,214,6,44.04,2,5,2,9,Potential
19977,244,5,6044.59,2,5,5,12,Loyal
19978,233,5,6060.5,2,5,5,12,Loyal
19979,221,5,6090.59,2,5,5,12,Loyal
19980,13,2,94.47999999999999,5,2,3,10,Recent Customer
19981,300,2,1155.48,1,2,3,6,At Risk
19982,79,4,589.96,4,4,3,11,Loyal
19983,282,1,1120.49,2,1,3,6,At Risk
19984,278,3,1183.47,2,3,4,9,Potential
19985,296,2,1174.48,1,2,4,7,Potential
19986,302,4,1189.46,1,4,4,9,Potential
19987,210,5,4564.45,2,5,5,12,Loyal
19988,167,3,4555.469999999999,3,3,5,11,Loyal
19989,181,2,4495.48,3,2,5,10,Loyal
19990,79,2,548.98,4,2,3,9,Potential
19991,75,3,596.96,4,3,3,10,Loyal
19992,68,2,586.97,5,2,3,10,Loyal
19993,298,4,1184.46,1,4,4,9,Potential
19994,89,1,539.99,4,1,3,8,Potential
19995,69,2,618.98,5,2,3,10,Loyal
19996,134,1,69.99,3,1,2,6,At Risk
19997,91,3,5814.98,4,3,5,12,Loyal
19998,300,2,1155.48,1,2,3,6,At Risk
19999,303,3,1147.77,1,3,3,7,Potential
20000,161,2,4495.48,3,2,5,10,Loyal
20001,280,2,1155.48,2,2,3,7,Potential
20002,51,4,589.96,5,4,3,12,Loyal
20003,45,3,579.97,5,3,3,11,Loyal
20004,50,4,589.96,5,4,3,12,Loyal
20005,258,4,1143.46,2,4,3,9,Potential
20006,245,2,1155.48,2,2,3,7,Potential
20007,152,2,4495.48,3,2,5,10,Loyal
20008,104,1,69.99,4,1,2,7,Potential
20009,267,4,1184.46,2,4,4,10,Loyal
20010,128,1,69.99,4,1,2,7,Potential
20011,37,1,539.99,5,1,3,9,Potential
20012,52,3,554.97,5,3,3,11,Loyal
20013,37,1,539.99,5,1,3,9,Potential
20014,307,2,78.97999999999999,1,2,2,5,At Risk
20015,45,1,564.99,5,1,3,9,Potential
20016,171,3,132.97,3,3,3,9,Potential
20017,35,2,78.97999999999999,5,2,2,9,Potential
20018,228,1,69.99,2,1,2,5,At Risk
20019,147,3,128.97,3,3,3,9,Potential
20020,117,2,78.97999999999999,4,2,2,8,Potential
20021,41,3,80.96000000000001,5,3,2,10,Loyal
20022,114,2,119.97999999999999,4,2,3,9,Potential
20023,145,3,4530.469999999999,3,3,5,11,Loyal
20024,274,2,1155.48,2,2,3,7,Potential
20025,80,2,94.47999999999999,4,2,3,9,Potential
20026,254,4,1212.97,2,4,4,10,Loyal
20027,88,2,78.97999999999999,4,2,2,8,Potential
20028,246,2,1174.48,2,2,4,8,Potential
20029,270,2,1129.48,2,2,3,7,Potential
20030,260,2,1155.48,2,2,3,7,Potential
20031,263,2,1155.48,2,2,3,7,Potential
20032,247,1,1120.49,2,1,3,6,At Risk
20033,51,3,567.27,5,3,3,11,Loyal
20034,68,5,5769.959999999999,5,5,5,15,Champions
20035,80,2,5694.98,4,2,5,11,Loyal
20036,378,5,2618.62,1,5,4,10,Loyal
20037,367,3,2595.95,1,3,4,8,Potential
20038,394,1,2443.35,1,1,4,6,At Risk
20039,376,3,2457.3299999999995,1,3,4,8,Potential
20040,263,2,1155.48,2,2,3,7,Potential
20041,280,2,12.98,2,2,1,5,At Risk
20042,332,3,3150.3981999999996,1,3,4,8,Potential
20043,35,2,32.28,5,2,1,8,Potential
20044,232,2,1155.48,2,2,3,7,Potential
20045,301,3,596.96,1,3,3,7,Potential
20046,245,8,691.9100000000001,2,5,3,10,Loyal
20047,245,2,614.98,2,2,3,7,Potential
20048,185,2,3142.4482,3,2,4,9,Potential
20049,159,3,3150.3981999999996,3,3,4,10,Loyal
20050,362,2,58.980000000000004,1,2,2,5,At Risk
20051,32,9,4464.2699999999995,5,5,5,15,Champions
20052,316,5,3214.0282,1,5,4,10,Loyal
20053,218,3,36.269999999999996,2,3,1,6,At Risk
20054,293,5,3338.0382,1,5,5,11,Loyal
20055,217,3,82.97,2,3,2,7,Potential
20056,69,5,144.45,5,5,3,13,Champions
20057,141,3,47.97,3,3,2,8,Potential
20058,243,3,31.27,2,3,1,6,At Risk
20059,198,2,1170.48,3,2,4,9,Potential
20060,175,2,3142.4482,3,2,4,9,Potential
20061,189,2,1174.48,3,2,4,9,Potential
20062,305,5,1997.45,1,5,4,10,Loyal
20063,51,3,64.97,5,3,2,10,Loyal
20064,225,2,38.980000000000004,2,2,1,5,At Risk
20065,41,1,21.49,5,1,1,7,Potential
20066,265,2,1170.48,2,2,4,8,Potential
20067,253,2,1155.48,2,2,3,7,Potential
20068,247,1,1120.49,2,1,3,6,At Risk
20069,120,2,574.98,4,2,3,9,Potential
20070,191,2,39.980000000000004,3,2,1,6,At Risk
20071,332,2,78.97999999999999,1,2,2,5,At Risk
20072,261,2,1155.48,2,2,3,7,Potential
20073,266,2,1170.48,2,2,4,8,Potential
20074,105,4,588.96,4,4,3,11,Loyal
20075,789,1,3399.99,1,1,5,7,Potential
20076,69,3,553.97,5,3,3,11,Loyal
20077,89,5,633.45,4,5,3,12,Loyal
20078,69,3,628.97,5,3,3,11,Loyal
20079,71,1,4.99,5,1,1,7,Potential
20080,88,2,548.98,4,2,3,9,Potential
20081,106,2,58.980000000000004,4,2,2,8,Potential
20082,21,6,137.54000000000002,5,5,3,13,Recent Customer
20083,86,2,39.980000000000004,4,2,1,7,Potential
20084,61,5,63.150000000000006,5,5,2,12,Loyal
20085,162,6,76.75999999999999,3,5,2,10,Loyal
20086,252,5,128.55,2,5,3,10,Loyal
20087,25,4,112.76,5,4,3,12,Recent Customer
20088,236,1,4.99,2,1,1,4,At Risk
20089,196,1,4.99,3,1,1,5,At Risk
20090,62,2,548.98,5,2,3,10,Loyal
20091,69,4,562.96,5,4,3,12,Loyal
20092,248,3,1149.47,2,3,3,8,Potential
20093,270,3,1179.97,2,3,4,9,Potential
20094,175,2,13.98,3,2,1,6,At Risk
20095,145,2,59.980000000000004,3,2,2,7,Potential
20096,41,3,71.46,5,3,2,10,Loyal
20097,271,1,1120.49,2,1,3,6,At Risk
20098,102,2,68.49,4,2,2,8,Potential
20099,150,1,4.99,3,1,1,5,At Risk
20100,41,2,39.980000000000004,5,2,1,8,Potential
20101,77,3,67.93,4,3,2,9,Potential
20102,137,2,39.980000000000004,3,2,1,6,At Risk
20103,270,3,103.48,2,3,3,8,Potential
20104,336,6,66.53,1,5,2,8,Potential
20105,162,3,68.97,3,3,2,8,Potential
20106,234,4,131.95,2,4,3,9,Potential
20107,189,1,69.99,3,1,2,6,At Risk
20108,271,2,1155.48,2,2,3,7,Potential
20109,257,2,1155.48,2,2,3,7,Potential
20110,244,1,1120.49,2,1,3,6,At Risk
20111,240,4,1169.46,2,4,4,10,Loyal
20112,101,2,78.97999999999999,4,2,2,8,Potential
20113,94,1,69.99,4,1,2,7,Potential
20114,243,2,78.97999999999999,2,2,2,6,At Risk
20115,332,2,119.97999999999999,1,2,3,6,At Risk
20116,331,2,119.97999999999999,1,2,3,6,At Risk
20117,309,2,78.97999999999999,1,2,2,5,At Risk
20118,222,2,1170.48,2,2,4,8,Potential
20119,117,1,69.99,4,1,2,7,Potential
20120,295,2,119.97999999999999,1,2,3,6,At Risk
20121,317,1,69.99,1,1,2,4,At Risk
20122,78,3,128.97,4,3,3,10,Loyal
20123,111,3,132.97,4,3,3,10,Loyal
20124,235,1,69.99,2,1,2,5,At Risk
20125,245,2,119.97999999999999,2,2,3,7,Potential
20126,20,1,69.99,5,1,2,8,Recent Customer
20127,292,1,69.99,1,1,2,4,At Risk
20128,202,2,78.97999999999999,3,2,2,7,Potential
20129,300,2,119.97999999999999,1,2,3,6,At Risk
20130,363,1,4.99,1,1,1,3,At Risk
20131,34,2,38.980000000000004,5,2,1,8,Potential
20132,233,3,69.97,2,3,2,7,Potential
20133,209,2,28.979999999999997,2,2,1,5,At Risk
20134,3,3,148.98,5,3,3,11,Recent Customer
20135,212,3,69.97,2,3,2,7,Potential
20136,25,2,27.279999999999998,5,2,1,8,Recent Customer
20137,54,4,78.96000000000001,5,4,2,11,Loyal
20138,357,4,119.96000000000001,1,4,3,8,Potential
20139,270,1,69.99,2,1,2,5,At Risk
20140,270,1,29.99,2,1,1,4,At Risk
20141,82,1,3.99,4,1,1,6,At Risk
20142,363,1,3.99,1,1,1,3,At Risk
20143,185,2,32.28,3,2,1,6,At Risk
20144,31,4,120.46,5,4,3,12,Loyal
20145,201,4,1184.46,3,4,4,11,Loyal
20146,348,1,3.99,1,1,1,3,At Risk
20147,224,3,37.97,2,3,1,6,At Risk
20148,319,2,6.28,1,2,1,4,At Risk
20149,176,5,3165.4182,3,5,4,12,Loyal
20150,297,6,3264.0182,1,5,4,10,Loyal
20151,338,5,4152.73,1,5,5,11,Loyal
20152,358,3,4142.75,1,3,5,9,Potential
20153,183,2,13.98,3,2,1,6,At Risk
20154,349,3,4153.25,1,3,5,9,Potential
20155,214,2,59.980000000000004,2,2,2,6,At Risk
20156,338,3,4139.75,1,3,5,9,Potential
20157,356,2,4118.26,1,2,5,8,Potential
20158,363,3,4153.25,1,3,5,9,Potential
20159,356,5,4167.23,1,5,5,11,Loyal
20160,341,6,4237.219999999999,1,5,5,11,Loyal
20161,217,2,38.980000000000004,2,2,1,5,At Risk
20162,294,4,1966.46,1,4,4,9,Potential
20163,288,2,1903.48,2,2,4,8,Potential
20164,133,3,3150.3981999999996,4,3,4,11,Loyal
20165,144,5,3191.4181999999996,3,5,4,12,Loyal
20166,299,5,1967.45,1,5,4,10,Loyal
20167,126,2,3142.4482,4,2,4,10,Loyal
20168,29,2,32.28,5,2,1,8,Recent Customer
20169,4,4,78.96000000000001,5,4,2,11,Recent Customer
20170,105,3,3177.4382,4,3,4,11,Loyal
20171,268,3,1938.47,2,3,4,9,Potential
20172,65,3,3150.3981999999996,5,3,4,12,Loyal
20173,290,5,3181.3282,1,5,4,10,Loyal
20174,105,1,29.99,4,1,1,6,At Risk
20175,204,4,1214.46,3,4,4,11,Loyal
20176,120,2,32.28,4,2,1,7,Potential
20177,232,2,6.28,2,2,1,5,At Risk
20178,314,1,3.99,1,1,1,3,At Risk
20179,242,1,24.99,2,1,1,4,At Risk
20180,393,4,2487.89,1,4,4,9,Potential
20181,384,1,2443.35,1,1,4,6,At Risk
20182,85,3,5749.969999999999,4,3,5,12,Loyal
20183,365,2,2451.2999999999997,1,2,4,7,Potential
20184,278,2,123.97999999999999,2,2,3,7,Potential
20185,135,1,69.99,3,1,2,6,At Risk
20186,117,2,3191.9096,4,2,4,10,Loyal
20187,227,3,1179.97,2,3,4,9,Potential
20188,95,3,3226.8996,4,3,4,11,Loyal
20189,136,1,4.99,3,1,1,5,At Risk
20190,223,4,1204.46,2,4,4,10,Loyal
20191,215,4,1143.46,2,4,3,9,Potential
20192,229,2,1155.48,2,2,3,7,Potential
20193,233,1,1120.49,2,1,3,6,At Risk
20194,220,2,1174.48,2,2,4,8,Potential
20195,241,2,1174.48,2,2,4,8,Potential
20196,216,1,1120.49,2,1,3,6,At Risk
20197,220,2,1145.48,2,2,3,7,Potential
20198,230,2,1174.48,2,2,4,8,Potential
20199,343,3,2502.8299999999995,1,3,4,8,Potential
20200,366,3,2479.94,1,3,4,8,Potential
20201,1,2,133.49,5,2,3,10,Recent Customer
20202,52,4,45.95,5,4,2,11,Loyal
20203,129,2,119.97999999999999,4,2,3,9,Potential
20204,364,2,2475.95,1,2,4,7,Potential
20205,231,4,1184.46,2,4,4,10,Loyal
20206,94,3,3204.5782,4,3,4,11,Loyal
20207,231,3,1134.47,2,3,3,8,Potential
20208,121,3,3219.5782,4,3,4,11,Loyal
20209,111,6,3268.5481999999997,4,5,4,13,Champions
20210,346,2,2478.3399999999997,1,2,4,7,Potential
20211,242,3,5333.25,2,3,5,10,Loyal
20212,45,6,100.74,5,5,3,13,Champions
20213,238,3,6029.57,2,3,5,10,Loyal
20214,218,3,5304.25,2,3,5,10,Loyal
20215,236,2,5279.26,2,2,5,9,Potential
20216,239,4,5338.74,2,4,5,11,Loyal
20217,239,5,6089.589999999999,2,5,5,12,Loyal
20218,271,7,104.69,2,5,3,10,Loyal
20219,243,5,6044.59,2,5,5,12,Loyal
20220,237,5,6060.5,2,5,5,12,Loyal
20221,228,4,6035.599999999999,2,4,5,11,Loyal
20222,42,5,74.45,5,5,2,12,Loyal
20223,32,8,187.38,5,5,3,13,Champions
20224,116,4,44.46,4,4,2,10,Loyal
20225,227,3,6056.61,2,3,5,10,Loyal
20226,238,5,6067.2,2,5,5,12,Loyal
20227,221,3,6054.219999999999,2,3,5,10,Loyal
20228,244,5,6093.2,2,5,5,12,Loyal
20229,163,3,69.97,3,3,2,8,Potential
20230,230,2,32.28,2,2,1,5,At Risk
20231,251,3,60.47,2,3,2,7,Potential
20232,230,4,91.95,2,4,2,8,Potential
20233,271,3,69.97,2,3,2,7,Potential
20234,340,2,32.28,1,2,1,4,At Risk
20235,47,2,34.98,5,2,1,8,Potential
20236,213,2,5279.26,2,2,5,9,Potential
20237,362,1,21.49,1,1,1,3,At Risk
20238,220,2,6021.62,2,2,5,9,Potential
20239,224,5,6093.2,2,5,5,12,Loyal
20240,105,3,56.96,4,3,2,9,Potential
20241,193,5,5347.23,3,5,5,13,Champions
20242,230,6,6068.45,2,5,5,12,Loyal
20243,252,3,60.47,2,3,2,7,Potential
20244,230,2,6021.62,2,2,5,9,Potential
20245,192,5,6085.59,3,5,5,13,Champions
20246,213,4,6035.599999999999,2,4,5,11,Loyal
20247,188,3,6056.61,3,3,5,11,Loyal
20248,34,3,69.97,5,3,2,10,Loyal
20249,189,3,5333.25,3,3,5,11,Loyal
20250,286,3,37.269999999999996,2,3,1,6,At Risk
20251,282,3,59.47,2,3,2,7,Potential
20252,150,3,69.97,3,3,2,8,Potential
20253,187,4,6035.599999999999,3,4,5,12,Loyal
20254,135,3,60.47,3,3,2,8,Potential
20255,353,2,75.48,1,2,2,5,At Risk
20256,196,3,6029.57,3,3,5,11,Loyal
20257,5,1,21.49,5,1,1,7,Recent Customer
20258,200,3,6029.57,3,3,5,11,Loyal
20259,194,3,6029.57,3,3,5,11,Loyal
20260,213,3,5314.25,2,3,5,10,Loyal
20261,183,3,5314.25,3,3,5,11,Loyal
20262,212,3,27.77,2,3,1,6,At Risk
20263,64,1,21.49,5,1,1,7,Potential
20264,190,3,5333.25,3,3,5,11,Loyal
20265,322,2,32.28,1,2,1,4,At Risk
20266,284,3,60.47,2,3,2,7,Potential
20267,177,3,49.97,3,3,2,8,Potential
20268,98,1,21.49,4,1,1,6,At Risk
20269,93,1,4.99,4,1,1,6,At Risk
20270,282,2,78.97999999999999,2,2,2,6,At Risk
20271,196,2,119.97999999999999,3,2,3,8,Potential
20272,127,2,94.47999999999999,4,2,3,9,Potential
20273,123,2,39.980000000000004,4,2,1,7,Potential
20274,180,1,69.99,3,1,2,6,At Risk
20275,16,2,133.49,5,2,3,10,Recent Customer
20276,24,3,128.97,5,3,3,11,Recent Customer
20277,271,1,4.99,2,1,1,4,At Risk
20278,332,1,69.99,1,1,2,4,At Risk
20279,319,3,144.46999999999997,1,3,3,7,Potential
20280,137,5,95.94,3,5,3,11,Loyal
20281,225,3,1179.97,2,3,4,9,Potential
20282,208,3,37.269999999999996,2,3,1,6,At Risk
20283,163,3,5314.25,3,3,5,11,Loyal
20284,154,5,5328.23,3,5,5,13,Champions
20285,47,1,69.99,5,1,2,8,Potential
20286,280,2,78.97999999999999,2,2,2,6,At Risk
20287,140,3,144.46999999999997,3,3,3,9,Potential
20288,81,2,94.47999999999999,4,2,3,9,Potential
20289,160,1,69.99,3,1,2,6,At Risk
20290,295,2,123.97999999999999,1,2,3,6,At Risk
20291,220,4,1151.76,2,4,3,9,Potential
20292,91,2,119.97999999999999,4,2,3,9,Potential
20293,136,1,69.99,3,1,2,6,At Risk
20294,138,2,119.97999999999999,3,2,3,8,Potential
20295,230,2,1174.48,2,2,4,8,Potential
20296,244,2,1145.48,2,2,3,7,Potential
20297,323,4,2466.3199999999997,1,4,4,9,Potential
20298,3,1,69.99,5,1,2,8,Recent Customer
20299,291,2,56.97,1,2,2,5,At Risk
20300,126,2,71.97,4,2,2,8,Potential
20301,251,1,69.99,2,1,2,5,At Risk
20302,311,2,2451.2999999999997,1,2,4,7,Potential
20303,311,4,2512.3199999999997,1,4,4,9,Potential
20304,224,2,1170.48,2,2,4,8,Potential
20305,115,1,69.99,4,1,2,7,Potential
20306,273,1,69.99,2,1,2,5,At Risk
20307,234,2,119.97999999999999,2,2,3,7,Potential
20308,317,1,69.99,1,1,2,4,At Risk
20309,25,2,68.49,5,2,2,9,Recent Customer
20310,224,3,1149.47,2,3,3,8,Potential
20311,73,2,119.97999999999999,5,2,3,10,Loyal
20312,268,1,4.99,2,1,1,4,At Risk
20313,58,2,94.47999999999999,5,2,3,10,Loyal
20314,68,3,67.93,5,3,2,10,Loyal
20315,228,3,132.97,2,3,3,8,Potential
20316,337,2,39.980000000000004,1,2,1,4,At Risk
20317,307,2,58.980000000000004,1,2,2,5,At Risk
20318,94,3,3241.8995999999997,4,3,4,11,Loyal
20319,229,2,1155.48,2,2,3,7,Potential
20320,236,2,1155.48,2,2,3,7,Potential
20321,233,2,1155.48,2,2,3,7,Potential
20322,35,1,69.99,5,1,2,8,Potential
20323,314,4,2492.3199999999997,1,4,4,9,Potential
20324,306,4,2543.44,1,4,4,9,Potential
20325,90,2,78.97999999999999,4,2,2,8,Potential
20326,276,3,128.97,2,3,3,8,Potential
20327,256,1,69.99,2,1,2,5,At Risk
20328,164,2,119.97999999999999,3,2,3,8,Potential
20329,98,1,69.99,4,1,2,7,Potential
20330,29,4,71.95,5,4,2,11,Recent Customer
20331,245,2,133.49,2,2,3,7,Potential
20332,140,2,78.97999999999999,3,2,2,7,Potential
20333,75,1,69.99,4,1,2,7,Potential
20334,350,1,69.99,1,1,2,4,At Risk
20335,128,1,69.99,4,1,2,7,Potential
20336,45,1,69.99,5,1,2,8,Potential
20337,331,2,2452.3399999999997,1,2,4,7,Potential
20338,100,2,123.97999999999999,4,2,3,9,Potential
20339,308,3,2528.3299999999995,1,3,4,8,Potential
20340,304,1,2443.35,1,1,4,6,At Risk
20341,185,2,56.97,3,2,2,7,Potential
20342,114,2,78.97999999999999,4,2,2,8,Potential
20343,357,1,69.99,1,1,2,4,At Risk
20344,327,2,119.97999999999999,1,2,3,6,At Risk
20345,292,4,2520.8299999999995,1,4,4,9,Potential
20346,284,5,2564.9199999999996,2,5,4,11,Loyal
20347,284,1,2443.35,2,1,4,7,Potential
20348,296,4,2511.3199999999997,1,4,4,9,Potential
20349,209,1,69.99,2,1,2,5,At Risk
20350,82,3,3226.8996,4,3,4,11,Loyal
20351,131,2,119.97999999999999,4,2,3,9,Potential
20352,288,2,78.97999999999999,2,2,2,6,At Risk
20353,285,2,78.97999999999999,2,2,2,6,At Risk
20354,247,3,32.22,2,3,1,6,At Risk
20355,119,2,78.97999999999999,4,2,2,8,Potential
20356,45,2,78.97999999999999,5,2,2,9,Potential
20357,223,1,69.99,2,1,2,5,At Risk
20358,271,2,123.97999999999999,2,2,3,7,Potential
20359,236,2,78.97999999999999,2,2,2,6,At Risk
20360,160,2,78.97999999999999,3,2,2,7,Potential
20361,349,1,69.99,1,1,2,4,At Risk
20362,79,1,69.99,4,1,2,7,Potential
20363,79,3,144.46999999999997,4,3,3,10,Loyal
20364,39,2,78.97999999999999,5,2,2,9,Potential
20365,3,1,69.99,5,1,2,8,Recent Customer
20366,339,1,69.99,1,1,2,4,At Risk
20367,60,3,128.97,5,3,3,11,Loyal
20368,268,1,69.99,2,1,2,5,At Risk
20369,266,3,64.97,2,3,2,7,Potential
20370,266,3,49.970000000000006,2,3,2,7,Potential
20371,228,2,1174.48,2,2,4,8,Potential
20372,231,4,1184.46,2,4,4,10,Loyal
20373,82,3,3226.8996,4,3,4,11,Loyal
20374,243,1,1120.49,2,1,3,6,At Risk
20375,85,4,4438.3796,4,4,5,13,Champions
20376,278,2,2475.95,2,2,4,8,Potential
20377,247,1,2443.35,2,1,4,7,Potential
20378,348,2,119.97999999999999,1,2,3,6,At Risk
20379,177,2,123.97999999999999,3,2,3,8,Potential
20380,283,2,7.28,2,2,1,5,At Risk
20381,91,1,69.99,4,1,2,7,Potential
20382,274,4,2482.23,2,4,4,10,Loyal
20383,95,2,94.47999999999999,4,2,3,9,Potential
20384,249,3,128.97,2,3,3,8,Potential
20385,259,3,2528.3299999999995,2,3,4,9,Potential
20386,266,4,2482.23,2,4,4,10,Loyal
20387,207,3,1194.97,2,3,4,9,Potential
20388,147,1,9.99,3,1,1,5,At Risk
20389,86,3,22.93,4,3,1,8,Potential
20390,157,2,14.98,3,2,1,6,At Risk
20391,355,3,23.97,1,3,1,5,At Risk
20392,93,4,133.47,4,4,3,11,Loyal
20393,24,2,14.98,5,2,1,8,Recent Customer
20394,210,4,1158.46,2,4,4,10,Loyal
20395,199,3,1179.97,3,3,4,10,Loyal
20396,119,1,69.99,4,1,2,7,Potential
20397,105,3,78.48,4,3,2,9,Potential
20398,234,3,68.97,2,3,2,7,Potential
20399,192,4,1184.46,3,4,4,11,Loyal
20400,207,1,1120.49,2,1,3,6,At Risk
20401,190,4,1184.46,3,4,4,11,Loyal
20402,227,1,4.99,2,1,1,4,At Risk
20403,36,2,7.28,5,2,1,8,Potential
20404,18,2,124.99,5,2,3,10,Recent Customer
20405,256,2,2563.35,2,2,4,8,Potential
20406,143,2,59.980000000000004,3,2,2,7,Potential
20407,168,1,4.99,3,1,1,5,At Risk
20408,150,3,69.97,3,3,2,8,Potential
20409,167,2,14.98,3,2,1,6,At Risk
20410,294,3,49.970000000000006,1,3,2,6,At Risk
20411,260,3,69.47,2,3,2,7,Potential
20412,269,3,2528.3299999999995,2,3,4,9,Potential
20413,312,3,49.970000000000006,1,3,2,6,At Risk
20414,110,3,78.48,4,3,2,9,Potential
20415,169,2,13.98,3,2,1,6,At Risk
20416,336,2,4118.26,1,2,5,8,Potential
20417,287,3,67.97,2,3,2,7,Potential
20418,338,4,4207.24,1,4,5,10,Loyal
20419,297,1,4.99,1,1,1,3,At Risk
20420,331,4,4132.24,1,4,5,10,Loyal
20421,265,3,118.97,2,3,3,8,Potential
20422,205,3,1134.47,3,3,3,9,Potential
20423,314,4,4177.74,1,4,5,10,Loyal
20424,319,4,4132.24,1,4,5,10,Loyal
20425,331,2,4118.26,1,2,5,8,Potential
20426,326,3,4139.75,1,3,5,9,Potential
20427,163,3,5314.25,3,3,5,11,Loyal
20428,12,1,29.99,5,1,1,7,Recent Customer
20429,154,4,5377.75,3,4,5,12,Loyal
20430,187,3,6056.61,3,3,5,11,Loyal
20431,125,2,14.98,4,2,1,7,Potential
20432,83,2,14.98,4,2,1,7,Potential
20433,52,4,74.46,5,4,2,11,Loyal
20434,207,2,1170.48,2,2,4,8,Potential
20435,197,3,49.970000000000006,3,3,2,8,Potential
20436,183,3,1134.47,3,3,3,9,Potential
20437,201,2,1155.48,3,2,3,8,Potential
20438,293,3,69.97,1,3,2,6,At Risk
20439,339,2,14.98,1,2,1,4,At Risk
20440,248,1,9.99,2,1,1,4,At Risk
20441,157,2,39.980000000000004,3,2,1,6,At Risk
20442,259,4,2482.23,2,4,4,10,Loyal
20443,117,3,39.47,4,3,1,8,Potential
20444,190,5,6085.59,3,5,5,13,Champions
20445,190,4,6078.71,3,4,5,12,Loyal
20446,195,3,6029.57,3,3,5,11,Loyal
20447,187,4,6035.599999999999,3,4,5,12,Loyal
20448,205,5,6044.59,3,5,5,13,Champions
20449,203,1,9.99,3,1,1,5,At Risk
20450,203,2,6021.62,3,2,5,10,Loyal
20451,197,3,6054.219999999999,3,3,5,11,Loyal
20452,202,6,6156.7,3,5,5,13,Champions
20453,362,1,21.49,1,1,1,3,At Risk
20454,213,2,23.779999999999998,2,2,1,5,At Risk
20455,10,2,23.779999999999998,5,2,1,8,Recent Customer
20456,186,3,6029.57,3,3,5,11,Loyal
20457,246,4,73.96000000000001,2,4,2,8,Potential
20458,275,3,49.970000000000006,2,3,2,7,Potential
20459,184,2,1155.48,3,2,3,8,Potential
20460,353,1,21.49,1,1,1,3,At Risk
20461,242,4,2492.3199999999997,2,4,4,10,Loyal
20462,234,4,2512.3199999999997,2,4,4,10,Loyal
20463,194,3,1147.77,3,3,3,9,Potential
20464,220,3,22.93,2,3,1,6,At Risk
20465,238,4,2514.93,2,4,4,10,Loyal
20466,9,2,14.98,5,2,1,8,Recent Customer
20467,100,3,17.27,4,3,1,8,Potential
20468,72,2,3169.5882,5,2,4,11,Loyal
20469,43,3,49.970000000000006,5,3,2,10,Loyal
20470,78,5,4408.6896,4,5,5,14,Champions
20471,58,3,73.97,5,3,2,10,Loyal
20472,216,4,2482.23,2,4,4,10,Loyal
20473,3,2,14.98,5,2,1,8,Recent Customer
20474,184,3,49.970000000000006,3,3,2,8,Potential
20475,233,2,14.98,2,2,1,5,At Risk
20476,241,5,2521.3099999999995,2,5,4,11,Loyal
20477,206,3,68.97,3,3,2,8,Potential
20478,262,3,96.46000000000001,2,3,3,8,Potential
20479,109,2,85.48,4,2,2,8,Potential
20480,196,2,1155.48,3,2,3,8,Potential
20481,186,2,1170.48,3,2,4,9,Potential
20482,218,1,2443.35,2,1,4,7,Potential
20483,36,4,4400.0581999999995,5,4,5,14,Champions
20484,192,4,1151.76,3,4,3,10,Loyal
20485,205,2,14.98,3,2,1,6,At Risk
20486,130,3,49.970000000000006,4,3,2,9,Potential
20487,273,1,9.99,2,1,1,4,At Risk
20488,68,2,14.98,5,2,1,8,Potential
20489,281,3,49.970000000000006,2,3,2,7,Potential
20490,30,3,49.970000000000006,5,3,2,10,Recent Customer
20491,24,3,23.97,5,3,1,9,Recent Customer
20492,363,2,71.97,1,2,2,5,At Risk
20493,76,3,23.97,4,3,1,8,Potential
20494,331,2,14.98,1,2,1,4,At Risk
20495,225,4,2482.23,2,4,4,10,Loyal
20496,191,2,2478.3399999999997,3,2,4,9,Potential
20497,335,1,69.99,1,1,2,4,At Risk
20498,183,2,12.940000000000001,3,2,1,6,At Risk
20499,18,2,54.980000000000004,5,2,2,9,Recent Customer
20500,281,2,68.49,2,2,2,6,At Risk
20501,185,2,64.98,3,2,2,7,Potential
20502,284,2,64.98,2,2,2,6,At Risk
20503,287,2,14.98,2,2,1,5,At Risk
20504,146,4,119.96000000000001,3,4,3,10,Loyal
20505,300,3,64.97,1,3,2,6,At Risk
20506,332,3,68.97,1,3,2,6,At Risk
20507,229,3,49.970000000000006,2,3,2,7,Potential
20508,29,1,21.98,5,1,1,7,Recent Customer
20509,273,1,9.99,2,1,1,4,At Risk
20510,18,3,72.93,5,3,2,10,Recent Customer
20511,72,2,14.98,5,2,1,8,Potential
20512,309,1,9.99,1,1,1,3,At Risk
20513,306,4,74.46,1,4,2,7,Potential
20514,126,3,49.970000000000006,4,3,2,9,Potential
20515,223,4,74.46,2,4,2,8,Potential
20516,109,2,14.98,4,2,1,7,Potential
20517,223,2,76.97,2,2,2,6,At Risk
20518,168,3,49.970000000000006,3,3,2,8,Potential
20519,61,4,54.96000000000001,5,4,2,11,Loyal
20520,306,2,14.98,1,2,1,4,At Risk
20521,53,4,25.22,5,4,1,10,Loyal
20522,166,2,44.980000000000004,3,2,2,7,Potential
20523,63,2,14.98,5,2,1,8,Potential
20524,246,3,68.97,2,3,2,7,Potential
20525,203,2,1155.48,3,2,3,8,Potential
20526,186,2,1170.48,3,2,4,9,Potential
20527,191,2,2478.3399999999997,3,2,4,9,Potential
20528,329,3,64.47,1,3,2,6,At Risk
20529,207,2,1174.48,2,2,4,8,Potential
20530,274,4,103.96000000000001,2,4,3,9,Potential
20531,67,3,64.97,5,3,2,10,Loyal
20532,51,4,93.46,5,4,3,12,Loyal
20533,178,4,31.92,3,4,1,8,Potential
20534,133,3,23.97,4,3,1,8,Potential
20535,101,2,14.98,4,2,1,7,Potential
20536,101,3,23.97,4,3,1,8,Potential
20537,365,3,23.97,1,3,1,5,At Risk
20538,110,3,68.97,4,3,2,9,Potential
20539,128,2,14.98,4,2,1,7,Potential
20540,53,1,9.99,5,1,1,7,Potential
20541,206,2,1174.48,3,2,4,9,Potential
20542,167,4,93.46,3,4,3,10,Loyal
20543,183,4,2492.3199999999997,3,4,4,11,Loyal
20544,207,3,2457.3299999999995,2,3,4,9,Potential
20545,168,5,2542.31,3,5,4,12,Loyal
20546,76,6,3246.5481999999997,4,5,4,13,Champions
20547,147,2,56.97,3,2,2,7,Potential
20548,69,5,3131.95,5,5,4,14,Champions
20549,92,3,3105.2699999999995,4,3,4,11,Loyal
20550,264,1,24.99,2,1,1,4,At Risk
20551,4,3,64.97,5,3,2,10,Recent Customer
20552,57,4,3034.0681999999997,5,4,4,13,Champions
20553,66,2,2354.9799999999996,5,2,4,11,Loyal
20554,277,2,34.98,2,2,1,5,At Risk
20555,83,4,3153.95,4,4,4,12,Loyal
20556,88,3,3124.96,4,3,4,11,Loyal
20557,115,3,64.97,4,3,2,9,Potential
20558,48,2,3019.0881999999997,5,2,4,11,Loyal
20559,320,2,74.98,1,2,2,5,At Risk
20560,84,6,3161.9399999999996,4,5,4,13,Champions
20561,41,3,3139.0881999999997,5,3,4,12,Loyal
20562,38,2,2994.0881999999997,5,2,4,11,Loyal
20563,230,2,34.98,2,2,1,5,At Risk
20564,55,4,3059.0781999999995,5,4,4,13,Champions
20565,204,3,64.97,3,3,2,8,Potential
20566,206,2,27.279999999999998,3,2,1,6,At Risk
20567,59,3,3074.0781999999995,5,3,4,12,Loyal
20568,246,2,28.979999999999997,2,2,1,5,At Risk
20569,47,5,3114.0582,5,5,4,14,Champions
20570,287,4,114.96000000000001,2,4,3,9,Potential
20571,115,1,24.99,4,1,1,6,At Risk
20572,163,4,78.96000000000001,3,4,2,9,Potential
20573,71,2,2414.99,5,2,4,11,Loyal
20574,275,2,38.98,2,2,1,5,At Risk
20575,45,6,3095.0382,5,5,4,14,Champions
20576,57,4,3147.9599999999996,5,4,4,13,Champions
20577,56,3,3080.2699999999995,5,3,4,12,Loyal
20578,40,3,31.27,5,3,1,9,Potential
20579,57,1,24.99,5,1,1,7,Potential
20580,322,3,36.93,1,3,1,5,At Risk
20581,89,2,2439.99,4,2,4,10,Loyal
20582,186,5,142.45,3,5,3,11,Loyal
20583,235,3,69.97,2,3,2,7,Potential
20584,65,4,3140.2699999999995,5,4,4,13,Champions
20585,155,3,32.269999999999996,3,3,1,7,Potential
20586,245,1,24.99,2,1,1,4,At Risk
20587,88,5,2378.95,4,5,4,13,Champions
20588,344,2,27.279999999999998,1,2,1,4,At Risk
20589,80,4,2344.9599999999996,4,4,4,12,Loyal
20590,75,4,3127.25,4,4,4,12,Loyal
20591,337,3,69.97,1,3,2,6,At Risk
20592,45,4,3113.2199999999993,5,4,4,13,Champions
20593,154,3,31.27,3,3,1,7,Potential
20594,305,3,42.93,1,3,2,6,At Risk
20595,203,3,69.97,3,3,2,8,Potential
20596,306,3,32.269999999999996,1,3,1,5,At Risk
20597,233,4,119.96000000000001,2,4,3,9,Potential
20598,77,3,3099.96,4,3,4,11,Loyal
20599,169,3,32.269999999999996,3,3,1,7,Potential
20600,195,3,6056.61,3,3,5,11,Loyal
20601,1,3,80.47,5,3,2,10,Recent Customer
20602,294,3,80.47,1,3,2,6,At Risk
20603,282,2,23.779999999999998,2,2,1,5,At Risk
20604,151,2,93.49,3,2,3,8,Potential
20605,279,4,84.96000000000001,2,4,2,8,Potential
20606,194,3,6054.219999999999,3,3,5,11,Loyal
20607,45,2,23.779999999999998,5,2,1,8,Potential
20608,186,4,6035.599999999999,3,4,5,12,Loyal
20609,209,6,6117.69,2,5,5,12,Loyal
20610,190,2,6021.62,3,2,5,10,Loyal
20611,185,2,6021.62,3,2,5,10,Loyal
20612,207,5,6060.5,2,5,5,12,Loyal
20613,198,3,6056.61,3,3,5,11,Loyal
20614,202,4,6035.599999999999,3,4,5,12,Loyal
20615,210,5,6060.5,2,5,5,12,Loyal
20616,210,5,6093.2,2,5,5,12,Loyal
20617,164,4,6058.21,3,4,5,12,Loyal
20618,330,1,21.49,1,1,1,3,At Risk
20619,85,3,74.98,4,3,2,9,Potential
20620,158,5,6044.59,3,5,5,13,Champions
20621,175,6,6117.69,3,5,5,13,Champions
20622,171,5,6139.59,3,5,5,13,Champions
20623,158,5,6093.2,3,5,5,13,Champions
20624,156,2,6021.62,3,2,5,10,Loyal
20625,174,3,6029.57,3,3,5,11,Loyal
20626,167,4,6038.5599999999995,3,4,5,12,Loyal
20627,159,5,6044.59,3,5,5,13,Champions
20628,177,3,6056.61,3,3,5,11,Loyal
20629,182,5,6060.5,3,5,5,13,Champions
20630,89,3,74.98,4,3,2,9,Potential
20631,214,4,71.96000000000001,2,4,2,8,Potential
20632,126,1,21.98,4,1,1,6,At Risk
20633,117,3,68.97,4,3,2,9,Potential
20634,297,1,9.99,1,1,1,3,At Risk
20635,198,3,49.970000000000006,3,3,2,8,Potential
20636,329,2,14.98,1,2,1,4,At Risk
20637,262,1,9.99,2,1,1,4,At Risk
20638,170,3,2478.24,3,3,4,10,Loyal
20639,163,4,2466.3199999999997,3,4,4,11,Loyal
20640,165,2,2498.3399999999997,3,2,4,9,Potential
20641,134,3,2457.3299999999995,3,3,4,10,Loyal
20642,105,2,2452.3399999999997,4,2,4,10,Loyal
20643,154,2,14.98,3,2,1,6,At Risk
20644,92,3,2457.3299999999995,4,3,4,11,Loyal
20645,173,4,1143.46,3,4,3,10,Loyal
20646,158,4,1197.97,3,4,4,11,Loyal
20647,169,2,1155.48,3,2,3,8,Potential
20648,62,3,2457.3299999999995,5,3,4,12,Loyal
20649,43,4,2487.89,5,4,4,13,Champions
20650,177,2,1174.48,3,2,4,9,Potential
20651,84,4,3198.5681999999997,4,4,4,12,Loyal
20652,164,2,1174.48,3,2,4,9,Potential
20653,180,2,1155.48,3,2,3,8,Potential
20654,166,2,1170.48,3,2,4,9,Potential
20655,150,4,47.42,3,4,2,9,Potential
20656,76,3,3245.8996,4,3,4,11,Loyal
20657,163,5,1193.45,3,5,4,12,Loyal
20658,55,3,2457.3299999999995,5,3,4,12,Loyal
20659,35,4,2466.3199999999997,5,4,4,13,Champions
20660,182,3,1179.97,3,3,4,10,Loyal
20661,168,2,1174.48,3,2,4,9,Potential
20662,397,2,1750.98,1,2,4,7,Potential
20663,341,2,1750.98,1,2,4,7,Potential
20664,317,4,1764.96,1,4,4,9,Potential
20665,48,5,4408.5581999999995,5,5,5,15,Champions
20666,335,3,1714.97,1,3,4,8,Potential
20667,293,3,1775.97,1,3,4,8,Potential
20668,277,2,1750.98,2,2,4,8,Potential
20669,56,2,3169.5882,5,2,4,11,Loyal
20670,44,4,3228.5681999999997,5,4,4,13,Champions
20671,285,2,1735.98,2,2,4,8,Potential
20672,268,2,1750.98,2,2,4,8,Potential
20673,221,2,1754.98,2,2,4,8,Potential
20674,180,4,1143.46,3,4,3,10,Loyal
20675,180,2,1155.48,3,2,3,8,Potential
20676,291,2,14.98,1,2,1,4,At Risk
20677,176,4,1184.46,3,4,4,11,Loyal
20678,169,2,1155.48,3,2,3,8,Potential
20679,310,3,64.47,1,3,2,6,At Risk
20680,34,3,3219.5782,5,3,4,12,Loyal
20681,362,1,9.99,1,1,1,3,At Risk
20682,202,2,1735.98,3,2,4,9,Potential
20683,212,2,1735.98,2,2,4,8,Potential
20684,188,3,1729.97,3,3,4,10,Loyal
20685,155,2,1155.48,3,2,3,8,Potential
20686,178,4,1151.76,3,4,3,10,Loyal
20687,96,1,9.99,4,1,1,6,At Risk
20688,12,3,68.97,5,3,2,10,Recent Customer
20689,242,3,78.48,2,3,2,7,Potential
20690,46,3,39.47,5,3,1,9,Potential
20691,312,2,39.980000000000004,1,2,1,4,At Risk
20692,117,3,49.970000000000006,4,3,2,9,Potential
20693,155,2,1155.48,3,2,3,8,Potential
20694,334,3,146.97,1,3,3,7,Potential
20695,35,2,14.98,5,2,1,8,Potential
20696,359,4,73.96000000000001,1,4,2,7,Potential
20697,49,4,77.92,5,4,2,11,Loyal
20698,247,3,23.97,2,3,1,6,At Risk
20699,178,3,1209.47,3,3,4,10,Loyal
20700,178,6,1243.44,3,5,4,12,Loyal
20701,155,2,1155.48,3,2,3,8,Potential
20702,193,2,1750.98,3,2,4,9,Potential
20703,174,2,1735.98,3,2,4,9,Potential
20704,120,4,77.96000000000001,4,4,2,10,Loyal
20705,303,3,69.47,1,3,2,6,At Risk
20706,154,3,1759.97,3,3,4,10,Loyal
20707,163,2,1750.98,3,2,4,9,Potential
20708,53,4,4406.3996,5,4,5,14,Champions
20709,177,3,1729.97,3,3,4,10,Loyal
20710,278,4,3240.3199999999997,2,4,4,10,Loyal
20711,248,4,3240.3199999999997,2,4,4,10,Loyal
20712,234,3,3261.33,2,3,4,9,Potential
20713,64,5,3421.9300000000003,5,5,5,15,Champions
20714,323,3,187.98,1,3,3,7,Potential
20715,174,4,196.27,3,4,3,10,Loyal
20716,50,6,3911.2899999999995,5,5,5,15,Champions
20717,215,4,3240.3199999999997,2,4,4,10,Loyal
20718,90,4,3283.4300000000003,4,4,5,13,Champions
20719,253,4,1947.46,2,4,4,10,Loyal
20720,250,3,1938.47,2,3,4,9,Potential
20721,173,1,24.99,3,1,1,5,At Risk
20722,257,6,2378.8,2,5,4,11,Loyal
20723,193,4,143.96,3,4,3,10,Loyal
20724,189,1,24.99,3,1,1,5,At Risk
20725,45,3,63.97,5,3,2,10,Loyal
20726,242,5,1941.95,2,5,4,11,Loyal
20727,72,2,30.479999999999997,5,2,1,8,Potential
20728,238,4,709.26,2,4,3,9,Potential
20729,223,4,77.96000000000001,2,4,2,8,Potential
20730,240,3,68.97,2,3,2,7,Potential
20731,305,3,42.97,1,3,2,6,At Risk
20732,330,1,9.99,1,1,1,3,At Risk
20733,249,3,23.97,2,3,1,6,At Risk
20734,246,2,7.28,2,2,1,5,At Risk
20735,167,1,1120.49,3,1,3,7,Potential
20736,39,3,3194.5782,5,3,4,12,Loyal
20737,8,3,128.97,5,3,3,11,Recent Customer
20738,124,3,23.97,4,3,1,8,Potential
20739,325,2,78.97999999999999,1,2,2,5,At Risk
20740,140,5,140.94,3,5,3,11,Loyal
20741,280,2,119.97999999999999,2,2,3,7,Potential
20742,116,3,128.97,4,3,3,10,Loyal
20743,91,2,78.97999999999999,4,2,2,8,Potential
20744,54,2,548.98,5,2,3,10,Loyal
20745,5,5,113.94999999999999,5,5,3,13,Recent Customer
20746,204,5,119.95,3,5,3,11,Loyal
20747,56,1,69.99,5,1,2,8,Potential
20748,288,2,123.97999999999999,2,2,3,7,Potential
20749,61,3,624.97,5,3,3,11,Loyal
20750,159,4,1184.46,3,4,4,11,Loyal
20751,47,2,574.98,5,2,3,10,Loyal
20752,110,1,69.99,4,1,2,7,Potential
20753,39,1,539.99,5,1,3,9,Potential
20754,152,2,78.97999999999999,3,2,2,7,Potential
20755,165,3,1164.47,3,3,4,10,Loyal
20756,67,4,34.56,5,4,1,10,Loyal
20757,28,1,69.99,5,1,2,8,Recent Customer
20758,285,3,128.97,2,3,3,8,Potential
20759,223,4,77.96000000000001,2,4,2,8,Potential
20760,86,2,7.28,4,2,1,7,Potential
20761,257,3,22.93,2,3,1,6,At Risk
20762,45,2,123.97999999999999,5,2,3,10,Loyal
20763,224,2,123.97999999999999,2,2,3,7,Potential
20764,181,4,56.76,3,4,2,9,Potential
20765,170,3,1179.97,3,3,4,10,Loyal
20766,306,2,14.98,1,2,1,4,At Risk
20767,126,1,1120.49,4,1,3,8,Potential
20768,132,2,1170.48,4,2,4,10,Loyal
20769,261,4,25.22,2,4,1,7,Potential
20770,80,3,49.970000000000006,4,3,2,9,Potential
20771,82,2,46.47,4,2,2,8,Potential
20772,12,3,72.93,5,3,2,10,Recent Customer
20773,53,2,30.97,5,2,1,8,Potential
20774,116,3,22.93,4,3,1,8,Potential
20775,17,1,9.99,5,1,1,7,Recent Customer
20776,256,3,22.93,2,3,1,6,At Risk
20777,20,1,9.99,5,1,1,7,Recent Customer
20778,33,4,74.46,5,4,2,11,Loyal
20779,347,2,14.98,1,2,1,4,At Risk
20780,194,1,9.99,3,1,1,5,At Risk
20781,132,3,15.23,4,3,1,8,Potential
20782,141,5,1197.41,3,5,4,12,Loyal
20783,67,2,39.980000000000004,5,2,1,8,Potential
20784,6,1,9.99,5,1,1,7,Recent Customer
20785,146,2,1145.48,3,2,3,8,Potential
20786,104,2,14.98,4,2,1,7,Potential
20787,133,3,1134.47,4,3,3,10,Loyal
20788,16,1,9.99,5,1,1,7,Recent Customer
20789,292,3,39.47,1,3,1,5,At Risk
20790,193,2,14.98,3,2,1,6,At Risk
20791,242,1,9.99,2,1,1,4,At Risk
20792,122,2,39.980000000000004,4,2,1,7,Potential
20793,158,3,1205.47,3,3,4,10,Loyal
20794,89,2,53.980000000000004,4,2,2,8,Potential
20795,204,1,3.99,3,1,1,5,At Risk
20796,229,3,88.97,2,3,2,7,Potential
20797,234,3,14.23,2,3,1,6,At Risk
20798,204,4,123.96000000000001,3,4,3,10,Loyal
20799,26,2,32.28,5,2,1,8,Recent Customer
20800,76,3,63.97,4,3,2,9,Potential
20801,223,2,74.98,2,2,2,6,At Risk
20802,233,2,6.28,2,2,1,5,At Risk
20803,138,2,38.980000000000004,3,2,1,6,At Risk
20804,190,1,24.99,3,1,1,5,At Risk
20805,131,1,29.99,4,1,1,6,At Risk
20806,206,2,27.279999999999998,3,2,1,6,At Risk
20807,32,5,3249.31,5,5,4,14,Champions
20808,217,3,1938.47,2,3,4,9,Potential
20809,155,2,32.28,3,2,1,6,At Risk
20810,152,2,6.28,3,2,1,6,At Risk
20811,242,4,3270.3199999999997,2,4,4,10,Loyal
20812,335,3,4127.25,1,3,5,9,Potential
20813,16,3,64.47,5,3,2,10,Recent Customer
20814,321,5,4186.23,1,5,5,11,Loyal
20815,329,2,4118.26,1,2,5,8,Potential
20816,319,6,4228.719999999999,1,5,5,11,Loyal
20817,320,2,4118.26,1,2,5,8,Potential
20818,320,6,4230.73,1,5,5,11,Loyal
20819,322,3,4181.76,1,3,5,9,Potential
20820,322,4,4143.74,1,4,5,10,Loyal
20821,306,2,4118.26,1,2,5,8,Potential
20822,326,5,4134.53,1,5,5,11,Loyal
20823,303,4,4216.75,1,4,5,10,Loyal
20824,396,4,2512.96,1,4,4,9,Potential
20825,203,2,3226.34,3,2,4,9,Potential
20826,182,4,1173.96,3,4,4,11,Loyal
20827,185,2,11.940000000000001,3,2,1,6,At Risk
20828,217,3,1938.47,2,3,4,9,Potential
20829,231,4,1962.46,2,4,4,10,Loyal
20830,218,4,1966.46,2,4,4,10,Loyal
20831,225,5,2012.95,2,5,4,11,Loyal
20832,370,3,2533.9700000000003,1,3,4,8,Potential
20833,241,2,1903.48,2,2,4,8,Potential
20834,381,5,2566.95,1,5,4,10,Loyal
20835,164,6,2002.44,3,5,4,12,Loyal
20836,163,3,1938.47,3,3,4,10,Loyal
20837,368,5,2547.95,1,5,4,10,Loyal
20838,349,6,2541.94,1,5,4,10,Loyal
20839,355,4,2511.26,1,4,4,9,Potential
20840,158,1,3.99,3,1,1,5,At Risk
20841,174,3,1938.47,3,3,4,10,Loyal
20842,145,5,1952.45,3,5,4,12,Loyal
20843,140,2,1903.48,3,2,4,9,Potential
20844,166,2,1155.48,3,2,3,8,Potential
20845,142,3,1957.47,3,3,4,10,Loyal
20846,155,2,1174.48,3,2,4,9,Potential
20847,135,4,1947.46,3,4,4,11,Loyal
20848,338,4,2558.46,1,4,4,9,Potential
20849,118,3,69.97,4,3,2,9,Potential
20850,320,6,2556.94,1,5,4,10,Loyal
20851,287,3,2518.97,2,3,4,9,Potential
20852,288,4,2546.96,2,4,4,10,Loyal
20853,164,3,1147.77,3,3,3,9,Potential
20854,135,3,1938.47,3,3,4,10,Loyal
20855,178,2,1155.48,3,2,3,8,Potential
20856,287,2,2483.98,2,2,4,8,Potential
20857,140,1,1120.49,3,1,3,7,Potential
20858,152,2,1155.48,3,2,3,8,Potential
20859,257,3,2508.9700000000003,2,3,4,9,Potential
20860,231,5,2379.81,2,5,4,11,Loyal
20861,228,9,2368.06,2,5,4,11,Loyal
20862,192,4,3240.3199999999997,3,4,4,11,Loyal
20863,159,3,3261.33,3,3,4,10,Loyal
20864,137,3,3234.29,3,3,4,10,Loyal
20865,181,2,34.98,3,2,1,6,At Risk
20866,45,3,3157.9699999999993,5,3,4,12,Loyal
20867,120,2,38.980000000000004,4,2,1,7,Potential
20868,300,3,37.269999999999996,1,3,1,5,At Risk
20869,251,4,2542.96,2,4,4,10,Loyal
20870,135,3,1938.47,3,3,4,10,Loyal
20871,304,4,78.96000000000001,1,4,2,7,Potential
20872,252,3,2518.97,2,3,4,9,Potential
20873,269,3,42.93,2,3,2,7,Potential
20874,122,4,1962.46,4,4,4,12,Loyal
20875,253,3,2518.97,2,3,4,9,Potential
20876,100,3,1938.47,4,3,4,11,Loyal
20877,133,1,1120.49,4,1,3,8,Potential
20878,102,2,1155.48,4,2,3,9,Potential
20879,129,6,3284.2999999999997,4,5,5,14,Champions
20880,259,3,2518.97,2,3,4,9,Potential
20881,117,4,78.96000000000001,4,4,2,10,Loyal
20882,78,2,1170.48,4,2,4,10,Loyal
20883,74,3,1149.47,4,3,3,10,Loyal
20884,82,4,1229.96,4,4,4,12,Loyal
20885,253,3,2518.97,2,3,4,9,Potential
20886,269,3,2533.9700000000003,2,3,4,9,Potential
20887,80,3,1164.47,4,3,4,11,Loyal
20888,76,2,1174.48,4,2,4,10,Loyal
20889,175,3,69.97,3,3,2,8,Potential
20890,222,4,2527.96,2,4,4,10,Loyal
20891,241,2,589.98,2,2,3,7,Potential
20892,114,4,3240.3199999999997,4,4,4,12,Loyal
20893,48,2,34.98,5,2,1,8,Potential
20894,66,2,1155.48,5,2,3,10,Loyal
20895,59,1,1120.49,5,1,3,9,Potential
20896,110,3,1957.47,4,3,4,11,Loyal
20897,101,3,88.97,4,3,2,9,Potential
20898,101,2,51.97,4,2,2,8,Potential
20899,10,2,6.28,5,2,1,8,Recent Customer
20900,125,4,78.96000000000001,4,4,2,10,Loyal
20901,51,1,1120.49,5,1,3,9,Potential
20902,14,3,37.269999999999996,5,3,1,9,Recent Customer
20903,247,3,69.97,2,3,2,7,Potential
20904,29,3,69.97,5,3,2,10,Recent Customer
20905,41,2,1155.48,5,2,3,10,Loyal
20906,54,2,32.28,5,2,1,8,Potential
20907,169,2,32.28,3,2,1,6,At Risk
20908,241,4,78.96000000000001,2,4,2,8,Potential
20909,294,3,69.97,1,3,2,6,At Risk
20910,126,5,613.95,4,5,3,12,Loyal
20911,78,3,611.96,4,3,3,10,Loyal
20912,113,7,2373.79,4,5,4,13,Champions
20913,96,4,1947.46,4,4,4,12,Loyal
20914,108,5,1926.45,4,5,4,13,Champions
20915,40,2,38.980000000000004,5,2,1,8,Potential
20916,226,4,119.96000000000001,2,4,3,9,Potential
20917,98,3,3234.29,4,3,4,11,Loyal
20918,128,2,67.49,4,2,2,8,Potential
20919,21,2,6.28,5,2,1,8,Recent Customer
20920,16,2,6.28,5,2,1,8,Recent Customer
20921,93,3,3234.29,4,3,4,11,Loyal
20922,82,2,3226.34,4,2,4,10,Loyal
20923,116,6,2374.8,4,5,4,13,Champions
20924,215,3,69.97,2,3,2,7,Potential
20925,145,2,67.49,3,2,2,7,Potential
20926,43,1,1120.49,5,1,3,9,Potential
20927,80,5,101.94,4,5,3,12,Loyal
20928,93,3,40.23,4,3,2,9,Potential
20929,328,3,37.269999999999996,1,3,1,5,At Risk
20930,66,7,2363.79,5,5,4,14,Champions
20931,52,6,3273.17,5,5,5,15,Champions
20932,78,3,47.97,4,3,2,9,Potential
20933,232,3,2518.97,2,3,4,9,Potential
20934,46,2,1145.48,5,2,3,10,Loyal
20935,79,2,162.99,4,2,3,9,Potential
20936,34,3,1134.47,5,3,3,11,Loyal
20937,147,4,119.96000000000001,3,4,3,10,Loyal
20938,21,3,84.97,5,3,2,10,Recent Customer
20939,73,2,13.98,5,2,1,8,Potential
20940,351,2,38.980000000000004,1,2,1,4,At Risk
20941,342,3,126.28,1,3,3,7,Potential
20942,310,1,3.99,1,1,1,3,At Risk
20943,124,3,37.269999999999996,4,3,1,8,Potential
20944,357,3,226.49,1,3,3,7,Potential
20945,109,3,1953.47,4,3,4,11,Loyal
20946,137,2,58.980000000000004,3,2,2,7,Potential
20947,4,3,37.269999999999996,5,3,1,9,Recent Customer
20948,311,1,3.99,1,1,1,3,At Risk
20949,305,3,154.98,1,3,3,7,Potential
20950,268,2,32.28,2,2,1,5,At Risk
20951,171,3,37.269999999999996,3,3,1,7,Potential
20952,46,3,37.269999999999996,5,3,1,9,Potential
20953,72,2,162.99,5,2,3,10,Loyal
20954,136,2,38.980000000000004,3,2,1,6,At Risk
20955,57,3,1164.47,5,3,4,12,Loyal
20956,84,1,3.99,4,1,1,6,At Risk
20957,222,2,38.980000000000004,2,2,1,5,At Risk
20958,365,2,68.49,1,2,2,5,At Risk
20959,88,2,38.980000000000004,4,2,1,7,Potential
20960,256,2,6.28,2,2,1,5,At Risk
20961,37,1,3.99,5,1,1,7,Potential
20962,292,2,6.28,1,2,1,4,At Risk
20963,329,3,42.93,1,3,2,6,At Risk
20964,152,2,38.980000000000004,3,2,1,6,At Risk
20965,206,1,29.99,3,1,1,5,At Risk
20966,51,1,1120.49,5,1,3,9,Potential
20967,241,1,4.99,2,1,1,4,At Risk
20968,202,2,34.98,3,2,1,6,At Risk
20969,260,2,38.980000000000004,2,2,1,5,At Risk
20970,91,4,1962.46,4,4,4,12,Loyal
20971,88,2,38.980000000000004,4,2,1,7,Potential
20972,105,3,69.97,4,3,2,9,Potential
20973,145,3,193.98,3,3,3,9,Potential
20974,211,3,126.28,2,3,3,8,Potential
20975,218,5,2515.25,2,5,4,11,Loyal
20976,181,3,60.47,3,3,2,8,Potential
20977,376,2,574.98,1,2,3,6,At Risk
20978,181,1,4.99,3,1,1,5,At Risk
20979,86,4,1947.46,4,4,4,12,Loyal
20980,77,4,1981.96,4,4,4,12,Loyal
20981,357,2,68.49,1,2,2,5,At Risk
20982,394,4,2546.96,1,4,4,9,Potential
20983,278,5,4178.73,2,5,5,12,Loyal
20984,303,3,4153.25,1,3,5,9,Potential
20985,299,2,4118.26,1,2,5,8,Potential
20986,116,2,7.28,4,2,1,7,Potential
20987,289,4,4132.24,1,4,5,10,Loyal
20988,303,2,4118.26,1,2,5,8,Potential
20989,277,4,4148.74,2,4,5,11,Loyal
20990,293,6,4196.219999999999,1,5,5,11,Loyal
20991,277,2,4118.26,2,2,5,9,Potential
20992,299,3,4139.75,1,3,5,9,Potential
20993,280,5,4262.04,2,5,5,12,Loyal
20994,302,6,4191.72,1,5,5,11,Loyal
20995,281,3,4127.25,2,3,5,10,Loyal
20996,292,5,4149.99,1,5,5,11,Loyal
20997,298,5,2744.5225,1,5,4,10,Loyal
20998,280,6,2806.5125,2,5,4,11,Loyal
20999,289,4,2735.5325,1,4,4,9,Potential
21000,247,2,2721.5525,2,2,4,8,Potential
21001,274,3,3018.33,2,3,4,9,Potential
21002,246,3,2992.33,2,3,4,9,Potential
21003,353,3,49.97,1,3,2,6,At Risk
21004,388,2,561.48,1,2,3,6,At Risk
21005,169,2,25.479999999999997,3,2,1,6,At Risk
21006,71,3,1938.47,5,3,4,12,Loyal
21007,118,2,58.980000000000004,4,2,2,8,Potential
21008,87,3,1957.47,4,3,4,11,Loyal
21009,55,2,39.980000000000004,5,2,1,8,Potential
21010,226,1,4.99,2,1,1,4,At Risk
21011,225,4,2527.96,2,4,4,10,Loyal
21012,228,4,2497.96,2,4,4,10,Loyal
21013,367,2,548.98,1,2,3,6,At Risk
21014,378,4,607.96,1,4,3,8,Potential
21015,79,3,1957.47,4,3,4,11,Loyal
21016,92,3,1938.47,4,3,4,11,Loyal
21017,382,4,578.46,1,4,3,8,Potential
21018,244,5,2515.25,2,5,4,11,Loyal
21019,90,4,629.96,4,4,3,11,Loyal
21020,243,4,2497.96,2,4,4,10,Loyal
21021,358,4,628.97,1,4,3,8,Potential
21022,344,1,539.99,1,1,3,5,At Risk
21023,258,4,91.95,2,4,2,8,Potential
21024,346,4,562.96,1,4,3,8,Potential
21025,95,3,69.97,4,3,2,9,Potential
21026,270,2,38.98,2,2,1,5,At Risk
21027,238,3,2537.97,2,3,4,9,Potential
21028,133,3,37.269999999999996,4,3,1,8,Potential
21029,82,5,1934.75,4,5,4,13,Champions
21030,353,1,539.99,1,1,3,5,At Risk
21031,349,5,597.95,1,5,3,9,Potential
21032,78,1,4.99,4,1,1,6,At Risk
21033,352,3,553.97,1,3,3,7,Potential
21034,231,3,2533.9700000000003,2,3,4,9,Potential
21035,86,3,1957.47,4,3,4,11,Loyal
21036,243,5,2547.95,2,5,4,11,Loyal
21037,56,8,2438.28,5,5,4,14,Champions
21038,57,2,573.98,5,2,3,10,Loyal
21039,371,2,2483.98,1,2,4,7,Potential
21040,370,5,2566.95,1,5,4,10,Loyal
21041,359,4,589.96,1,4,3,8,Potential
21042,92,2,1155.48,4,2,3,9,Potential
21043,152,2,39.980000000000004,3,2,1,6,At Risk
21044,239,3,2533.9700000000003,2,3,4,9,Potential
21045,57,2,23.779999999999998,5,2,1,8,Potential
21046,166,2,34.98,3,2,1,6,At Risk
21047,87,2,1155.48,4,2,3,9,Potential
21048,346,4,578.46,1,4,3,8,Potential
21049,197,2,32.28,3,2,1,6,At Risk
21050,349,3,583.97,1,3,3,7,Potential
21051,77,1,1120.49,4,1,3,8,Potential
21052,57,1,1120.49,5,1,3,9,Potential
21053,227,4,2542.96,2,4,4,10,Loyal
21054,47,3,625.47,5,3,3,11,Loyal
21055,52,7,1566.78,5,5,4,14,Champions
21056,371,5,2547.95,1,5,4,10,Loyal
21057,86,4,2394.9699999999993,4,4,4,12,Loyal
21058,220,4,69.46000000000001,2,4,2,8,Potential
21059,359,5,616.95,1,5,3,9,Potential
21060,188,3,2508.4700000000003,3,3,4,10,Loyal
21061,353,4,607.96,1,4,3,8,Potential
21062,322,3,563.77,1,3,3,7,Potential
21063,283,3,60.47,2,3,2,7,Potential
21064,315,3,553.97,1,3,3,7,Potential
21065,48,5,1549.1100000000001,5,5,4,14,Champions
21066,12,5,131.44,5,5,3,13,Recent Customer
21067,199,2,2483.98,3,2,4,9,Potential
21068,299,4,81.45,1,4,2,7,Potential
21069,75,3,69.97,4,3,2,9,Potential
21070,348,2,30.479999999999997,1,2,1,4,At Risk
21071,210,3,2533.9700000000003,2,3,4,9,Potential
21072,321,1,539.99,1,1,3,5,At Risk
21073,181,2,29.479999999999997,3,2,1,6,At Risk
21074,219,3,43.97,2,3,2,7,Potential
21075,288,2,59.980000000000004,2,2,2,6,At Risk
21076,67,1,4.99,5,1,1,7,Potential
21077,209,2,23.779999999999998,2,2,1,5,At Risk
21078,94,2,23.779999999999998,4,2,1,7,Potential
21079,190,3,37.269999999999996,3,3,1,7,Potential
21080,19,4,110.46000000000001,5,4,3,12,Recent Customer
21081,60,1,21.49,5,1,1,7,Potential
21082,191,4,98.96000000000001,3,4,3,10,Loyal
21083,8,2,38.98,5,2,1,8,Recent Customer
21084,288,3,27.77,2,3,1,6,At Risk
21085,20,2,39.980000000000004,5,2,1,8,Recent Customer
21086,168,3,48.970000000000006,3,3,2,8,Potential
21087,145,2,819.48,3,2,3,8,Potential
21088,299,2,30.479999999999997,1,2,1,4,At Risk
21089,292,2,561.48,1,2,3,6,At Risk
21090,305,2,548.98,1,2,3,6,At Risk
21091,193,2,13.98,3,2,1,6,At Risk
21092,350,4,2511.26,1,4,4,9,Potential
21093,333,5,2515.25,1,5,4,10,Loyal
21094,85,3,60.47,4,3,2,9,Potential
21095,278,3,31.729999999999997,2,3,1,6,At Risk
21096,95,2,13.98,4,2,1,7,Potential
21097,163,2,29.479999999999997,3,2,1,6,At Risk
21098,180,4,69.46000000000001,3,4,2,9,Potential
21099,261,1,21.49,2,1,1,4,At Risk
21100,49,5,1178.45,5,5,4,14,Champions
21101,130,2,32.28,4,2,1,7,Potential
21102,148,4,793.46,3,4,3,10,Loyal
21103,317,5,2506.95,1,5,4,10,Loyal
21104,257,5,2566.95,2,5,4,11,Loyal
21105,264,3,2533.9700000000003,2,3,4,9,Potential
21106,270,3,2537.97,2,3,4,9,Potential
21107,141,4,806.76,3,4,3,10,Loyal
21108,140,2,819.48,3,2,3,8,Potential
21109,79,2,39.980000000000004,4,2,1,7,Potential
21110,349,2,34.98,1,2,1,4,At Risk
21111,355,3,37.269999999999996,1,3,1,5,At Risk
21112,243,2,25.479999999999997,2,2,1,5,At Risk
21113,27,2,23.779999999999998,5,2,1,8,Recent Customer
21114,307,1,4.99,1,1,1,3,At Risk
21115,283,1,4.99,2,1,1,4,At Risk
21116,93,4,78.96000000000001,4,4,2,10,Loyal
21117,161,3,60.47,3,3,2,8,Potential
21118,197,2,34.98,3,2,1,6,At Risk
21119,124,2,25.479999999999997,4,2,1,7,Potential
21120,361,3,48.970000000000006,1,3,2,6,At Risk
21121,288,1,21.49,2,1,1,4,At Risk
21122,293,3,143.78,1,3,3,7,Potential
21123,108,2,30.479999999999997,4,2,1,7,Potential
21124,47,3,56.96,5,3,2,10,Loyal
21125,150,3,27.77,3,3,1,7,Potential
21126,282,3,565.47,2,3,3,8,Potential
21127,168,3,60.47,3,3,2,8,Potential
21128,215,1,4.99,2,1,1,4,At Risk
21129,42,3,48.970000000000006,5,3,2,10,Loyal
21130,230,2,2483.98,2,2,4,8,Potential
21131,217,2,39.980000000000004,2,2,1,5,At Risk
21132,238,1,21.49,2,1,1,4,At Risk
21133,98,1,21.49,4,1,1,6,At Risk
21134,264,3,69.97,2,3,2,7,Potential
21135,284,5,103.95,2,5,3,10,Loyal
21136,234,6,106.92999999999999,2,5,3,10,Loyal
21137,103,3,37.269999999999996,4,3,1,8,Potential
21138,56,3,4371.3782,5,3,5,13,Champions
21139,157,2,1735.98,3,2,4,9,Potential
21140,252,2,14.98,2,2,1,5,At Risk
21141,123,2,1155.48,4,2,3,9,Potential
21142,38,4,77.92,5,4,2,11,Loyal
21143,123,2,1155.48,4,2,3,9,Potential
21144,142,4,1188.46,3,4,4,11,Loyal
21145,90,3,69.97,4,3,2,9,Potential
21146,146,2,1155.48,3,2,3,8,Potential
21147,127,3,1179.97,4,3,4,11,Loyal
21148,53,3,3223.5782,5,3,4,12,Loyal
21149,138,3,1183.47,3,3,4,10,Loyal
21150,145,2,1170.48,3,2,4,9,Potential
21151,141,2,1155.48,3,2,3,8,Potential
21152,150,3,1134.47,3,3,3,9,Potential
21153,141,3,1147.77,3,3,3,9,Potential
21154,55,4,74.46,5,4,2,11,Loyal
21155,142,2,1155.48,3,2,3,8,Potential
21156,134,3,1149.47,3,3,3,9,Potential
21157,234,3,49.970000000000006,2,3,2,7,Potential
21158,331,3,49.970000000000006,1,3,2,6,At Risk
21159,343,4,74.46,1,4,2,7,Potential
21160,125,3,1775.47,4,3,4,11,Loyal
21161,129,2,1174.48,4,2,4,10,Loyal
21162,126,2,1155.48,4,2,3,9,Potential
21163,1,3,72.93,5,3,2,10,Recent Customer
21164,175,3,68.97,3,3,2,8,Potential
21165,174,5,4673.8825,3,5,5,13,Champions
21166,173,5,4909.67,3,5,5,13,Champions
21167,154,3,4657.512500000001,3,3,5,11,Loyal
21168,161,2,4624.9125,3,2,5,10,Loyal
21169,181,5,4647.8825,3,5,5,13,Champions
21170,111,3,74.98,4,3,2,9,Potential
21171,268,2,37.29,2,2,1,5,At Risk
21172,323,3,42.28,1,3,2,6,At Risk
21173,175,3,4659.9025,3,3,5,11,Loyal
21174,132,3,42.28,4,3,2,9,Potential
21175,192,1,35.0,3,1,1,5,At Risk
21176,364,1,35.0,1,1,1,3,At Risk
21177,176,2,39.99,3,2,2,7,Potential
21178,170,2,39.99,3,2,2,7,Potential
21179,172,5,4935.669999999999,3,5,5,13,Champions
21180,177,2,3882.5525,3,2,5,10,Loyal
21181,137,2,32.28,3,2,1,6,At Risk
21182,55,2,32.28,5,2,1,8,Potential
21183,168,3,4657.5125,3,3,5,11,Loyal
21184,155,3,74.98,3,3,2,8,Potential
21185,29,2,39.99,5,2,2,9,Recent Customer
21186,278,1,35.0,2,1,1,4,At Risk
21187,212,2,32.28,2,2,1,5,At Risk
21188,244,4,123.96000000000001,2,4,3,9,Potential
21189,171,5,4208.3099999999995,3,5,5,13,Champions
21190,355,3,42.28,1,3,2,6,At Risk
21191,160,3,4169.33,3,3,5,11,Loyal
21192,162,4,4229.32,3,4,5,12,Loyal
21193,150,5,3905.5225,3,5,5,13,Champions
21194,144,4,3911.5325000000003,3,4,5,12,Loyal
21195,153,2,4144.34,3,2,5,10,Loyal
21196,156,2,34.98,3,2,1,6,At Risk
21197,143,3,3917.5425,3,3,5,11,Loyal
21198,120,3,69.97,4,3,2,9,Potential
21199,135,2,4144.34,3,2,5,10,Loyal
21200,145,3,3932.5424999999996,3,3,5,11,Loyal
21201,167,3,4921.69,3,3,5,11,Loyal
21202,155,3,4632.8625,3,3,5,11,Loyal
21203,155,3,4633.9025,3,3,5,11,Loyal
21204,129,3,74.98,4,3,2,9,Potential
21205,178,2,4886.7,3,2,5,10,Loyal
21206,151,2,3882.5525,3,2,5,10,Loyal
21207,249,4,123.96000000000001,2,4,3,9,Potential
21208,276,2,39.980000000000004,2,2,1,5,At Risk
21209,144,2,39.99,3,2,2,7,Potential
21210,311,2,39.99,1,2,2,5,At Risk
21211,166,4,4900.679999999999,3,4,5,12,Loyal
21212,342,3,74.98,1,3,2,6,At Risk
21213,95,4,64.26,4,4,2,10,Loyal
21214,147,3,4659.9025,3,3,5,11,Loyal
21215,136,2,4624.9125,3,2,5,10,Loyal
21216,148,5,4935.669999999999,3,5,5,13,Champions
21217,136,3,4659.9025,3,3,5,11,Loyal
21218,147,4,4661.5025000000005,3,4,5,12,Loyal
21219,129,5,4696.4925,4,5,5,14,Champions
21220,305,3,74.98,1,3,2,6,At Risk
21221,184,1,29.99,3,1,1,5,At Risk
21222,147,3,3936.5425,3,3,5,11,Loyal
21223,310,2,56.980000000000004,1,2,2,5,At Risk
21224,113,3,42.28,4,3,2,9,Potential
21225,133,7,4732.862499999999,4,5,5,14,Champions
21226,144,4,4659.8025,3,4,5,12,Loyal
21227,127,2,26.97,4,2,1,7,Potential
21228,153,3,3936.5425,3,3,5,11,Loyal
21229,131,3,4198.33,4,3,5,12,Loyal
21230,130,4,4171.62,4,4,5,13,Champions
21231,101,3,3936.5425,4,3,5,12,Loyal
21232,41,2,39.980000000000004,5,2,1,8,Potential
21233,300,2,119.97999999999999,1,2,3,6,At Risk
21234,345,2,119.97999999999999,1,2,3,6,At Risk
21235,134,3,1134.47,3,3,3,9,Potential
21236,157,4,77.92,3,4,2,9,Potential
21237,170,1,69.99,3,1,2,6,At Risk
21238,11,5,39.55,5,5,1,11,Recent Customer
21239,213,2,7.28,2,2,1,5,At Risk
21240,315,2,119.97999999999999,1,2,3,6,At Risk
21241,264,2,78.97999999999999,2,2,2,6,At Risk
21242,323,2,78.97999999999999,1,2,2,5,At Risk
21243,176,2,14.98,3,2,1,6,At Risk
21244,239,3,49.970000000000006,2,3,2,7,Potential
21245,221,3,22.93,2,3,1,6,At Risk
21246,134,3,1194.97,3,3,4,10,Loyal
21247,117,2,14.98,4,2,1,7,Potential
21248,172,2,34.98,3,2,1,6,At Risk
21249,64,3,69.97,5,3,2,10,Loyal
21250,280,2,14.98,2,2,1,5,At Risk
21251,181,4,191.27,3,4,3,10,Loyal
21252,348,5,94.45,1,5,3,9,Potential
21253,127,2,1155.48,4,2,3,9,Potential
21254,352,3,89.97,1,3,2,6,At Risk
21255,327,2,32.28,1,2,1,4,At Risk
21256,100,3,3917.5425,4,3,5,12,Loyal
21257,108,2,4144.34,4,2,5,11,Loyal
21258,107,3,3936.5425,4,3,5,12,Loyal
21259,99,3,3907.5424999999996,4,3,5,12,Loyal
21260,124,2,14.98,4,2,1,7,Potential
21261,285,3,69.97,2,3,2,7,Potential
21262,54,3,68.97,5,3,2,10,Loyal
21263,237,1,4.99,2,1,1,4,At Risk
21264,140,1,1120.49,3,1,3,7,Potential
21265,147,3,1729.97,3,3,4,10,Loyal
21266,32,4,4525.0682,5,4,5,14,Champions
21267,144,2,1735.98,3,2,4,9,Potential
21268,114,2,1725.98,4,2,4,10,Loyal
21269,115,2,1735.98,4,2,4,10,Loyal
21270,207,3,78.48,2,3,2,7,Potential
21271,104,3,1728.27,4,3,4,11,Loyal
21272,32,5,4435.379599999999,5,5,5,15,Champions
21273,192,2,14.98,3,2,1,6,At Risk
21274,137,4,1197.97,3,4,4,11,Loyal
21275,105,4,1151.76,4,4,3,11,Loyal
21276,109,2,39.980000000000004,4,2,1,7,Potential
21277,109,1,4.99,4,1,1,6,At Risk
21278,30,2,14.98,5,2,1,8,Recent Customer
21279,181,1,4.99,3,1,1,5,At Risk
21280,50,3,39.47,5,3,1,9,Potential
21281,93,2,1129.48,4,2,3,9,Potential
21282,112,1,1120.49,4,1,3,8,Potential
21283,290,5,124.94,1,5,3,9,Potential
21284,36,3,3223.5782,5,3,4,12,Loyal
21285,258,2,14.98,2,2,1,5,At Risk
21286,75,3,68.97,4,3,2,9,Potential
21287,167,2,44.980000000000004,3,2,2,7,Potential
21288,277,2,14.98,2,2,1,5,At Risk
21289,78,3,1763.97,4,3,4,11,Loyal
21290,73,3,23.97,5,3,1,9,Potential
21291,41,2,1735.98,5,2,4,11,Loyal
21292,149,2,14.98,3,2,1,6,At Risk
21293,43,3,1763.97,5,3,4,12,Loyal
21294,292,1,9.99,1,1,1,3,At Risk
21295,82,2,56.97,4,2,2,8,Potential
21296,13,4,99.96000000000001,5,4,3,12,Recent Customer
21297,44,2,1735.98,5,2,4,11,Loyal
21298,309,4,93.46,1,4,3,8,Potential
21299,332,3,78.48,1,3,2,6,At Risk
21300,380,1,1120.49,1,1,3,5,At Risk
21301,10,2,14.98,5,2,1,8,Recent Customer
21302,252,3,69.97,2,3,2,7,Potential
21303,185,3,68.97,3,3,2,8,Potential
21304,252,3,23.97,2,3,1,6,At Risk
21305,41,3,3204.5782,5,3,4,12,Loyal
21306,55,1,4.99,5,1,1,7,Potential
21307,305,3,23.97,1,3,1,5,At Risk
21308,51,3,81.46000000000001,5,3,2,10,Loyal
21309,354,3,1183.47,1,3,4,8,Potential
21310,333,1,1120.49,1,1,3,5,At Risk
21311,34,5,4472.5782,5,5,5,15,Champions
21312,183,3,94.97,3,3,3,9,Potential
21313,254,2,1155.48,2,2,3,7,Potential
21314,34,1,9.99,5,1,1,7,Potential
21315,231,4,1189.46,2,4,4,10,Loyal
21316,108,3,68.97,4,3,2,9,Potential
21317,219,5,108.95,2,5,3,10,Loyal
21318,123,3,36.96,4,3,1,8,Potential
21319,62,3,23.97,5,3,1,9,Potential
21320,135,4,99.96000000000001,3,4,3,10,Loyal
21321,320,3,49.970000000000006,1,3,2,6,At Risk
21322,161,2,14.98,3,2,1,6,At Risk
21323,224,1,1120.49,2,1,3,6,At Risk
21324,284,3,68.97,2,3,2,7,Potential
21325,280,3,69.97,2,3,2,7,Potential
21326,226,3,1179.97,2,3,4,9,Potential
21327,223,1,1120.49,2,1,3,6,At Risk
21328,205,3,49.970000000000006,3,3,2,8,Potential
21329,110,3,1179.47,4,3,4,11,Loyal
21330,104,1,1120.49,4,1,3,8,Potential
21331,383,4,2670.8896,1,4,4,9,Potential
21332,354,5,2616.8581999999997,1,5,4,10,Loyal
21333,203,2,1174.48,3,2,4,9,Potential
21334,178,2,1155.48,3,2,3,8,Potential
21335,178,3,1183.47,3,3,4,10,Loyal
21336,289,4,2628.3496,1,4,4,9,Potential
21337,162,3,49.970000000000006,3,3,2,8,Potential
21338,169,3,23.97,3,3,1,7,Potential
21339,360,2,39.980000000000004,1,2,1,4,At Risk
21340,265,3,22.93,2,3,1,6,At Risk
21341,22,2,14.98,5,2,1,8,Recent Customer
21342,175,2,1155.48,3,2,3,8,Potential
21343,152,2,1170.48,3,2,4,9,Potential
21344,136,2,1155.48,3,2,3,8,Potential
21345,174,2,29.93,3,2,1,6,At Risk
21346,199,2,14.98,3,2,1,6,At Risk
21347,1,1,4.99,5,1,1,7,Recent Customer
21348,49,5,4392.0181999999995,5,5,5,15,Champions
21349,383,5,2989.3795999999998,1,5,4,10,Loyal
21350,340,3,69.97,1,3,2,6,At Risk
21351,94,3,17.27,4,3,1,8,Potential
21352,295,4,2625.3896,1,4,4,9,Potential
21353,199,2,44.980000000000004,3,2,2,7,Potential
21354,299,3,2646.3996,1,3,4,8,Potential
21355,120,4,1184.46,4,4,4,12,Loyal
21356,97,2,1174.48,4,2,4,10,Loyal
21357,122,3,1205.47,4,3,4,11,Loyal
21358,310,1,9.99,1,1,1,3,At Risk
21359,253,5,3032.3099999999995,2,5,4,11,Loyal
21360,142,3,93.97,3,3,3,9,Potential
21361,274,4,2997.3199999999997,2,4,4,10,Loyal
21362,10,3,93.97,5,3,3,11,Recent Customer
21363,277,1,4.99,2,1,1,4,At Risk
21364,3,2,7.28,5,2,1,8,Recent Customer
21365,277,2,7.28,2,2,1,5,At Risk
21366,362,2,39.980000000000004,1,2,1,4,At Risk
21367,342,2,7.28,1,2,1,4,At Risk
21368,214,2,14.98,2,2,1,5,At Risk
21369,122,2,1155.48,4,2,3,9,Potential
21370,197,2,39.980000000000004,3,2,1,6,At Risk
21371,207,2,7.28,2,2,1,5,At Risk
21372,161,4,74.96000000000001,3,4,2,9,Potential
21373,323,3,15.23,1,3,1,5,At Risk
21374,324,2,7.28,1,2,1,4,At Risk
21375,333,2,39.980000000000004,1,2,1,4,At Risk
21376,157,1,4.99,3,1,1,5,At Risk
21377,239,1,69.99,2,1,2,5,At Risk
21378,196,2,78.97999999999999,3,2,2,7,Potential
21379,253,3,2992.33,2,3,4,9,Potential
21380,272,4,2735.5325,2,4,4,10,Loyal
21381,77,1,69.99,4,1,2,7,Potential
21382,354,1,69.99,1,1,2,4,At Risk
21383,90,1,69.99,4,1,2,7,Potential
21384,251,6,2921.0225,2,5,4,11,Loyal
21385,42,4,608.96,5,4,3,12,Loyal
21386,34,1,539.99,5,1,3,9,Potential
21387,246,4,2745.3325000000004,2,4,4,10,Loyal
21388,106,3,1179.47,4,3,4,11,Loyal
21389,272,5,2770.5224999999996,2,5,4,11,Loyal
21390,52,2,32.28,5,2,1,8,Potential
21391,358,1,29.99,1,1,1,3,At Risk
21392,73,1,29.99,5,1,1,7,Potential
21393,137,5,4925.17,3,5,5,13,Champions
21394,141,3,4657.5125,3,3,5,11,Loyal
21395,24,3,98.97,5,3,3,11,Recent Customer
21396,119,2,1170.48,4,2,4,10,Loyal
21397,196,3,49.970000000000006,3,3,2,8,Potential
21398,65,3,23.97,5,3,1,9,Potential
21399,92,1,9.99,4,1,1,6,At Risk
21400,255,5,2688.8896,2,5,4,11,Loyal
21401,108,2,1174.48,4,2,4,10,Loyal
21402,135,2,4624.9125,3,2,5,10,Loyal
21403,131,3,4895.69,4,3,5,12,Loyal
21404,148,4,4684.3925,3,4,5,12,Loyal
21405,216,3,74.98,2,3,2,7,Potential
21406,317,3,74.98,1,3,2,6,At Risk
21407,366,3,42.28,1,3,2,6,At Risk
21408,149,2,4624.9125,3,2,5,10,Loyal
21409,280,1,35.0,2,1,1,4,At Risk
21410,76,2,1155.48,4,2,3,9,Potential
21411,63,3,1147.77,5,3,3,11,Loyal
21412,358,2,59.980000000000004,1,2,2,5,At Risk
21413,219,2,14.98,2,2,1,5,At Risk
21414,34,2,14.98,5,2,1,8,Potential
21415,110,3,49.970000000000006,4,3,2,9,Potential
21416,100,2,1155.48,4,2,3,9,Potential
21417,100,2,1155.48,4,2,3,9,Potential
21418,128,3,4659.9025,4,3,5,12,Loyal
21419,252,3,64.97,2,3,2,7,Potential
21420,91,3,78.48,4,3,2,9,Potential
21421,191,4,99.96000000000001,3,4,3,10,Loyal
21422,88,4,1184.46,4,4,4,12,Loyal
21423,137,5,2888.5582,3,5,4,12,Loyal
21424,112,2,1170.48,4,2,4,10,Loyal
21425,206,1,9.99,3,1,1,5,At Risk
21426,104,3,1149.47,4,3,3,10,Loyal
21427,62,2,1155.48,5,2,3,10,Loyal
21428,68,2,1155.48,5,2,3,10,Loyal
21429,42,2,1174.48,5,2,4,11,Loyal
21430,137,4,74.46,3,4,2,9,Potential
21431,34,2,56.97,5,2,2,9,Potential
21432,329,2,14.98,1,2,1,4,At Risk
21433,163,3,68.97,3,3,2,8,Potential
21434,34,3,1183.47,5,3,4,12,Loyal
21435,42,2,1170.48,5,2,4,11,Loyal
21436,34,5,1193.95,5,5,4,14,Champions
21437,37,4,1136.76,5,4,3,12,Loyal
21438,384,2,561.48,1,2,3,6,At Risk
21439,388,1,539.99,1,1,3,5,At Risk
21440,396,4,562.96,1,4,3,8,Potential
21441,16,2,7.28,5,2,1,8,Recent Customer
21442,352,2,14.98,1,2,1,4,At Risk
21443,337,3,49.970000000000006,1,3,2,6,At Risk
21444,249,3,22.93,2,3,1,6,At Risk
21445,335,4,113.47,1,4,3,8,Potential
21446,265,2,54.980000000000004,2,2,2,6,At Risk
21447,203,1,21.98,3,1,1,5,At Risk
21448,374,2,564.48,1,2,3,6,At Risk
21449,255,2,14.98,2,2,1,5,At Risk
21450,92,2,59.980000000000004,4,2,2,8,Potential
21451,219,3,23.97,2,3,1,6,At Risk
21452,214,3,49.970000000000006,2,3,2,7,Potential
21453,327,3,36.96,1,3,1,5,At Risk
21454,92,1,9.99,4,1,1,6,At Risk
21455,262,2,14.98,2,2,1,5,At Risk
21456,267,4,103.96000000000001,2,4,3,9,Potential
21457,124,3,69.97,4,3,2,9,Potential
21458,228,3,49.970000000000006,2,3,2,7,Potential
21459,348,2,14.98,1,2,1,4,At Risk
21460,191,2,14.98,3,2,1,6,At Risk
21461,91,2,141.98,4,2,3,9,Potential
21462,42,3,49.970000000000006,5,3,2,10,Loyal
21463,175,3,23.97,3,3,1,7,Potential
21464,69,2,76.97,5,2,2,9,Potential
21465,384,2,574.98,1,2,3,6,At Risk
21466,371,4,556.26,1,4,3,8,Potential
21467,133,3,23.97,4,3,1,8,Potential
21468,138,2,64.98,3,2,2,7,Potential
21469,384,4,588.96,1,4,3,8,Potential
21470,376,4,562.96,1,4,3,8,Potential
21471,300,2,31.97,1,2,1,4,At Risk
21472,330,3,49.970000000000006,1,3,2,6,At Risk
21473,135,3,78.48,3,3,2,8,Potential
21474,339,2,44.980000000000004,1,2,2,5,At Risk
21475,93,3,1147.77,4,3,3,10,Loyal
21476,98,5,1197.41,4,5,4,13,Champions
21477,222,3,23.97,2,3,1,6,At Risk
21478,108,2,1155.48,4,2,3,9,Potential
21479,99,3,1149.47,4,3,3,10,Loyal
21480,34,2,39.980000000000004,5,2,1,8,Potential
21481,144,1,9.99,3,1,1,5,At Risk
21482,122,2,1129.48,4,2,3,9,Potential
21483,105,3,1205.47,4,3,4,11,Loyal
21484,112,1,1120.49,4,1,3,8,Potential
21485,101,3,1149.47,4,3,3,10,Loyal
21486,122,2,1155.48,4,2,3,9,Potential
21487,378,2,548.98,1,2,3,6,At Risk
21488,382,5,638.95,1,5,3,9,Potential
21489,143,2,7.28,3,2,1,6,At Risk
21490,67,2,7.28,5,2,1,8,Potential
21491,108,2,1174.48,4,2,4,10,Loyal
21492,243,2,14.98,2,2,1,5,At Risk
21493,47,3,68.97,5,3,2,10,Loyal
21494,171,2,7.28,3,2,1,6,At Risk
21495,32,3,23.97,5,3,1,9,Potential
21496,340,2,14.98,1,2,1,4,At Risk
21497,52,4,89.46,5,4,2,11,Loyal
21498,76,3,134.98,4,3,3,10,Loyal
21499,87,4,99.96000000000001,4,4,3,11,Loyal
21500,345,3,22.93,1,3,1,5,At Risk
21501,385,3,2661.3995999999997,1,3,4,8,Potential
21502,107,3,49.970000000000006,4,3,2,9,Potential
21503,70,3,49.970000000000006,5,3,2,10,Loyal
21504,105,2,1155.48,4,2,3,9,Potential
21505,60,2,2354.9799999999996,5,2,4,11,Loyal
21506,42,4,2369.9599999999996,5,4,4,13,Champions
21507,359,1,24.99,1,1,1,3,At Risk
21508,48,5,3152.9499999999994,5,5,4,14,Champions
21509,38,4,3117.9599999999996,5,4,4,13,Champions
21510,302,5,128.95,1,5,3,9,Potential
21511,197,3,32.269999999999996,3,3,1,7,Potential
21512,127,1,24.99,4,1,1,6,At Risk
21513,162,4,119.96000000000001,3,4,3,10,Loyal
21514,243,3,69.97,2,3,2,7,Potential
21515,237,2,49.48,2,2,2,6,At Risk
21516,49,4,3102.25,5,4,4,13,Champions
21517,59,4,3172.97,5,4,4,13,Champions
21518,193,5,144.45,3,5,3,11,Loyal
21519,232,3,69.97,2,3,2,7,Potential
21520,90,3,32.269999999999996,4,3,1,8,Potential
21521,166,3,42.93,3,3,2,8,Potential
21522,211,4,123.96000000000001,2,4,3,9,Potential
21523,1,2,38.98,5,2,1,8,Recent Customer
21524,1,4,114.96000000000001,5,4,3,12,Recent Customer
21525,347,3,32.269999999999996,1,3,1,5,At Risk
21526,160,1,29.99,3,1,1,5,At Risk
21527,34,1,2294.99,5,1,4,10,Loyal
21528,63,2,34.98,5,2,1,8,Potential
21529,66,1,29.99,5,1,1,7,Potential
21530,174,5,128.95,3,5,3,11,Loyal
21531,7,3,56.96,5,3,2,10,Recent Customer
21532,37,5,2399.95,5,5,4,14,Champions
21533,209,4,40.22,2,4,2,8,Potential
21534,392,5,1622.45,1,5,4,10,Loyal
21535,77,3,69.97,4,3,2,9,Potential
21536,133,4,78.96000000000001,4,4,2,10,Loyal
21537,51,1,2319.99,5,1,4,10,Loyal
21538,40,4,2369.9599999999996,5,4,4,13,Champions
21539,124,2,34.98,4,2,1,7,Potential
21540,204,3,1602.47,3,3,4,10,Loyal
21541,145,3,149.98,3,3,3,9,Potential
21542,52,2,2329.9799999999996,5,2,4,11,Loyal
21543,185,3,37.269999999999996,3,3,1,7,Potential
21544,83,2,29.979999999999997,4,2,1,7,Potential
21545,209,4,1631.46,2,4,4,10,Loyal
21546,121,1,4.99,4,1,1,6,At Risk
21547,152,4,72.96000000000001,3,4,2,9,Potential
21548,132,3,36.93,4,3,1,8,Potential
21549,331,4,98.96000000000001,1,4,3,8,Potential
21550,173,2,58.980000000000004,3,2,2,7,Potential
21551,180,1,29.99,3,1,1,5,At Risk
21552,131,2,4624.9125,4,2,5,11,Loyal
21553,146,4,4666.5025000000005,3,4,5,12,Loyal
21554,157,3,74.98,3,3,2,8,Potential
21555,139,5,4715.4925,3,5,5,13,Champions
21556,138,4,4930.679999999999,3,4,5,12,Loyal
21557,128,2,4886.7,4,2,5,11,Loyal
21558,145,3,4919.299999999999,3,3,5,11,Loyal
21559,134,4,4900.679999999999,3,4,5,12,Loyal
21560,136,5,4702.3925,3,5,5,13,Champions
21561,153,5,4947.78,3,5,5,13,Champions
21562,107,3,4632.8625,4,3,5,12,Loyal
21563,334,2,39.99,1,2,2,5,At Risk
21564,264,3,74.98,2,3,2,7,Potential
21565,346,3,48.980000000000004,1,3,2,6,At Risk
21566,339,3,42.28,1,3,2,6,At Risk
21567,95,5,4973.28,4,5,5,14,Champions
21568,93,4,4659.8025,4,4,5,13,Champions
21569,100,6,4960.16,4,5,5,14,Champions
21570,94,6,4705.4825,4,5,5,14,Champions
21571,121,2,4624.9125,4,2,5,11,Loyal
21572,98,3,4659.9025,4,3,5,12,Loyal
21573,173,3,61.970000000000006,3,3,2,8,Potential
21574,351,5,124.45,1,5,3,9,Potential
21575,395,2,548.98,1,2,3,6,At Risk
21576,369,2,548.98,1,2,3,6,At Risk
21577,57,2,39.980000000000004,5,2,1,8,Potential
21578,156,3,17.27,3,3,1,7,Potential
21579,240,2,14.98,2,2,1,5,At Risk
21580,232,4,44.91,2,4,2,8,Potential
21581,357,2,24.27,1,2,1,4,At Risk
21582,272,5,2638.0582,2,5,4,11,Loyal
21583,105,4,1214.46,4,4,4,12,Loyal
21584,114,2,1155.48,4,2,3,9,Potential
21585,95,3,1179.97,4,3,4,11,Loyal
21586,98,1,1120.49,4,1,3,8,Potential
21587,93,2,1155.48,4,2,3,9,Potential
21588,80,2,1174.48,4,2,4,10,Loyal
21589,255,2,2589.0882,2,2,4,8,Potential
21590,80,4,1169.46,4,4,4,12,Loyal
21591,38,3,69.97,5,3,2,10,Loyal
21592,94,3,23.97,4,3,1,8,Potential
21593,84,2,1155.48,4,2,3,9,Potential
21594,84,3,1169.97,4,3,4,11,Loyal
21595,263,5,2649.5581999999995,2,5,4,11,Loyal
21596,69,2,1155.48,5,2,3,10,Loyal
21597,375,2,561.48,1,2,3,6,At Risk
21598,76,1,1120.49,4,1,3,8,Potential
21599,85,2,1170.48,4,2,4,10,Loyal
21600,394,3,563.77,1,3,3,7,Potential
21601,343,4,589.96,1,4,3,8,Potential
21602,358,2,548.98,1,2,3,6,At Risk
21603,360,4,567.76,1,4,3,8,Potential
21604,76,3,1179.97,4,3,4,11,Loyal
21605,86,3,1179.47,4,3,4,11,Loyal
21606,84,2,1155.48,4,2,3,9,Potential
21607,78,1,1120.49,4,1,3,8,Potential
21608,341,2,574.98,1,2,3,6,At Risk
21609,359,3,553.97,1,3,3,7,Potential
21610,336,2,548.98,1,2,3,6,At Risk
21611,339,4,617.47,1,4,3,8,Potential
21612,198,2,14.98,3,2,1,6,At Risk
21613,224,3,2610.5782,2,3,4,9,Potential
21614,225,2,2589.0882,2,2,4,8,Potential
21615,86,2,1155.48,4,2,3,9,Potential
21616,287,3,68.97,2,3,2,7,Potential
21617,9,2,14.98,5,2,1,8,Recent Customer
21618,362,3,2611.0681999999997,1,3,4,8,Potential
21619,346,4,556.26,1,4,3,8,Potential
21620,216,3,2620.3996,2,3,4,9,Potential
21621,207,5,2616.8581999999997,2,5,4,11,Loyal
21622,136,5,2612.0582,3,5,4,12,Loyal
21623,43,1,9.99,5,1,1,7,Potential
21624,264,3,49.970000000000006,2,3,2,7,Potential
21625,171,3,68.97,3,3,2,8,Potential
21626,140,3,134.98,3,3,3,9,Potential
21627,218,3,17.27,2,3,1,6,At Risk
21628,146,4,77.96000000000001,3,4,2,9,Potential
21629,101,3,2624.0782,4,3,4,11,Loyal
21630,350,2,14.98,1,2,1,4,At Risk
21631,199,2,7.28,3,2,1,6,At Risk
21632,295,2,14.98,1,2,1,4,At Risk
21633,312,2,64.98,1,2,2,5,At Risk
21634,132,3,49.970000000000006,4,3,2,9,Potential
21635,222,4,73.96000000000001,2,4,2,8,Potential
21636,188,2,14.98,3,2,1,6,At Risk
21637,77,2,1155.48,4,2,3,9,Potential
21638,83,2,1170.48,4,2,4,10,Loyal
21639,171,1,9.99,3,1,1,5,At Risk
21640,193,4,123.96000000000001,3,4,3,10,Loyal
21641,63,1,1120.49,5,1,3,9,Potential
21642,104,3,2620.3996,4,3,4,11,Loyal
21643,65,2,1170.48,5,2,4,11,Loyal
21644,68,2,1145.48,5,2,3,10,Loyal
21645,78,3,1183.47,4,3,4,11,Loyal
21646,345,3,563.77,1,3,3,7,Potential
21647,353,4,608.96,1,4,3,8,Potential
21648,350,2,548.98,1,2,3,6,At Risk
21649,345,3,553.97,1,3,3,7,Potential
21650,348,3,553.97,1,3,3,7,Potential
21651,325,4,608.96,1,4,3,8,Potential
21652,364,4,2646.0582,1,4,4,9,Potential
21653,306,4,588.96,1,4,3,8,Potential
21654,319,4,603.96,1,4,3,8,Potential
21655,311,4,2648.0681999999997,1,4,4,9,Potential
21656,166,2,56.97,3,2,2,7,Potential
21657,282,2,14.98,2,2,1,5,At Risk
21658,109,4,2641.8896000000004,4,4,4,12,Loyal
21659,86,4,4143.74,4,4,5,13,Champions
21660,69,3,1134.47,5,3,3,11,Loyal
21661,216,2,58.980000000000004,2,2,2,6,At Risk
21662,282,1,21.49,2,1,1,4,At Risk
21663,163,2,39.980000000000004,3,2,1,6,At Risk
21664,87,3,60.47,4,3,2,9,Potential
21665,283,3,553.97,2,3,3,8,Potential
21666,127,3,828.47,4,3,3,10,Loyal
21667,119,2,819.48,4,2,3,9,Potential
21668,222,3,2518.97,2,3,4,9,Potential
21669,190,2,2483.98,3,2,4,9,Potential
21670,140,4,147.77,3,4,3,10,Loyal
21671,284,4,628.97,2,4,3,9,Potential
21672,34,2,1155.48,5,2,3,10,Loyal
21673,276,5,638.95,2,5,3,10,Loyal
21674,93,1,4.99,4,1,1,6,At Risk
21675,14,4,99.96,5,4,3,12,Recent Customer
21676,32,2,23.779999999999998,5,2,1,8,Potential
21677,92,1,21.49,4,1,1,6,At Risk
21678,326,3,42.93,1,3,2,6,At Risk
21679,200,1,1700.99,3,1,4,8,Potential
21680,329,3,48.970000000000006,1,3,2,6,At Risk
21681,104,3,799.42,4,3,3,10,Loyal
21682,116,2,7.28,4,2,1,7,Potential
21683,212,3,1779.47,2,3,4,9,Potential
21684,171,3,60.47,3,3,2,8,Potential
21685,64,3,1205.47,5,3,4,12,Loyal
21686,194,1,9.99,3,1,1,5,At Risk
21687,102,3,23.97,4,3,1,8,Potential
21688,323,2,14.98,1,2,1,4,At Risk
21689,77,2,14.98,4,2,1,7,Potential
21690,286,3,93.97,2,3,3,8,Potential
21691,274,2,39.980000000000004,2,2,1,5,At Risk
21692,201,2,14.98,3,2,1,6,At Risk
21693,243,2,44.980000000000004,2,2,2,6,At Risk
21694,137,3,49.970000000000006,3,3,2,8,Potential
21695,63,4,1169.46,5,4,4,13,Champions
21696,31,3,68.97,5,3,2,10,Loyal
21697,100,2,14.98,4,2,1,7,Potential
21698,318,2,14.98,1,2,1,4,At Risk
21699,91,4,1158.96,4,4,4,12,Loyal
21700,91,2,1174.48,4,2,4,10,Loyal
21701,235,4,77.92,2,4,2,8,Potential
21702,120,5,91.94,4,5,2,11,Loyal
21703,25,4,43.96,5,4,2,11,Recent Customer
21704,78,4,1151.76,4,4,3,11,Loyal
21705,55,3,49.970000000000006,5,3,2,10,Loyal
21706,159,4,99.96000000000001,3,4,3,10,Loyal
21707,99,2,14.98,4,2,1,7,Potential
21708,178,3,49.970000000000006,3,3,2,8,Potential
21709,87,2,1155.48,4,2,3,9,Potential
21710,81,5,4187.23,4,5,5,14,Champions
21711,85,3,1179.97,4,3,4,11,Loyal
21712,268,3,68.97,2,3,2,7,Potential
21713,247,2,14.98,2,2,1,5,At Risk
21714,27,3,64.97,5,3,2,10,Recent Customer
21715,351,2,14.98,1,2,1,4,At Risk
21716,142,2,14.98,3,2,1,6,At Risk
21717,1,2,44.980000000000004,5,2,2,9,Recent Customer
21718,156,3,22.93,3,3,1,7,Potential
21719,90,4,99.96000000000001,4,4,3,11,Loyal
21720,343,2,14.98,1,2,1,4,At Risk
21721,108,2,14.98,4,2,1,7,Potential
21722,80,2,14.98,4,2,1,7,Potential
21723,68,3,1205.47,5,3,4,12,Loyal
21724,201,2,14.98,3,2,1,6,At Risk
21725,201,1,4.99,3,1,1,5,At Risk
21726,199,4,41.95,3,4,2,9,Potential
21727,64,4,4132.24,5,4,5,14,Champions
21728,90,3,1205.47,4,3,4,11,Loyal
21729,125,3,49.970000000000006,4,3,2,9,Potential
21730,56,3,17.27,5,3,1,9,Potential
21731,40,2,14.98,5,2,1,8,Potential
21732,107,4,83.47,4,4,2,10,Loyal
21733,45,2,14.98,5,2,1,8,Potential
21734,23,2,14.98,5,2,1,8,Recent Customer
21735,33,4,94.46,5,4,3,12,Loyal
21736,74,3,94.97,4,3,3,10,Loyal
21737,87,3,60.47,4,3,2,9,Potential
21738,56,3,69.97,5,3,2,10,Loyal
21739,300,3,37.269999999999996,1,3,1,5,At Risk
21740,15,5,131.44,5,5,3,13,Recent Customer
21741,333,3,4127.25,1,3,5,9,Potential
21742,275,2,30.97,2,2,1,5,At Risk
21743,275,3,49.970000000000006,2,3,2,7,Potential
21744,122,3,49.970000000000006,4,3,2,9,Potential
21745,172,4,71.95,3,4,2,9,Potential
21746,69,2,1174.48,5,2,4,11,Loyal
21747,335,1,539.99,1,1,3,5,At Risk
21748,331,4,600.46,1,4,3,8,Potential
21749,66,2,1155.48,5,2,3,10,Loyal
21750,302,3,68.97,1,3,2,6,At Risk
21751,159,3,49.970000000000006,3,3,2,8,Potential
21752,55,2,7.28,5,2,1,8,Potential
21753,274,3,78.48,2,3,2,7,Potential
21754,135,2,14.98,3,2,1,6,At Risk
21755,106,2,14.98,4,2,1,7,Potential
21756,334,3,553.97,1,3,3,7,Potential
21757,6,4,74.46,5,4,2,11,Recent Customer
21758,108,2,14.98,4,2,1,7,Potential
21759,44,3,64.47,5,3,2,10,Loyal
21760,116,3,49.970000000000006,4,3,2,9,Potential
21761,197,3,134.98,3,3,3,9,Potential
21762,363,4,78.96000000000001,1,4,2,7,Potential
21763,76,3,49.970000000000006,4,3,2,9,Potential
21764,311,2,7.28,1,2,1,4,At Risk
21765,235,3,78.48,2,3,2,7,Potential
21766,325,1,539.99,1,1,3,5,At Risk
21767,179,5,124.45,3,5,3,11,Loyal
21768,290,2,4118.26,1,2,5,8,Potential
21769,332,2,603.49,1,2,3,6,At Risk
21770,194,3,23.97,3,3,1,7,Potential
21771,202,3,22.93,3,3,1,7,Potential
21772,130,3,23.97,4,3,1,8,Potential
21773,247,2,14.98,2,2,1,5,At Risk
21774,48,3,49.970000000000006,5,3,2,10,Loyal
21775,304,3,69.97,1,3,2,6,At Risk
21776,272,3,23.97,2,3,1,6,At Risk
21777,66,2,180.98,5,2,3,10,Loyal
21778,103,2,14.98,4,2,1,7,Potential
21779,41,2,14.98,5,2,1,8,Potential
21780,298,4,77.92,1,4,2,7,Potential
21781,86,2,1174.48,4,2,4,10,Loyal
21782,276,3,49.970000000000006,2,3,2,7,Potential
21783,338,3,49.970000000000006,1,3,2,6,At Risk
21784,260,3,49.970000000000006,2,3,2,7,Potential
21785,68,2,1155.48,5,2,3,10,Loyal
21786,153,4,119.96000000000001,3,4,3,10,Loyal
21787,344,3,17.27,1,3,1,5,At Risk
21788,64,1,1120.49,5,1,3,9,Potential
21789,267,2,14.98,2,2,1,5,At Risk
21790,234,4,74.46,2,4,2,8,Potential
21791,306,2,574.98,1,2,3,6,At Risk
21792,60,4,114.46000000000001,5,4,3,12,Loyal
21793,64,2,1155.48,5,2,3,10,Loyal
21794,89,3,1179.97,4,3,4,11,Loyal
21795,323,5,613.45,1,5,3,9,Potential
21796,164,2,59.980000000000004,3,2,2,7,Potential
21797,87,2,1155.48,4,2,3,9,Potential
21798,79,2,1174.48,4,2,4,10,Loyal
21799,183,3,23.97,3,3,1,7,Potential
21800,147,3,64.97,3,3,2,8,Potential
21801,177,2,44.980000000000004,3,2,2,7,Potential
21802,303,4,77.96000000000001,1,4,2,7,Potential
21803,95,2,39.980000000000004,4,2,1,7,Potential
21804,189,2,14.98,3,2,1,6,At Risk
21805,289,3,49.970000000000006,1,3,2,6,At Risk
21806,140,2,14.98,3,2,1,6,At Risk
21807,77,1,1120.49,4,1,3,8,Potential
21808,89,2,1155.48,4,2,3,9,Potential
21809,110,3,49.970000000000006,4,3,2,9,Potential
21810,334,4,562.96,1,4,3,8,Potential
21811,63,3,17.27,5,3,1,9,Potential
21812,77,2,1155.48,4,2,3,9,Potential
21813,36,2,4118.26,5,2,5,12,Loyal
21814,203,2,14.98,3,2,1,6,At Risk
21815,299,3,64.47,1,3,2,6,At Risk
21816,212,3,83.47,2,3,2,7,Potential
21817,95,2,791.47,4,2,3,9,Potential
21818,272,3,191.28,2,3,3,8,Potential
21819,326,2,32.28,1,2,1,4,At Risk
21820,173,2,38.98,3,2,1,6,At Risk
21821,186,3,48.970000000000006,3,3,2,8,Potential
21822,247,1,564.99,2,1,3,6,At Risk
21823,126,1,4.99,4,1,1,6,At Risk
21824,50,2,27.279999999999998,5,2,1,8,Potential
21825,31,1,4.99,5,1,1,7,Potential
21826,76,2,12.940000000000001,4,2,1,7,Potential
21827,41,2,2354.9799999999996,5,2,4,11,Loyal
21828,49,2,2322.2799999999997,5,2,4,11,Loyal
21829,109,3,63.97,4,3,2,9,Potential
21830,233,1,539.99,2,1,3,6,At Risk
21831,115,2,34.98,4,2,1,7,Potential
21832,14,2,39.980000000000004,5,2,1,8,Recent Customer
21833,51,1,2294.99,5,1,4,10,Loyal
21834,119,2,58.980000000000004,4,2,2,8,Potential
21835,51,4,2360.9499999999994,5,4,4,13,Champions
21836,187,1,4.99,3,1,1,5,At Risk
21837,25,2,68.49,5,2,2,9,Recent Customer
21838,232,1,4.99,2,1,1,4,At Risk
21839,155,3,92.48,3,3,3,9,Potential
21840,361,3,31.27,1,3,1,5,At Risk
21841,194,1,24.99,3,1,1,5,At Risk
21842,138,3,48.970000000000006,3,3,2,8,Potential
21843,298,2,13.98,1,2,1,4,At Risk
21844,185,2,39.980000000000004,3,2,1,6,At Risk
21845,306,1,4.99,1,1,1,3,At Risk
21846,320,2,39.980000000000004,1,2,1,4,At Risk
21847,189,3,187.98,3,3,3,9,Potential
21848,228,1,564.99,2,1,3,6,At Risk
21849,313,2,39.980000000000004,1,2,1,4,At Risk
21850,128,1,4.99,4,1,1,6,At Risk
21851,310,1,4.99,1,1,1,3,At Risk
21852,170,1,4.99,3,1,1,5,At Risk
21853,151,3,89.97,3,3,2,8,Potential
21854,91,1,24.99,4,1,1,6,At Risk
21855,163,3,579.97,3,3,3,9,Potential
21856,101,1,24.99,4,1,1,6,At Risk
21857,370,3,2487.3299999999995,1,3,4,8,Potential
21858,374,4,2492.3199999999997,1,4,4,9,Potential
21859,164,1,4.99,3,1,1,5,At Risk
21860,179,1,4.99,3,1,1,5,At Risk
21861,363,2,39.980000000000004,1,2,1,4,At Risk
21862,251,2,13.98,2,2,1,5,At Risk
21863,296,2,39.980000000000004,1,2,1,4,At Risk
21864,215,2,28.979999999999997,2,2,1,5,At Risk
21865,244,3,148.98,2,3,3,8,Potential
21866,98,1,4.99,4,1,1,6,At Risk
21867,142,2,13.98,3,2,1,6,At Risk
21868,358,1,4.99,1,1,1,3,At Risk
21869,59,1,4.99,5,1,1,7,Potential
21870,76,4,72.96000000000001,4,4,2,10,Loyal
21871,56,1,29.99,5,1,1,7,Potential
21872,134,2,34.98,3,2,1,6,At Risk
21873,96,4,4661.5025000000005,4,4,5,13,Champions
21874,98,4,4638.8925,4,4,5,13,Champions
21875,93,3,4921.69,4,3,5,12,Loyal
21876,118,5,4663.3825,4,5,5,14,Champions
21877,101,2,4624.9125,4,2,5,11,Loyal
21878,120,5,4663.7925,4,5,5,14,Champions
21879,107,1,35.0,4,1,1,6,At Risk
21880,151,2,39.99,3,2,2,7,Potential
21881,133,4,128.97,4,4,3,11,Loyal
21882,98,2,4886.7,4,2,5,11,Loyal
21883,361,3,42.28,1,3,2,6,At Risk
21884,115,3,74.98,4,3,2,9,Potential
21885,114,4,4641.8525,4,4,5,13,Champions
21886,115,5,4696.4925,4,5,5,14,Champions
21887,359,2,39.99,1,2,2,5,At Risk
21888,118,5,4925.58,4,5,5,14,Champions
21889,119,2,4624.9125,4,2,5,11,Loyal
21890,186,2,39.99,3,2,2,7,Potential
21891,103,3,4921.69,4,3,5,12,Loyal
21892,93,3,4921.69,4,3,5,12,Loyal
21893,94,5,4663.7925,4,5,5,14,Champions
21894,118,2,4624.9125,4,2,5,11,Loyal
21895,96,3,4657.5125,4,3,5,12,Loyal
21896,237,3,74.98,2,3,2,7,Potential
21897,117,5,4909.67,4,5,5,14,Champions
21898,88,3,74.98,4,3,2,9,Potential
21899,112,5,4663.7925,4,5,5,14,Champions
21900,241,3,69.97,2,3,2,7,Potential
21901,27,2,14.98,5,2,1,8,Recent Customer
21902,88,3,23.97,4,3,1,8,Potential
21903,318,2,548.98,1,2,3,6,At Risk
21904,145,2,75.97,3,2,2,7,Potential
21905,195,2,14.98,3,2,1,6,At Risk
21906,162,2,14.98,3,2,1,6,At Risk
21907,139,2,14.98,3,2,1,6,At Risk
21908,170,3,64.97,3,3,2,8,Potential
21909,322,3,563.77,1,3,3,7,Potential
21910,46,2,1174.48,5,2,4,11,Loyal
21911,205,3,27.77,3,3,1,7,Potential
21912,262,2,574.98,2,2,3,7,Potential
21913,38,3,60.47,5,3,2,10,Loyal
21914,284,2,39.980000000000004,2,2,1,5,At Risk
21915,324,3,570.47,1,3,3,7,Potential
21916,168,2,39.980000000000004,3,2,1,6,At Risk
21917,240,3,69.97,2,3,2,7,Potential
21918,364,3,68.97,1,3,2,6,At Risk
21919,66,1,1120.49,5,1,3,9,Potential
21920,66,4,1184.46,5,4,4,13,Champions
21921,46,3,4142.75,5,3,5,13,Champions
21922,84,1,1120.49,4,1,3,8,Potential
21923,54,1,1120.49,5,1,3,9,Potential
21924,34,1,1120.49,5,1,3,9,Potential
21925,28,2,7.28,5,2,1,8,Recent Customer
21926,52,3,1198.97,5,3,4,12,Loyal
21927,36,2,1145.48,5,2,3,10,Loyal
21928,52,2,1170.48,5,2,4,11,Loyal
21929,55,3,1183.47,5,3,4,12,Loyal
21930,48,4,1233.96,5,4,4,13,Champions
21931,48,1,1120.49,5,1,3,9,Potential
21932,43,4,1158.46,5,4,4,13,Champions
21933,67,3,49.970000000000006,5,3,2,10,Loyal
21934,163,1,9.99,3,1,1,5,At Risk
21935,27,3,39.47,5,3,1,9,Recent Customer
21936,150,4,99.96000000000001,3,4,3,10,Loyal
21937,55,3,1134.47,5,3,3,11,Loyal
21938,169,2,14.98,3,2,1,6,At Risk
21939,295,4,4163.24,1,4,5,10,Loyal
21940,314,4,571.72,1,4,3,8,Potential
21941,59,2,1174.48,5,2,4,11,Loyal
21942,331,2,574.98,1,2,3,6,At Risk
21943,116,2,4624.9125,4,2,5,11,Loyal
21944,113,4,4713.8925,4,4,5,13,Champions
21945,102,2,4886.7,4,2,5,11,Loyal
21946,74,4,4659.802500000001,4,4,5,13,Champions
21947,85,3,4632.862499999999,4,3,5,12,Loyal
21948,87,2,4886.7,4,2,5,11,Loyal
21949,65,3,4659.9025,5,3,5,13,Champions
21950,64,4,4900.679999999999,5,4,5,14,Champions
21951,76,4,4923.29,4,4,5,13,Champions
21952,246,4,99.47,2,4,3,9,Potential
21953,283,1,35.0,2,1,1,4,At Risk
21954,29,1,35.0,5,1,1,7,Recent Customer
21955,68,4,4900.679999999999,5,4,5,14,Champions
21956,81,3,4632.862499999999,4,3,5,12,Loyal
21957,62,3,4919.299999999999,5,3,5,13,Champions
21958,68,5,4696.4925,5,5,5,15,Champions
21959,81,5,4702.3925,4,5,5,14,Champions
21960,138,2,39.99,3,2,2,7,Potential
21961,333,3,42.28,1,3,2,6,At Risk
21962,336,1,35.0,1,1,1,3,At Risk
21963,269,2,39.99,2,2,2,6,At Risk
21964,129,3,103.49,4,3,3,10,Loyal
21965,73,4,99.47,5,4,3,12,Loyal
21966,64,3,4659.9025,5,3,5,13,Champions
21967,60,4,123.96000000000001,5,4,3,12,Loyal
21968,68,5,4722.8825,5,5,5,15,Champions
21969,63,7,4759.4725,5,5,5,15,Champions
21970,75,2,32.28,4,2,1,7,Potential
21971,201,2,32.28,3,2,1,6,At Risk
21972,246,3,40.23,2,3,2,7,Potential
21973,64,2,56.97,5,2,2,9,Potential
21974,70,5,4925.17,5,5,5,15,Champions
21975,32,2,85.48,5,2,2,9,Potential
21976,104,3,4198.33,4,3,5,12,Loyal
21977,232,3,74.98,2,3,2,7,Potential
21978,282,2,37.29,2,2,1,5,At Risk
21979,115,3,3936.5425,4,3,5,12,Loyal
21980,100,6,4334.61,4,5,5,14,Champions
21981,80,2,75.97,4,2,2,8,Potential
21982,109,2,3882.5525,4,2,5,11,Loyal
21983,79,2,4144.34,4,2,5,11,Loyal
21984,88,5,4175.61,4,5,5,14,Champions
21985,80,3,3936.5425,4,3,5,12,Loyal
21986,76,2,3882.5525,4,2,5,11,Loyal
21987,82,4,4638.8925,4,4,5,13,Champions
21988,68,1,35.0,5,1,1,7,Potential
21989,309,1,35.0,1,1,1,3,At Risk
21990,298,4,99.47,1,4,3,8,Potential
21991,7,5,121.45,5,5,3,13,Recent Customer
21992,32,5,184.26,5,5,3,13,Champions
21993,327,3,74.98,1,3,2,6,At Risk
21994,69,3,4659.9025,5,3,5,13,Champions
21995,165,2,37.29,3,2,1,6,At Risk
21996,70,5,3946.5225,5,5,5,15,Champions
21997,87,2,39.99,4,2,2,8,Potential
21998,199,2,56.980000000000004,3,2,2,7,Potential
21999,92,3,4921.69,4,3,5,12,Loyal
22000,88,5,4663.7925000000005,4,5,5,14,Champions
22001,270,3,74.98,2,3,2,7,Potential
22002,153,2,78.97999999999999,3,2,2,7,Potential
22003,206,2,56.97,3,2,2,7,Potential
22004,92,3,3917.5425,4,3,5,12,Loyal
22005,33,4,135.46,5,4,3,12,Loyal
22006,317,3,42.28,1,3,2,6,At Risk
22007,50,2,44.980000000000004,5,2,2,9,Potential
22008,51,5,4141.23,5,5,5,15,Champions
22009,317,1,9.99,1,1,1,3,At Risk
22010,93,3,49.970000000000006,4,3,2,9,Potential
22011,61,3,68.97,5,3,2,10,Loyal
22012,213,2,14.98,2,2,1,5,At Risk
22013,46,3,565.47,5,3,3,11,Loyal
22014,21,6,80.2,5,5,2,12,Recent Customer
22015,205,1,4.99,3,1,1,5,At Risk
22016,35,2,574.98,5,2,3,10,Loyal
22017,238,1,69.99,2,1,2,5,At Risk
22018,231,2,76.97,2,2,2,6,At Risk
22019,336,2,7.28,1,2,1,4,At Risk
22020,125,2,56.97,4,2,2,8,Potential
22021,88,3,23.97,4,3,1,8,Potential
22022,78,3,49.970000000000006,4,3,2,9,Potential
22023,315,4,78.96000000000001,1,4,2,7,Potential
22024,271,3,23.97,2,3,1,6,At Risk
22025,205,2,14.98,3,2,1,6,At Risk
22026,153,2,39.980000000000004,3,2,1,6,At Risk
22027,263,2,59.980000000000004,2,2,2,6,At Risk
22028,361,1,69.99,1,1,2,4,At Risk
22029,47,2,30.97,5,2,1,8,Potential
22030,63,2,4144.34,5,2,5,12,Loyal
22031,70,4,3896.5325,5,4,5,14,Champions
22032,89,2,3882.5525,4,2,5,11,Loyal
22033,76,3,3917.5425,4,3,5,12,Loyal
22034,304,2,14.98,1,2,1,4,At Risk
22035,304,3,69.97,1,3,2,6,At Risk
22036,44,2,1155.48,5,2,3,10,Loyal
22037,137,4,45.22,3,4,2,9,Potential
22038,359,5,84.95,1,5,2,8,Potential
22039,47,2,34.98,5,2,1,8,Potential
22040,258,3,37.269999999999996,2,3,1,6,At Risk
22041,38,5,4167.23,5,5,5,15,Champions
22042,317,1,539.99,1,1,3,5,At Risk
22043,298,4,588.96,1,4,3,8,Potential
22044,293,4,607.96,1,4,3,8,Potential
22045,291,4,561.9200000000001,1,4,3,8,Potential
22046,299,3,563.77,1,3,3,7,Potential
22047,131,3,23.97,4,3,1,8,Potential
22048,295,2,548.98,1,2,3,6,At Risk
22049,269,2,14.98,2,2,1,5,At Risk
22050,227,5,4160.53,2,5,5,12,Loyal
22051,38,3,49.970000000000006,5,3,2,10,Loyal
22052,354,2,14.98,1,2,1,4,At Risk
22053,115,1,9.99,4,1,1,6,At Risk
22054,292,3,563.77,1,3,3,7,Potential
22055,353,3,23.97,1,3,1,5,At Risk
22056,144,2,34.98,3,2,1,6,At Risk
22057,18,3,69.97,5,3,2,10,Recent Customer
22058,59,2,4118.26,5,2,5,12,Loyal
22059,303,2,7.28,1,2,1,4,At Risk
22060,328,3,37.269999999999996,1,3,1,5,At Risk
22061,34,2,1145.48,5,2,3,10,Loyal
22062,40,1,1120.49,5,1,3,9,Potential
22063,14,2,78.97999999999999,5,2,2,9,Recent Customer
22064,347,1,69.99,1,1,2,4,At Risk
22065,337,1,69.99,1,1,2,4,At Risk
22066,303,1,539.99,1,1,3,5,At Risk
22067,278,1,539.99,2,1,3,6,At Risk
22068,292,3,23.97,1,3,1,5,At Risk
22069,184,3,22.93,3,3,1,7,Potential
22070,176,2,14.98,3,2,1,6,At Risk
22071,267,4,73.96000000000001,2,4,2,8,Potential
22072,304,4,617.47,1,4,3,8,Potential
22073,251,4,74.46,2,4,2,8,Potential
22074,276,3,553.97,2,3,3,8,Potential
22075,124,5,144.45,4,5,3,12,Loyal
22076,248,4,65.95,2,4,2,8,Potential
22077,298,1,29.99,1,1,1,3,At Risk
22078,276,3,563.77,2,3,3,8,Potential
22079,112,2,24.27,4,2,1,7,Potential
22080,62,2,56.97,5,2,2,9,Potential
22081,299,1,29.99,1,1,1,3,At Risk
22082,291,2,574.98,1,2,3,6,At Risk
22083,155,3,154.98,3,3,3,9,Potential
22084,113,3,69.97,4,3,2,9,Potential
22085,177,2,34.98,3,2,1,6,At Risk
22086,231,1,29.99,2,1,1,4,At Risk
22087,203,4,94.46000000000001,3,4,3,10,Loyal
22088,290,3,570.47,1,3,3,7,Potential
22089,296,3,553.97,1,3,3,7,Potential
22090,354,2,32.28,1,2,1,4,At Risk
22091,279,2,548.98,2,2,3,7,Potential
22092,292,3,563.77,1,3,3,7,Potential
22093,258,4,588.96,2,4,3,9,Potential
22094,266,1,539.99,2,1,3,6,At Risk
22095,80,2,141.98,4,2,3,9,Potential
22096,271,4,133.47,2,4,3,9,Potential
22097,347,3,61.96,1,3,2,6,At Risk
22098,215,3,69.97,2,3,2,7,Potential
22099,261,3,563.77,2,3,3,8,Potential
22100,174,4,90.95,3,4,2,9,Potential
22101,115,2,32.28,4,2,1,7,Potential
22102,115,3,84.97,4,3,2,9,Potential
22103,251,3,69.97,2,3,2,7,Potential
22104,267,3,553.97,2,3,3,8,Potential
22105,28,4,45.22,5,4,2,11,Recent Customer
22106,263,3,553.97,2,3,3,8,Potential
22107,231,2,71.97,2,2,2,6,At Risk
22108,286,3,84.97,2,3,2,7,Potential
22109,384,3,5971.33,1,3,5,9,Potential
22110,36,2,34.98,5,2,1,8,Potential
22111,59,2,1174.48,5,2,4,11,Loyal
22112,343,4,6047.32,1,4,5,10,Loyal
22113,257,4,588.96,2,4,3,9,Potential
22114,244,5,4183.2300000000005,2,5,5,12,Loyal
22115,267,3,624.97,2,3,3,8,Potential
22116,246,3,563.77,2,3,3,8,Potential
22117,199,4,4158.24,3,4,5,12,Loyal
22118,187,4,4158.24,3,4,5,12,Loyal
22119,246,3,563.77,2,3,3,8,Potential
22120,331,2,5962.34,1,2,5,8,Potential
22121,246,3,5997.33,2,3,5,10,Loyal
22122,291,4,94.46000000000001,1,4,3,8,Potential
22123,250,1,29.99,2,1,1,4,At Risk
22124,78,2,34.98,4,2,1,7,Potential
22125,324,2,34.98,1,2,1,4,At Risk
22126,162,2,34.98,3,2,1,6,At Risk
22127,265,3,89.97,2,3,2,7,Potential
22128,188,5,4142.2300000000005,3,5,5,13,Champions
22129,261,2,574.98,2,2,3,7,Potential
22130,265,2,574.98,2,2,3,7,Potential
22131,255,2,561.48,2,2,3,7,Potential
22132,246,4,562.96,2,4,3,9,Potential
22133,255,4,556.26,2,4,3,9,Potential
22134,126,5,144.45,4,5,3,12,Loyal
22135,268,2,574.98,2,2,3,7,Potential
22136,268,3,553.97,2,3,3,8,Potential
22137,55,4,1184.46,5,4,4,13,Champions
22138,287,3,37.269999999999996,2,3,1,6,At Risk
22139,262,2,548.98,2,2,3,7,Potential
22140,35,1,1120.49,5,1,3,9,Potential
22141,156,3,166.28,3,3,3,9,Potential
22142,308,5,71.94,1,5,2,8,Potential
22143,348,2,39.980000000000004,1,2,1,4,At Risk
22144,200,3,89.97,3,3,2,8,Potential
22145,313,3,37.269999999999996,1,3,1,5,At Risk
22146,49,3,37.269999999999996,5,3,1,9,Potential
22147,158,1,69.99,3,1,2,6,At Risk
22148,221,1,69.99,2,1,2,5,At Risk
22149,30,2,123.97999999999999,5,2,3,10,Recent Customer
22150,324,1,69.99,1,1,2,4,At Risk
22151,143,2,133.49,3,2,3,8,Potential
22152,53,3,1205.47,5,3,4,12,Loyal
22153,246,2,548.98,2,2,3,7,Potential
22154,359,3,36.96,1,3,1,5,At Risk
22155,144,1,69.99,3,1,2,6,At Risk
22156,329,1,69.99,1,1,2,4,At Risk
22157,113,2,32.28,4,2,1,7,Potential
22158,237,3,37.269999999999996,2,3,1,6,At Risk
22159,49,2,32.28,5,2,1,8,Potential
22160,240,3,37.269999999999996,2,3,1,6,At Risk
22161,40,5,71.94,5,5,2,12,Loyal
22162,238,3,69.97,2,3,2,7,Potential
22163,359,3,37.269999999999996,1,3,1,5,At Risk
22164,233,3,563.77,2,3,3,8,Potential
22165,256,3,191.28,2,3,3,8,Potential
22166,231,3,69.97,2,3,2,7,Potential
22167,353,2,123.97999999999999,1,2,3,6,At Risk
22168,245,4,2997.3199999999997,2,4,4,10,Loyal
22169,224,2,78.97999999999999,2,2,2,6,At Risk
22170,271,4,2745.3325000000004,2,4,4,10,Loyal
22171,259,2,2721.5525,2,2,4,8,Potential
22172,250,8,2932.3025000000002,2,5,4,11,Loyal
22173,268,4,2735.5325,2,4,4,10,Loyal
22174,274,3,3007.83,2,3,4,9,Potential
22175,272,3,3018.33,2,3,4,9,Potential
22176,208,4,100.46000000000001,2,4,3,9,Potential
22177,200,2,24.27,3,2,1,6,At Risk
22178,77,4,4233.32,4,4,5,13,Champions
22179,228,1,21.98,2,1,1,4,At Risk
22180,85,3,4632.8625,4,3,5,12,Loyal
22181,82,5,4673.8825,4,5,5,14,Champions
22182,215,4,6006.32,2,4,5,11,Loyal
22183,104,2,32.28,4,2,1,7,Potential
22184,108,3,37.269999999999996,4,3,1,8,Potential
22185,309,2,38.98,1,2,1,4,At Risk
22186,37,2,1174.48,5,2,4,11,Loyal
22187,28,2,32.28,5,2,1,8,Recent Customer
22188,40,3,1179.97,5,3,4,12,Loyal
22189,223,2,548.98,2,2,3,7,Potential
22190,99,3,37.269999999999996,4,3,1,8,Potential
22191,257,4,94.46000000000001,2,4,3,9,Potential
22192,219,3,84.97,2,3,2,7,Potential
22193,90,2,4886.7,4,2,5,11,Loyal
22194,64,3,4633.9025,5,3,5,13,Champions
22195,57,5,4909.67,5,5,5,15,Champions
22196,56,3,4632.8625,5,3,5,13,Champions
22197,56,6,4740.9825,5,5,5,15,Champions
22198,60,4,4661.5025000000005,5,4,5,14,Champions
22199,51,5,4693.8825,5,5,5,15,Champions
22200,45,3,4659.9025,5,3,5,13,Champions
22201,51,6,5012.2699999999995,5,5,5,15,Champions
22202,32,6,4671.7425,5,5,5,15,Champions
22203,56,2,4624.9125,5,2,5,12,Loyal
22204,198,3,42.28,3,3,2,8,Potential
22205,193,3,120.48,3,3,3,9,Potential
22206,170,4,201.28,3,4,3,10,Loyal
22207,33,3,4921.69,5,3,5,13,Champions
22208,304,3,42.28,1,3,2,6,At Risk
22209,271,3,74.98,2,3,2,7,Potential
22210,232,1,35.0,2,1,1,4,At Risk
22211,259,3,37.269999999999996,2,3,1,6,At Risk
22212,271,2,39.99,2,2,2,6,At Risk
22213,336,3,59.27,1,3,2,6,At Risk
22214,122,3,42.28,4,3,2,9,Potential
22215,290,4,78.96,1,4,2,7,Potential
22216,232,2,564.48,2,2,3,7,Potential
22217,12,4,61.45,5,4,2,11,Recent Customer
22218,36,2,1155.48,5,2,3,10,Loyal
22219,68,2,12.940000000000001,5,2,1,8,Potential
22220,34,3,1179.97,5,3,4,12,Loyal
22221,46,2,1155.48,5,2,3,10,Loyal
22222,41,4,94.46000000000001,5,4,3,12,Loyal
22223,124,2,34.98,4,2,1,7,Potential
22224,233,5,624.95,2,5,3,10,Loyal
22225,216,2,603.49,2,2,3,7,Potential
22226,317,2,34.98,1,2,1,4,At Risk
22227,309,2,34.98,1,2,1,4,At Risk
22228,90,3,37.269999999999996,4,3,1,8,Potential
22229,56,3,1147.77,5,3,3,11,Loyal
22230,126,5,4223.23,4,5,5,14,Champions
22231,244,4,608.96,2,4,3,9,Potential
22232,227,5,5985.31,2,5,5,12,Loyal
22233,229,3,5997.33,2,3,5,10,Loyal
22234,201,4,5976.32,3,4,5,12,Loyal
22235,41,2,1155.48,5,2,3,10,Loyal
22236,33,3,1179.97,5,3,4,12,Loyal
22237,186,1,29.99,3,1,1,5,At Risk
22238,33,2,1155.48,5,2,3,10,Loyal
22239,212,2,32.28,2,2,1,5,At Risk
22240,239,2,32.28,2,2,1,5,At Risk
22241,49,3,1149.47,5,3,3,11,Loyal
22242,329,3,37.269999999999996,1,3,1,5,At Risk
22243,56,2,1170.48,5,2,4,11,Loyal
22244,299,1,29.99,1,1,1,3,At Risk
22245,52,4,1188.46,5,4,4,13,Champions
22246,58,2,1170.48,5,2,4,11,Loyal
22247,199,5,5978.610000000001,3,5,5,13,Champions
22248,59,3,1134.47,5,3,3,11,Loyal
22249,216,1,539.99,2,1,3,6,At Risk
22250,216,2,548.98,2,2,3,7,Potential
22251,158,3,5971.33,3,3,5,11,Loyal
22252,182,4,6047.32,3,4,5,12,Loyal
22253,32,2,1174.48,5,2,4,11,Loyal
22254,381,3,553.97,1,3,3,7,Potential
22255,217,3,599.47,2,3,3,8,Potential
22256,242,3,570.47,2,3,3,8,Potential
22257,237,1,539.99,2,1,3,6,At Risk
22258,227,2,548.98,2,2,3,7,Potential
22259,386,4,562.96,1,4,3,8,Potential
22260,387,3,563.77,1,3,3,7,Potential
22261,397,2,561.48,1,2,3,6,At Risk
22262,372,1,539.99,1,1,3,5,At Risk
22263,7,2,34.98,5,2,1,8,Recent Customer
22264,233,3,89.97,2,3,2,7,Potential
22265,325,1,21.98,1,1,1,3,At Risk
22266,217,4,724.47,2,4,3,9,Potential
22267,120,5,4167.2300000000005,4,5,5,14,Champions
22268,156,5,6031.31,3,5,5,13,Champions
22269,190,4,94.46000000000001,3,4,3,10,Loyal
22270,236,4,608.96,2,4,3,9,Potential
22271,224,5,612.95,2,5,3,10,Loyal
22272,222,4,571.72,2,4,3,9,Potential
22273,377,2,574.98,1,2,3,6,At Risk
22274,373,2,574.98,1,2,3,6,At Risk
22275,355,3,615.47,1,3,3,7,Potential
22276,361,3,599.47,1,3,3,7,Potential
22277,4,1,29.99,5,1,1,7,Recent Customer
22278,319,2,7.28,1,2,1,4,At Risk
22279,56,1,29.99,5,1,1,7,Potential
22280,257,2,32.28,2,2,1,5,At Risk
22281,348,1,539.99,1,1,3,5,At Risk
22282,364,2,574.98,1,2,3,6,At Risk
22283,162,4,157.27,3,4,3,10,Loyal
22284,366,4,600.46,1,4,3,8,Potential
22285,199,3,89.97,3,3,2,8,Potential
22286,262,2,34.98,2,2,1,5,At Risk
22287,345,1,539.99,1,1,3,5,At Risk
22288,356,2,561.48,1,2,3,6,At Risk
22289,357,2,561.48,1,2,3,6,At Risk
22290,238,4,600.46,2,4,3,9,Potential
22291,243,2,574.98,2,2,3,7,Potential
22292,217,3,553.97,2,3,3,8,Potential
22293,237,2,561.48,2,2,3,7,Potential
22294,221,5,650.45,2,5,3,10,Loyal
22295,220,4,600.46,2,4,3,9,Potential
22296,94,5,132.95,4,5,3,12,Loyal
22297,227,4,600.46,2,4,3,9,Potential
22298,189,4,578.46,3,4,3,10,Loyal
22299,93,4,4145.54,4,4,5,13,Champions
22300,341,2,548.98,1,2,3,6,At Risk
22301,357,1,539.99,1,1,3,5,At Risk
22302,203,3,1763.97,3,3,4,10,Loyal
22303,46,1,21.49,5,1,1,7,Potential
22304,191,3,37.269999999999996,3,3,1,7,Potential
22305,24,4,119.96000000000001,5,4,3,12,Recent Customer
22306,269,2,561.48,2,2,3,7,Potential
22307,120,3,804.47,4,3,3,10,Loyal
22308,213,4,1768.96,2,4,4,10,Loyal
22309,169,3,1785.97,3,3,4,10,Loyal
22310,219,3,93.97,2,3,3,8,Potential
22311,198,4,1739.46,3,4,4,11,Loyal
22312,383,3,2478.24,1,3,4,8,Potential
22313,179,2,1735.98,3,2,4,9,Potential
22314,181,3,84.47,3,3,2,8,Potential
22315,98,2,39.980000000000004,4,2,1,7,Potential
22316,245,4,617.47,2,4,3,9,Potential
22317,334,2,13.98,1,2,1,4,At Risk
22318,34,2,1174.48,5,2,4,11,Loyal
22319,249,3,553.97,2,3,3,8,Potential
22320,176,2,1735.98,3,2,4,9,Potential
22321,170,1,1700.99,3,1,4,8,Potential
22322,271,4,600.46,2,4,3,9,Potential
22323,373,1,2443.35,1,1,4,6,At Risk
22324,307,1,24.99,1,1,1,3,At Risk
22325,184,2,13.98,3,2,1,6,At Risk
22326,84,3,40.23,4,3,2,9,Potential
22327,347,2,574.98,1,2,3,6,At Risk
22328,355,2,548.98,1,2,3,6,At Risk
22329,339,2,574.98,1,2,3,6,At Risk
22330,366,4,608.96,1,4,3,8,Potential
22331,14,2,14.98,5,2,1,8,Recent Customer
22332,227,2,39.980000000000004,2,2,1,5,At Risk
22333,331,3,69.97,1,3,2,6,At Risk
22334,340,2,548.98,1,2,3,6,At Risk
22335,324,4,578.46,1,4,3,8,Potential
22336,309,4,600.46,1,4,3,8,Potential
22337,107,3,49.970000000000006,4,3,2,9,Potential
22338,361,3,68.97,1,3,2,6,At Risk
22339,181,2,14.98,3,2,1,6,At Risk
22340,149,2,14.98,3,2,1,6,At Risk
22341,2,4,73.96000000000001,5,4,2,11,Recent Customer
22342,120,3,68.97,4,3,2,9,Potential
22343,300,4,2422.54,1,4,4,9,Potential
22344,246,2,2419.06,2,2,4,8,Potential
22345,346,3,73.97,1,3,2,6,At Risk
22346,334,2,574.98,1,2,3,6,At Risk
22347,133,3,49.970000000000006,4,3,2,9,Potential
22348,248,2,14.98,2,2,1,5,At Risk
22349,165,2,124.99,3,2,3,8,Potential
22350,102,2,14.98,4,2,1,7,Potential
22351,224,3,69.97,2,3,2,7,Potential
22352,144,1,9.99,3,1,1,5,At Risk
22353,193,2,39.980000000000004,3,2,1,6,At Risk
22354,207,2,39.980000000000004,2,2,1,5,At Risk
22355,239,1,9.99,2,1,1,4,At Risk
22356,3,3,49.970000000000006,5,3,2,10,Recent Customer
22357,15,3,49.970000000000006,5,3,2,10,Recent Customer
22358,252,2,38.98,2,2,1,5,At Risk
22359,271,2,7.28,2,2,1,5,At Risk
22360,186,5,58.95,3,5,2,10,Loyal
22361,220,2,34.98,2,2,1,5,At Risk
22362,141,2,34.98,3,2,1,6,At Risk
22363,217,2,56.97,2,2,2,6,At Risk
22364,195,4,45.22,3,4,2,9,Potential
22365,356,2,32.28,1,2,1,4,At Risk
22366,176,2,56.97,3,2,2,7,Potential
22367,278,3,69.97,2,3,2,7,Potential
22368,313,3,615.47,1,3,3,7,Potential
22369,232,3,69.97,2,3,2,7,Potential
22370,34,4,160.23,5,4,3,12,Loyal
22371,185,2,39.980000000000004,3,2,1,6,At Risk
22372,328,2,574.98,1,2,3,6,At Risk
22373,151,4,5976.32,3,4,5,12,Loyal
22374,308,4,600.46,1,4,3,8,Potential
22375,139,2,34.98,3,2,1,6,At Risk
22376,229,1,29.99,2,1,1,4,At Risk
22377,108,3,184.48,4,3,3,10,Loyal
22378,296,2,30.479999999999997,1,2,1,4,At Risk
22379,91,3,27.77,4,3,1,8,Potential
22380,301,1,4.99,1,1,1,3,At Risk
22381,256,2,29.479999999999997,2,2,1,5,At Risk
22382,20,1,4.99,5,1,1,7,Recent Customer
22383,181,3,67.97,3,3,2,8,Potential
22384,218,2,39.980000000000004,2,2,1,5,At Risk
22385,140,2,58.980000000000004,3,2,2,7,Potential
22386,131,1,4.99,4,1,1,6,At Risk
22387,106,1,4.99,4,1,1,6,At Risk
22388,310,2,68.49,1,2,2,5,At Risk
22389,17,2,39.980000000000004,5,2,1,8,Recent Customer
22390,200,2,29.479999999999997,3,2,1,6,At Risk
22391,44,2,1174.48,5,2,4,11,Loyal
22392,238,5,642.95,2,5,3,10,Loyal
22393,377,4,588.96,1,4,3,8,Potential
22394,4,2,25.479999999999997,5,2,1,8,Recent Customer
22395,243,4,571.72,2,4,3,9,Potential
22396,172,2,1725.98,3,2,4,9,Potential
22397,246,3,27.77,2,3,1,6,At Risk
22398,368,1,539.99,1,1,3,5,At Risk
22399,270,3,2785.0525,2,3,4,9,Potential
22400,252,5,2737.8225,2,5,4,11,Loyal
22401,260,2,2983.34,2,2,4,8,Potential
22402,247,2,2721.5525,2,2,4,8,Potential
22403,269,1,69.99,2,1,2,5,At Risk
22404,243,2,2983.34,2,2,4,8,Potential
22405,267,2,123.97999999999999,2,2,3,7,Potential
22406,238,3,3018.33,2,3,4,9,Potential
22407,236,3,2756.5425,2,3,4,9,Potential
22408,237,5,2770.5224999999996,2,5,4,11,Loyal
22409,238,3,2746.0424999999996,2,3,4,9,Potential
22410,219,2,2983.34,2,2,4,8,Potential
22411,220,5,2770.5224999999996,2,5,4,11,Loyal
22412,232,3,3018.33,2,3,4,9,Potential
22413,37,2,23.779999999999998,5,2,1,8,Potential
22414,386,2,574.98,1,2,3,6,At Risk
22415,387,3,615.47,1,3,3,7,Potential
22416,176,4,1764.96,3,4,4,11,Loyal
22417,135,1,21.49,3,1,1,5,At Risk
22418,173,4,1732.26,3,4,4,11,Loyal
22419,127,3,60.47,4,3,2,9,Potential
22420,245,2,23.779999999999998,2,2,1,5,At Risk
22421,237,2,58.980000000000004,2,2,2,6,At Risk
22422,133,2,1735.98,4,2,4,10,Loyal
22423,231,3,583.97,2,3,3,8,Potential
22424,297,2,75.48,1,2,2,5,At Risk
22425,97,2,25.479999999999997,4,2,1,7,Potential
22426,217,3,553.97,2,3,3,8,Potential
22427,153,1,1700.99,3,1,4,8,Potential
22428,129,4,1739.46,4,4,4,12,Loyal
22429,151,5,1777.95,3,5,4,12,Loyal
22430,397,4,2638.94,1,4,4,9,Potential
22431,329,3,60.47,1,3,2,6,At Risk
22432,389,4,578.46,1,4,3,8,Potential
22433,152,4,1764.96,3,4,4,11,Loyal
22434,103,2,1735.98,4,2,4,10,Loyal
22435,257,2,23.779999999999998,2,2,1,5,At Risk
22436,379,4,607.96,1,4,3,8,Potential
22437,163,4,1739.46,3,4,4,11,Loyal
22438,238,5,616.95,2,5,3,10,Loyal
22439,95,1,1700.99,4,1,4,9,Potential
22440,225,3,553.97,2,3,3,8,Potential
22441,371,5,597.95,1,5,3,9,Potential
22442,94,2,1709.98,4,2,4,10,Loyal
22443,241,3,553.97,2,3,3,8,Potential
22444,89,3,828.47,4,3,3,10,Loyal
22445,370,5,2490.18,1,5,4,10,Loyal
22446,134,4,1739.46,3,4,4,11,Loyal
22447,82,3,793.76,4,3,3,10,Loyal
22448,342,3,2479.94,1,3,4,8,Potential
22449,339,4,2514.93,1,4,4,9,Potential
22450,92,2,799.48,4,2,3,9,Potential
22451,133,2,1709.98,4,2,4,10,Loyal
22452,153,2,1735.98,3,2,4,9,Potential
22453,74,2,39.980000000000004,4,2,1,7,Potential
22454,83,2,12.940000000000001,4,2,1,7,Potential
22455,355,2,29.479999999999997,1,2,1,4,At Risk
22456,104,3,1728.27,4,3,4,11,Loyal
22457,281,1,4.99,2,1,1,4,At Risk
22458,222,3,563.77,2,3,3,8,Potential
22459,374,1,539.99,1,1,3,5,At Risk
22460,110,2,1750.98,4,2,4,10,Loyal
22461,107,2,1754.98,4,2,4,10,Loyal
22462,355,3,553.97,1,3,3,7,Potential
22463,207,2,574.98,2,2,3,7,Potential
22464,277,1,2443.35,2,1,4,7,Potential
22465,283,4,2492.3199999999997,2,4,4,10,Loyal
22466,213,2,548.98,2,2,3,7,Potential
22467,105,4,1732.26,4,4,4,12,Loyal
22468,74,1,1700.99,4,1,4,9,Potential
22469,320,3,563.77,1,3,3,7,Potential
22470,88,2,1735.98,4,2,4,10,Loyal
22471,190,2,561.48,3,2,3,8,Potential
22472,206,1,539.99,3,1,3,7,Potential
22473,313,4,607.96,1,4,3,8,Potential
22474,53,2,13.98,5,2,1,8,Potential
22475,294,4,98.96000000000001,1,4,3,8,Potential
22476,78,2,58.980000000000004,4,2,2,8,Potential
22477,331,2,574.98,1,2,3,6,At Risk
22478,316,3,553.97,1,3,3,7,Potential
22479,313,4,600.46,1,4,3,8,Potential
22480,208,5,616.95,2,5,3,10,Loyal
22481,334,2,564.48,1,2,3,6,At Risk
22482,21,2,39.980000000000004,5,2,1,8,Recent Customer
22483,56,4,110.46000000000001,5,4,3,12,Loyal
22484,183,4,589.96,3,4,3,10,Loyal
22485,100,2,23.779999999999998,4,2,1,7,Potential
22486,314,4,588.96,1,4,3,8,Potential
22487,181,4,588.96,3,4,3,10,Loyal
22488,277,1,4.99,2,1,1,4,At Risk
22489,48,2,30.479999999999997,5,2,1,8,Potential
22490,171,2,548.98,3,2,3,8,Potential
22491,355,1,4.99,1,1,1,3,At Risk
22492,344,3,67.97,1,3,2,6,At Risk
22493,5,1,4.99,5,1,1,7,Recent Customer
22494,328,1,4.99,1,1,1,3,At Risk
22495,178,4,607.96,3,4,3,10,Loyal
22496,116,3,48.970000000000006,4,3,2,9,Potential
22497,242,2,58.980000000000004,2,2,2,6,At Risk
22498,171,4,35.72,3,4,1,8,Potential
22499,155,2,23.779999999999998,3,2,1,6,At Risk
22500,259,4,2481.8199999999997,2,4,4,10,Loyal
22501,224,6,2566.7999999999997,2,5,4,11,Loyal
22502,153,2,1735.98,3,2,4,9,Potential
22503,142,3,1775.47,3,3,4,10,Loyal
22504,153,2,1735.98,3,2,4,9,Potential
22505,90,2,1735.98,4,2,4,10,Loyal
22506,279,2,561.48,2,2,3,7,Potential
22507,219,3,48.970000000000006,2,3,2,7,Potential
22508,78,2,799.48,4,2,3,9,Potential
22509,81,3,804.47,4,3,3,10,Loyal
22510,119,3,1763.97,4,3,4,11,Loyal
22511,184,3,80.47,3,3,2,8,Potential
22512,170,2,30.479999999999997,3,2,1,6,At Risk
22513,280,2,23.779999999999998,2,2,1,5,At Risk
22514,15,2,58.980000000000004,5,2,2,9,Recent Customer
22515,172,3,553.97,3,3,3,9,Potential
22516,230,1,4.99,2,1,1,4,At Risk
22517,285,4,562.96,2,4,3,9,Potential
22518,75,2,1735.98,4,2,4,10,Loyal
22519,90,4,921.77,4,4,3,11,Loyal
22520,107,3,1775.47,4,3,4,11,Loyal
22521,27,1,4.99,5,1,1,7,Recent Customer
22522,294,1,539.99,1,1,3,5,At Risk
22523,41,4,806.76,5,4,3,12,Loyal
22524,239,3,2478.24,2,3,4,9,Potential
22525,285,2,574.98,2,2,3,7,Potential
22526,71,4,1732.26,5,4,4,13,Champions
22527,315,2,75.48,1,2,2,5,At Risk
22528,174,2,39.980000000000004,3,2,1,6,At Risk
22529,173,2,23.779999999999998,3,2,1,6,At Risk
22530,127,1,4.99,4,1,1,6,At Risk
22531,119,3,184.48,4,3,3,10,Loyal
22532,57,1,4.99,5,1,1,7,Potential
22533,63,2,29.479999999999997,5,2,1,8,Potential
22534,41,2,25.479999999999997,5,2,1,8,Potential
22535,74,2,1750.98,4,2,4,10,Loyal
22536,73,3,1775.47,5,3,4,12,Loyal
22537,46,2,13.98,5,2,1,8,Potential
22538,5,1,21.49,5,1,1,7,Recent Customer
22539,248,4,98.96000000000001,2,4,3,9,Potential
22540,280,2,29.479999999999997,2,2,1,5,At Risk
22541,275,4,588.96,2,4,3,9,Potential
22542,97,2,23.779999999999998,4,2,1,7,Potential
22543,315,4,562.96,1,4,3,8,Potential
22544,359,3,127.28,1,3,3,7,Potential
22545,177,3,48.97,3,3,2,8,Potential
22546,161,1,29.99,3,1,1,5,At Risk
22547,267,3,37.269999999999996,2,3,1,6,At Risk
22548,27,3,37.269999999999996,5,3,1,9,Recent Customer
22549,333,2,34.98,1,2,1,4,At Risk
22550,165,2,29.479999999999997,3,2,1,6,At Risk
22551,92,2,67.49,4,2,2,8,Potential
22552,215,1,21.49,2,1,1,4,At Risk
22553,207,3,48.970000000000006,2,3,2,7,Potential
22554,324,1,4.99,1,1,1,3,At Risk
22555,136,3,143.78,3,3,3,9,Potential
22556,200,3,60.47,3,3,2,8,Potential
22557,182,1,4.99,3,1,1,5,At Risk
22558,248,1,4.99,2,1,1,4,At Risk
22559,350,1,4.99,1,1,1,3,At Risk
22560,281,3,93.97,2,3,3,8,Potential
22561,188,2,25.479999999999997,3,2,1,6,At Risk
22562,321,2,30.479999999999997,1,2,1,4,At Risk
22563,125,2,12.98,4,2,1,7,Potential
22564,119,2,58.980000000000004,4,2,2,8,Potential
22565,71,2,6.28,5,2,1,8,Potential
22566,64,1,1700.99,5,1,4,10,Loyal
22567,234,2,23.779999999999998,2,2,1,5,At Risk
22568,196,1,3.99,3,1,1,5,At Risk
22569,316,3,48.970000000000006,1,3,2,6,At Risk
22570,89,2,1735.98,4,2,4,10,Loyal
22571,238,5,2835.0224999999996,2,5,4,11,Loyal
22572,214,4,2997.3199999999997,2,4,4,10,Loyal
22573,234,2,2721.5525,2,2,4,8,Potential
22574,240,1,69.99,2,1,2,5,At Risk
22575,233,3,3018.33,2,3,4,9,Potential
22576,232,2,2721.5525,2,2,4,8,Potential
22577,214,3,2743.0424999999996,2,3,4,9,Potential
22578,226,4,2735.5325,2,4,4,10,Loyal
22579,241,3,2730.5424999999996,2,3,4,9,Potential
22580,240,5,3051.3099999999995,2,5,4,11,Loyal
22581,239,5,2749.3225,2,5,4,11,Loyal
22582,200,3,2756.5425,3,3,4,10,Loyal
22583,200,6,2821.5125,3,5,4,12,Loyal
22584,217,2,33.98,2,2,1,5,At Risk
22585,246,3,553.97,2,3,3,8,Potential
22586,64,4,1739.46,5,4,4,13,Champions
22587,273,2,548.98,2,2,3,7,Potential
22588,204,3,48.970000000000006,3,3,2,8,Potential
22589,155,1,4.99,3,1,1,5,At Risk
22590,261,3,583.97,2,3,3,8,Potential
22591,251,4,567.76,2,4,3,9,Potential
22592,74,2,1754.98,4,2,4,10,Loyal
22593,156,3,553.97,3,3,3,9,Potential
22594,86,2,1709.98,4,2,4,10,Loyal
22595,207,4,2519.93,2,4,4,10,Loyal
22596,89,2,1750.98,4,2,4,10,Loyal
22597,258,4,615.46,2,4,3,9,Potential
22598,248,5,597.95,2,5,3,10,Loyal
22599,79,1,1700.99,4,1,4,9,Potential
22600,44,2,1735.98,5,2,4,11,Loyal
22601,160,3,565.47,3,3,3,9,Potential
22602,53,2,1754.98,5,2,4,11,Loyal
22603,155,2,561.48,3,2,3,8,Potential
22604,48,2,1735.98,5,2,4,11,Loyal
22605,48,2,1750.98,5,2,4,11,Loyal
22606,268,4,588.96,2,4,3,9,Potential
22607,230,5,609.45,2,5,3,10,Loyal
22608,43,3,1744.97,5,3,4,12,Loyal
22609,236,4,608.96,2,4,3,9,Potential
22610,239,2,574.98,2,2,3,7,Potential
22611,66,3,1775.47,5,3,4,12,Loyal
22612,175,4,561.9200000000001,3,4,3,10,Loyal
22613,384,3,1183.47,1,3,4,8,Potential
22614,376,2,1155.48,1,2,3,6,At Risk
22615,224,1,539.99,2,1,3,6,At Risk
22616,62,2,1735.98,5,2,4,11,Loyal
22617,44,4,806.76,5,4,3,12,Loyal
22618,54,1,1700.99,5,1,4,10,Loyal
22619,48,2,819.48,5,2,3,10,Loyal
22620,354,2,573.98,1,2,3,6,At Risk
22621,283,4,589.96,2,4,3,9,Potential
22622,155,2,58.980000000000004,3,2,2,7,Potential
22623,215,3,553.97,2,3,3,8,Potential
22624,27,2,33.98,5,2,1,8,Recent Customer
22625,338,4,77.96000000000001,1,4,2,7,Potential
22626,175,3,565.47,3,3,3,9,Potential
22627,218,4,588.96,2,4,3,9,Potential
22628,239,4,562.96,2,4,3,9,Potential
22629,237,2,59.980000000000004,2,2,2,6,At Risk
22630,375,3,1164.47,1,3,4,8,Potential
22631,388,3,1149.47,1,3,3,7,Potential
22632,174,4,2492.3199999999997,3,4,4,11,Loyal
22633,266,1,564.99,2,1,3,6,At Risk
22634,37,3,1775.47,5,3,4,12,Loyal
22635,50,3,1728.27,5,3,4,12,Loyal
22636,37,1,1700.99,5,1,4,10,Loyal
22637,55,3,1714.97,5,3,4,12,Loyal
22638,231,2,548.98,2,2,3,7,Potential
22639,343,2,1155.48,1,2,3,6,At Risk
22640,350,3,1149.47,1,3,3,7,Potential
22641,133,4,588.96,4,4,3,11,Loyal
22642,349,3,1198.97,1,3,4,8,Potential
22643,341,1,1120.49,1,1,3,5,At Risk
22644,220,2,603.49,2,2,3,7,Potential
22645,136,3,553.97,3,3,3,9,Potential
22646,347,2,1155.48,1,2,3,6,At Risk
22647,153,2,2563.35,3,2,4,9,Potential
22648,145,2,2475.95,3,2,4,9,Potential
22649,131,4,588.96,4,4,3,11,Loyal
22650,236,2,574.98,2,2,3,7,Potential
22651,129,2,574.98,4,2,3,9,Potential
22652,225,3,553.97,2,3,3,8,Potential
22653,352,4,1188.46,1,4,4,9,Potential
22654,135,3,563.77,3,3,3,9,Potential
22655,197,3,565.47,3,3,3,9,Potential
22656,313,4,1169.46,1,4,4,9,Potential
22657,143,2,39.980000000000004,3,2,1,6,At Risk
22658,84,1,28.99,4,1,1,6,At Risk
22659,81,2,38.980000000000004,4,2,1,7,Potential
22660,16,1,3.99,5,1,1,7,Recent Customer
22661,90,3,68.97,4,3,2,9,Potential
22662,70,1,4.99,5,1,1,7,Potential
22663,127,2,574.98,4,2,3,9,Potential
22664,113,4,2511.3199999999997,4,4,4,12,Loyal
22665,258,2,586.97,2,2,3,7,Potential
22666,227,2,574.98,2,2,3,7,Potential
22667,391,2,1170.48,1,2,4,7,Potential
22668,378,2,1174.48,1,2,4,7,Potential
22669,375,1,1120.49,1,1,3,5,At Risk
22670,321,2,39.980000000000004,1,2,1,4,At Risk
22671,330,2,1155.48,1,2,3,6,At Risk
22672,212,2,29.479999999999997,2,2,1,5,At Risk
22673,137,4,608.96,3,4,3,10,Loyal
22674,211,2,574.98,2,2,3,7,Potential
22675,136,4,628.97,3,4,3,10,Loyal
22676,340,1,28.99,1,1,1,3,At Risk
22677,78,2,12.98,4,2,1,7,Potential
22678,197,3,653.97,3,3,3,9,Potential
22679,151,3,611.96,3,3,3,9,Potential
22680,72,4,620.95,5,4,3,12,Loyal
22681,233,5,131.95000000000002,2,5,3,10,Loyal
22682,12,1,28.99,5,1,1,7,Recent Customer
22683,256,3,58.47,2,3,2,7,Potential
22684,63,2,548.98,5,2,3,10,Loyal
22685,188,4,600.46,3,4,3,10,Loyal
22686,324,6,1243.44,1,5,4,10,Loyal
22687,396,2,1155.48,1,2,3,6,At Risk
22688,188,2,38.980000000000004,3,2,1,6,At Risk
22689,106,2,548.98,4,2,3,9,Potential
22690,96,5,2523.9199999999996,4,5,4,13,Champions
22691,104,3,2457.3299999999995,4,3,4,11,Loyal
22692,75,4,2481.8199999999997,4,4,4,12,Loyal
22693,361,2,1754.98,1,2,4,7,Potential
22694,206,2,574.98,3,2,3,8,Potential
22695,325,2,1174.48,1,2,4,7,Potential
22696,75,3,68.97,4,3,2,9,Potential
22697,329,3,83.97,1,3,2,6,At Risk
22698,291,3,68.97,1,3,2,6,At Risk
22699,67,2,162.99,5,2,3,10,Loyal
22700,195,2,6.28,3,2,1,6,At Risk
22701,209,2,57.980000000000004,2,2,2,6,At Risk
22702,77,1,28.99,4,1,1,6,At Risk
22703,22,3,68.97,5,3,2,10,Recent Customer
22704,228,3,41.93,2,3,2,7,Potential
22705,352,2,38.980000000000004,1,2,1,4,At Risk
22706,13,3,66.97,5,3,2,10,Recent Customer
22707,171,3,62.970000000000006,3,3,2,8,Potential
22708,141,3,88.97,3,3,2,8,Potential
22709,138,1,28.99,3,1,1,5,At Risk
22710,286,1,3.99,2,1,1,4,At Risk
22711,196,4,588.96,3,4,3,10,Loyal
22712,101,2,574.98,4,2,3,9,Potential
22713,35,4,4148.19,5,4,5,14,Champions
22714,218,4,71.95,2,4,2,8,Potential
22715,258,2,85.48,2,2,2,6,At Risk
22716,196,3,553.97,3,3,3,9,Potential
22717,204,2,574.98,3,2,3,8,Potential
22718,185,4,600.46,3,4,3,10,Loyal
22719,195,4,567.76,3,4,3,10,Loyal
22720,34,1,29.99,5,1,1,7,Potential
22721,175,3,37.269999999999996,3,3,1,7,Potential
22722,193,4,562.96,3,4,3,10,Loyal
22723,122,3,69.97,4,3,2,9,Potential
22724,185,3,69.97,3,3,2,8,Potential
22725,179,2,38.98,3,2,1,6,At Risk
22726,32,1,29.99,5,1,1,7,Potential
22727,298,2,34.98,1,2,1,4,At Risk
22728,339,3,149.93,1,3,3,7,Potential
22729,298,3,69.97,1,3,2,6,At Risk
22730,149,1,4.99,3,1,1,5,At Risk
22731,204,3,69.97,3,3,2,8,Potential
22732,55,4,4133.24,5,4,5,14,Champions
22733,209,2,548.98,2,2,3,7,Potential
22734,339,4,73.96000000000001,1,4,2,7,Potential
22735,272,2,34.98,2,2,1,5,At Risk
22736,323,1,29.99,1,1,1,3,At Risk
22737,230,5,165.22,2,5,3,10,Loyal
22738,105,4,119.96000000000001,4,4,3,11,Loyal
22739,350,2,7.28,1,2,1,4,At Risk
22740,83,1,29.99,4,1,1,6,At Risk
22741,311,2,34.98,1,2,1,4,At Risk
22742,331,5,71.94,1,5,2,8,Potential
22743,334,4,65.95,1,4,2,7,Potential
22744,121,5,54.21,4,5,2,11,Loyal
22745,326,4,588.96,1,4,3,8,Potential
22746,196,3,40.23,3,3,2,8,Potential
22747,289,2,32.28,1,2,1,4,At Risk
22748,33,4,4188.24,5,4,5,14,Champions
22749,202,4,600.46,3,4,3,10,Loyal
22750,103,1,29.99,4,1,1,6,At Risk
22751,230,4,133.47,2,4,3,9,Potential
22752,256,2,32.28,2,2,1,5,At Risk
22753,184,4,724.47,3,4,3,10,Loyal
22754,139,3,193.98,3,3,3,9,Potential
22755,48,1,4.99,5,1,1,7,Potential
22756,273,3,69.97,2,3,2,7,Potential
22757,13,4,94.46000000000001,5,4,3,12,Recent Customer
22758,300,4,562.96,1,4,3,8,Potential
22759,225,3,37.269999999999996,2,3,1,6,At Risk
22760,284,2,548.98,2,2,3,7,Potential
22761,133,3,69.97,4,3,2,9,Potential
22762,123,4,94.46000000000001,4,4,3,11,Loyal
22763,112,3,69.97,4,3,2,9,Potential
22764,148,1,29.99,3,1,1,5,At Risk
22765,141,5,5978.610000000001,3,5,5,13,Champions
22766,254,1,29.99,2,1,1,4,At Risk
22767,310,3,69.97,1,3,2,6,At Risk
22768,285,4,600.46,2,4,3,9,Potential
22769,235,1,29.99,2,1,1,4,At Risk
22770,193,1,539.99,3,1,3,7,Potential
22771,21,3,76.96000000000001,5,3,2,10,Recent Customer
22772,312,1,4.99,1,1,1,3,At Risk
22773,92,4,215.96,4,4,3,11,Loyal
22774,35,1,29.99,5,1,1,7,Potential
22775,210,3,37.269999999999996,2,3,1,6,At Risk
22776,244,3,69.97,2,3,2,7,Potential
22777,238,3,193.98,2,3,3,8,Potential
22778,280,4,722.77,2,4,3,9,Potential
22779,15,1,29.99,5,1,1,7,Recent Customer
22780,283,4,722.77,2,4,3,9,Potential
22781,22,3,37.269999999999996,5,3,1,9,Recent Customer
22782,191,4,567.76,3,4,3,10,Loyal
22783,142,3,69.97,3,3,2,8,Potential
22784,205,2,564.48,3,2,3,8,Potential
22785,393,3,6029.57,1,3,5,9,Potential
22786,88,3,37.269999999999996,4,3,1,8,Potential
22787,208,4,620.46,2,4,3,9,Potential
22788,200,4,603.96,3,4,3,10,Loyal
22789,196,2,574.98,3,2,3,8,Potential
22790,188,2,574.98,3,2,3,8,Potential
22791,281,4,600.46,2,4,3,9,Potential
22792,173,3,69.97,3,3,2,8,Potential
22793,127,3,69.97,4,3,2,9,Potential
22794,331,2,27.279999999999998,1,2,1,4,At Risk
22795,342,3,67.97,1,3,2,6,At Risk
22796,258,3,48.970000000000006,2,3,2,7,Potential
22797,40,3,2309.9699999999993,5,3,4,12,Loyal
22798,267,1,24.99,2,1,1,4,At Risk
22799,67,2,34.98,5,2,1,8,Potential
22800,52,3,2359.9799999999996,5,3,4,12,Loyal
22801,138,1,4.99,3,1,1,5,At Risk
22802,8,1,4.99,5,1,1,7,Recent Customer
22803,40,3,2364.9799999999996,5,3,4,12,Loyal
22804,298,2,53.980000000000004,1,2,2,5,At Risk
22805,54,1,3.99,5,1,1,7,Potential
22806,106,2,38.980000000000004,4,2,1,7,Potential
22807,17,5,71.94,5,5,2,12,Recent Customer
22808,375,2,2478.3399999999997,1,2,4,7,Potential
22809,30,2,38.980000000000004,5,2,1,8,Recent Customer
22810,38,2,2354.9799999999996,5,2,4,11,Loyal
22811,73,2,34.98,5,2,1,8,Potential
22812,168,2,32.28,3,2,1,6,At Risk
22813,94,4,119.96000000000001,4,4,3,11,Loyal
22814,311,1,4.99,1,1,1,3,At Risk
22815,154,2,12.98,3,2,1,6,At Risk
22816,47,5,2340.9399999999996,5,5,4,14,Champions
22817,47,6,2400.93,5,5,4,14,Champions
22818,365,3,56.96,1,3,2,6,At Risk
22819,166,3,69.97,3,3,2,8,Potential
22820,4,2,29.479999999999997,5,2,1,8,Recent Customer
22821,236,2,38.980000000000004,2,2,1,5,At Risk
22822,394,2,2475.95,1,2,4,7,Potential
22823,141,3,43.97,3,3,2,8,Potential
22824,46,2,2304.9799999999996,5,2,4,11,Loyal
22825,145,4,78.96000000000001,3,4,2,9,Potential
22826,320,2,34.98,1,2,1,4,At Risk
22827,236,3,89.97,2,3,2,7,Potential
22828,380,2,2451.2999999999997,1,2,4,7,Potential
22829,55,1,4.99,5,1,1,7,Potential
22830,33,3,14.23,5,3,1,9,Potential
22831,273,2,39.980000000000004,2,2,1,5,At Risk
22832,322,2,13.98,1,2,1,4,At Risk
22833,98,2,29.479999999999997,4,2,1,7,Potential
22834,145,2,12.98,3,2,1,6,At Risk
22835,321,2,38.980000000000004,1,2,1,4,At Risk
22836,52,3,2334.9799999999996,5,3,4,12,Loyal
22837,139,3,69.97,3,3,2,8,Potential
22838,195,1,29.99,3,1,1,5,At Risk
22839,358,4,39.25,1,4,1,6,At Risk
22840,100,2,37.29,4,2,1,7,Potential
22841,330,1,35.0,1,1,1,3,At Risk
22842,226,4,86.46,2,4,2,8,Potential
22843,292,3,48.980000000000004,1,3,2,6,At Risk
22844,304,2,39.99,1,2,2,5,At Risk
22845,34,3,4633.9025,5,3,5,13,Champions
22846,364,3,74.98,1,3,2,6,At Risk
22847,263,2,37.29,2,2,1,5,At Risk
22848,358,2,39.99,1,2,2,5,At Risk
22849,51,4,50.230000000000004,5,4,2,11,Loyal
22850,42,3,4657.512500000001,5,3,5,13,Champions
22851,58,3,4632.862499999999,5,3,5,13,Champions
22852,70,2,39.99,5,2,2,9,Potential
22853,247,2,39.99,2,2,2,6,At Risk
22854,42,3,4659.9025,5,3,5,13,Champions
22855,62,4,70.96000000000001,5,4,2,11,Loyal
22856,188,1,4.99,3,1,1,5,At Risk
22857,54,2,4886.7,5,2,5,12,Loyal
22858,13,1,4.99,5,1,1,7,Recent Customer
22859,198,1,4.99,3,1,1,5,At Risk
22860,35,5,4663.7925,5,5,5,15,Champions
22861,189,3,69.97,3,3,2,8,Potential
22862,185,1,539.99,3,1,3,7,Potential
22863,285,1,29.99,2,1,1,4,At Risk
22864,190,4,571.72,3,4,3,10,Loyal
22865,119,3,37.269999999999996,4,3,1,8,Potential
22866,310,2,6.28,1,2,1,4,At Risk
22867,182,2,38.980000000000004,3,2,1,6,At Risk
22868,47,2,33.98,5,2,1,8,Potential
22869,132,2,39.980000000000004,4,2,1,7,Potential
22870,280,3,68.97,2,3,2,7,Potential
22871,189,2,561.48,3,2,3,8,Potential
22872,195,1,539.99,3,1,3,7,Potential
22873,192,1,539.99,3,1,3,7,Potential
22874,283,2,548.98,2,2,3,7,Potential
22875,291,4,556.26,1,4,3,8,Potential
22876,286,2,574.98,2,2,3,7,Potential
22877,111,2,5962.34,4,2,5,11,Loyal
22878,295,3,553.97,1,3,3,7,Potential
22879,290,4,562.96,1,4,3,8,Potential
22880,277,2,548.98,2,2,3,7,Potential
22881,72,3,5997.33,5,3,5,13,Champions
22882,156,4,101.45,3,4,3,10,Loyal
22883,314,1,29.99,1,1,1,3,At Risk
22884,34,2,34.98,5,2,1,8,Potential
22885,305,2,548.98,1,2,3,6,At Risk
22886,288,3,599.47,2,3,3,8,Potential
22887,277,4,578.46,2,4,3,9,Potential
22888,278,1,539.99,2,1,3,6,At Risk
22889,65,3,5971.33,5,3,5,13,Champions
22890,81,3,69.97,4,3,2,9,Potential
22891,262,3,69.97,2,3,2,7,Potential
22892,157,2,561.48,3,2,3,8,Potential
22893,350,4,6056.51,1,4,5,10,Loyal
22894,328,2,32.28,1,2,1,4,At Risk
22895,366,3,6029.57,1,3,5,9,Potential
22896,303,4,600.46,1,4,3,8,Potential
22897,266,4,561.9200000000001,2,4,3,9,Potential
22898,272,1,539.99,2,1,3,6,At Risk
22899,274,4,600.46,2,4,3,9,Potential
22900,258,1,539.99,2,1,3,6,At Risk
22901,84,3,5971.33,4,3,5,12,Loyal
22902,130,2,32.28,4,2,1,7,Potential
22903,275,3,6054.219999999999,2,3,5,10,Loyal
22904,37,6,4759.9925,5,5,5,15,Champions
22905,35,2,4624.9125,5,2,5,12,Loyal
22906,60,2,4624.9125,5,2,5,12,Loyal
22907,67,3,4169.33,5,3,5,13,Champions
22908,54,4,4661.5025000000005,5,4,5,14,Champions
22909,85,5,3980.5224999999996,4,5,5,14,Champions
22910,73,2,3882.5525,5,2,5,12,Loyal
22911,156,2,39.980000000000004,3,2,1,6,At Risk
22912,35,3,4659.9025,5,3,5,13,Champions
22913,55,4,4684.3925,5,4,5,14,Champions
22914,300,2,59.980000000000004,1,2,2,5,At Risk
22915,216,2,13.98,2,2,1,5,At Risk
22916,141,2,58.980000000000004,3,2,2,7,Potential
22917,332,1,4.99,1,1,1,3,At Risk
22918,115,1,4.99,4,1,1,6,At Risk
22919,170,2,58.980000000000004,3,2,2,7,Potential
22920,64,4,91.95,5,4,2,11,Loyal
22921,36,5,4647.8825,5,5,5,15,Champions
22922,186,3,68.97,3,3,2,8,Potential
22923,32,1,21.98,5,1,1,7,Potential
22924,352,4,90.95,1,4,2,7,Potential
22925,148,6,134.93,3,5,3,11,Loyal
22926,43,3,3936.5425,5,3,5,13,Champions
22927,42,5,3913.8225,5,5,5,15,Champions
22928,230,2,58.980000000000004,2,2,2,6,At Risk
22929,57,5,4673.8825,5,5,5,15,Champions
22930,33,4,4900.679999999999,5,4,5,14,Champions
22931,375,2,3882.5525,1,2,5,8,Potential
22932,380,3,4169.33,1,3,5,9,Potential
22933,56,3,3917.5425,5,3,5,13,Champions
22934,49,4,4173.32,5,4,5,14,Champions
22935,57,5,3951.5225,5,5,5,15,Champions
22936,47,5,3946.5225,5,5,5,15,Champions
22937,42,3,4179.33,5,3,5,13,Champions
22938,49,4,4173.32,5,4,5,14,Champions
22939,48,4,3961.0325,5,4,5,14,Champions
22940,389,4,4207.32,1,4,5,10,Loyal
22941,209,2,58.980000000000004,2,2,2,6,At Risk
22942,58,4,3971.5325,5,4,5,14,Champions
22943,44,2,4144.34,5,2,5,12,Loyal
22944,267,3,64.47,2,3,2,7,Potential
22945,315,2,12.940000000000001,1,2,1,4,At Risk
22946,341,4,3911.5325000000003,1,4,5,10,Loyal
22947,332,2,75.97,1,2,2,5,At Risk
22948,273,2,39.980000000000004,2,2,1,5,At Risk
22949,286,2,71.97,2,2,2,6,At Risk
22950,361,3,3917.5425,1,3,5,9,Potential
22951,312,5,4242.3099999999995,1,5,5,11,Loyal
22952,340,2,39.980000000000004,1,2,1,4,At Risk
22953,309,4,3899.4925000000003,1,4,5,10,Loyal
22954,312,3,4179.33,1,3,5,9,Potential
22955,156,2,13.98,3,2,1,6,At Risk
22956,101,3,64.47,4,3,2,9,Potential
22957,171,2,39.980000000000004,3,2,1,6,At Risk
22958,38,5,4208.3099999999995,5,5,5,15,Champions
22959,35,3,3917.5425,5,3,5,13,Champions
22960,133,1,4.99,4,1,1,6,At Risk
22961,311,3,3891.5424999999996,1,3,5,9,Potential
22962,244,2,39.980000000000004,2,2,1,5,At Risk
22963,312,2,58.980000000000004,1,2,2,5,At Risk
22964,247,2,123.97999999999999,2,2,3,7,Potential
22965,130,2,7.28,4,2,1,7,Potential
22966,286,3,3917.5425,2,3,5,10,Loyal
22967,158,3,69.97,3,3,2,8,Potential
22968,249,2,32.28,2,2,1,5,At Risk
22969,21,2,39.980000000000004,5,2,1,8,Recent Customer
22970,348,4,78.96000000000001,1,4,2,7,Potential
22971,935,1,3578.27,1,1,5,7,Potential
22972,246,1,539.99,2,1,3,6,At Risk
22973,32,2,7.28,5,2,1,8,Potential
22974,312,2,7.28,1,2,1,4,At Risk
22975,938,1,3578.27,1,1,5,7,Potential
22976,65,3,5971.33,5,3,5,13,Champions
22977,247,3,69.97,2,3,2,7,Potential
22978,29,3,81.46000000000001,5,3,2,10,Recent Customer
22979,84,4,78.96000000000001,4,4,2,10,Loyal
22980,358,1,29.99,1,1,1,3,At Risk
22981,48,4,91.95,5,4,2,11,Loyal
22982,330,3,69.97,1,3,2,6,At Risk
22983,192,2,7.28,3,2,1,6,At Risk
22984,40,2,34.98,5,2,1,8,Potential
22985,120,4,81.45,4,4,2,10,Loyal
22986,197,3,2756.5425,3,3,4,10,Loyal
22987,55,4,3942.0325,5,4,5,14,Champions
22988,54,3,4194.33,5,3,5,13,Champions
22989,258,3,69.97,2,3,2,7,Potential
22990,280,1,29.99,2,1,1,4,At Risk
22991,240,2,34.98,2,2,1,5,At Risk
22992,260,4,607.96,2,4,3,9,Potential
22993,157,3,565.47,3,3,3,9,Potential
22994,156,1,539.99,3,1,3,7,Potential
22995,214,5,6060.5,2,5,5,12,Loyal
22996,219,4,6035.599999999999,2,4,5,11,Loyal
22997,164,4,607.96,3,4,3,10,Loyal
22998,397,3,5329.25,1,3,5,9,Potential
22999,181,3,553.97,3,3,3,9,Potential
23000,16,4,94.46000000000001,5,4,3,12,Recent Customer
23001,114,3,37.269999999999996,4,3,1,8,Potential
23002,292,5,67.2,1,5,2,8,Potential
23003,282,2,32.28,2,2,1,5,At Risk
23004,91,3,56.96,4,3,2,9,Potential
23005,284,2,32.28,2,2,1,5,At Risk
23006,91,3,39.47,4,3,1,8,Potential
23007,298,2,14.98,1,2,1,4,At Risk
23008,258,2,59.980000000000004,2,2,2,6,At Risk
23009,54,2,7.28,5,2,1,8,Potential
23010,91,3,64.47,4,3,2,9,Potential
23011,213,2,14.98,2,2,1,5,At Risk
23012,144,1,4.99,3,1,1,5,At Risk
23013,223,2,12.940000000000001,2,2,1,5,At Risk
23014,174,2,13.98,3,2,1,6,At Risk
23015,169,3,563.77,3,3,3,9,Potential
23016,177,2,561.48,3,2,3,8,Potential
23017,169,3,563.77,3,3,3,9,Potential
23018,160,4,607.96,3,4,3,10,Loyal
23019,259,5,613.45,2,5,3,10,Loyal
23020,25,6,106.92999999999999,5,5,3,13,Recent Customer
23021,168,2,564.48,3,2,3,8,Potential
23022,250,2,7.28,2,2,1,5,At Risk
23023,310,2,32.28,1,2,1,4,At Risk
23024,261,4,106.95,2,4,3,9,Potential
23025,154,1,29.99,3,1,1,5,At Risk
23026,162,2,603.49,3,2,3,8,Potential
23027,172,3,37.269999999999996,3,3,1,7,Potential
23028,158,4,600.46,3,4,3,10,Loyal
23029,301,4,120.46,1,4,3,8,Potential
23030,152,1,29.99,3,1,1,5,At Risk
23031,166,3,69.97,3,3,2,8,Potential
23032,164,2,548.98,3,2,3,8,Potential
23033,164,4,588.96,3,4,3,10,Loyal
23034,161,1,539.99,3,1,3,7,Potential
23035,168,4,561.9200000000001,3,4,3,10,Loyal
23036,166,5,624.95,3,5,3,11,Loyal
23037,8,2,32.28,5,2,1,8,Recent Customer
23038,261,2,564.48,2,2,3,7,Potential
23039,258,2,561.48,2,2,3,7,Potential
23040,250,3,565.47,2,3,3,8,Potential
23041,171,2,561.48,3,2,3,8,Potential
23042,170,4,589.96,3,4,3,10,Loyal
23043,40,1,29.99,5,1,1,7,Potential
23044,295,3,37.269999999999996,1,3,1,5,At Risk
23045,228,2,34.98,2,2,1,5,At Risk
23046,347,3,37.269999999999996,1,3,1,5,At Risk
23047,171,3,553.97,3,3,3,9,Potential
23048,273,3,51.46,2,3,2,7,Potential
23049,333,2,34.98,1,2,1,4,At Risk
23050,359,3,69.97,1,3,2,6,At Risk
23051,317,2,34.98,1,2,1,4,At Risk
23052,178,1,29.99,3,1,1,5,At Risk
23053,93,3,69.97,4,3,2,9,Potential
23054,199,1,29.99,3,1,1,5,At Risk
23055,162,3,69.97,3,3,2,8,Potential
23056,166,3,599.47,3,3,3,9,Potential
23057,38,4,6021.82,5,4,5,14,Champions
23058,182,4,588.96,3,4,3,10,Loyal
23059,172,4,600.46,3,4,3,10,Loyal
23060,243,6,126.93,2,5,3,10,Loyal
23061,325,1,29.99,1,1,1,3,At Risk
23062,108,4,119.96000000000001,4,4,3,11,Loyal
23063,44,3,37.269999999999996,5,3,1,9,Potential
23064,293,1,29.99,1,1,1,3,At Risk
23065,219,3,69.97,2,3,2,7,Potential
23066,271,4,617.47,2,4,3,9,Potential
23067,243,3,84.97,2,3,2,7,Potential
23068,79,3,37.269999999999996,4,3,1,8,Potential
23069,349,3,69.97,1,3,2,6,At Risk
23070,360,1,4.99,1,1,1,3,At Risk
23071,235,2,32.28,2,2,1,5,At Risk
23072,283,3,37.269999999999996,2,3,1,6,At Risk
23073,166,1,539.99,3,1,3,7,Potential
23074,54,4,6021.82,5,4,5,14,Champions
23075,269,3,563.77,2,3,3,8,Potential
23076,35,1,29.99,5,1,1,7,Potential
23077,312,2,7.28,1,2,1,4,At Risk
23078,206,3,15.23,3,3,1,7,Potential
23079,206,2,7.28,3,2,1,6,At Risk
23080,258,2,548.98,2,2,3,7,Potential
23081,179,4,608.96,3,4,3,10,Loyal
23082,175,2,603.49,3,2,3,8,Potential
23083,178,5,49.9,3,5,2,10,Loyal
23084,224,2,39.980000000000004,2,2,1,5,At Risk
23085,104,2,7.28,4,2,1,7,Potential
23086,311,2,12.940000000000001,1,2,1,4,At Risk
23087,154,2,39.980000000000004,3,2,1,6,At Risk
23088,355,2,32.28,1,2,1,4,At Risk
23089,324,3,37.269999999999996,1,3,1,5,At Risk
23090,160,3,37.269999999999996,3,3,1,7,Potential
23091,66,4,97.96000000000001,5,4,3,12,Loyal
23092,218,1,29.99,2,1,1,4,At Risk
23093,23,3,69.97,5,3,2,10,Recent Customer
23094,277,3,67.93,2,3,2,7,Potential
23095,225,1,4.99,2,1,1,4,At Risk
23096,275,2,7.28,2,2,1,5,At Risk
23097,183,5,2770.5224999999996,3,5,4,12,Loyal
23098,187,4,2745.3325000000004,3,4,4,11,Loyal
23099,199,2,2983.34,3,2,4,9,Potential
23100,201,4,3007.12,3,4,4,11,Loyal
23101,195,6,2795.0125,3,5,4,12,Loyal
23102,198,3,2730.5424999999996,3,3,4,10,Loyal
23103,257,2,85.48,2,2,2,6,At Risk
23104,374,5,3490.0325000000003,1,5,5,11,Loyal
23105,393,4,3361.5325,1,4,5,10,Loyal
23106,287,6,3956.0125,2,5,5,12,Loyal
23107,287,4,3896.5325,2,4,5,11,Loyal
23108,168,2,32.28,3,2,1,6,At Risk
23109,346,3,37.269999999999996,1,3,1,5,At Risk
23110,248,1,539.99,2,1,3,6,At Risk
23111,246,3,553.97,2,3,3,8,Potential
23112,265,2,561.48,2,2,3,7,Potential
23113,57,3,5997.33,5,3,5,13,Champions
23114,50,4,5996.32,5,4,5,14,Champions
23115,333,2,34.98,1,2,1,4,At Risk
23116,278,3,3936.5425,2,3,5,10,Loyal
23117,284,5,3931.5224999999996,2,5,5,12,Loyal
23118,248,5,3913.8225,2,5,5,12,Loyal
23119,248,4,3945.5325,2,4,5,11,Loyal
23120,256,2,4144.34,2,2,5,9,Potential
23121,251,2,4144.34,2,2,5,9,Potential
23122,183,2,13.98,3,2,1,6,At Risk
23123,87,2,39.980000000000004,4,2,1,7,Potential
23124,16,1,29.99,5,1,1,7,Recent Customer
23125,181,2,603.49,3,2,3,8,Potential
23126,50,4,45.22,5,4,2,11,Loyal
23127,263,3,565.47,2,3,3,8,Potential
23128,216,2,39.980000000000004,2,2,1,5,At Risk
23129,268,1,4.99,2,1,1,4,At Risk
23130,347,2,32.28,1,2,1,4,At Risk
23131,120,1,29.99,4,1,1,6,At Risk
23132,318,4,160.23,1,4,3,8,Potential
23133,151,3,69.97,3,3,2,8,Potential
23134,81,2,39.980000000000004,4,2,1,7,Potential
23135,155,3,553.97,3,3,3,9,Potential
23136,145,2,574.98,3,2,3,8,Potential
23137,311,3,5314.25,1,3,5,9,Potential
23138,129,3,599.47,4,3,3,10,Loyal
23139,237,3,553.97,2,3,3,8,Potential
23140,347,2,38.98,1,2,1,4,At Risk
23141,138,2,603.49,3,2,3,8,Potential
23142,138,3,556.9300000000001,3,3,3,9,Potential
23143,231,3,563.77,2,3,3,8,Potential
23144,238,2,548.98,2,2,3,7,Potential
23145,217,2,574.98,2,2,3,7,Potential
23146,128,2,603.49,4,2,3,9,Potential
23147,76,4,157.27,4,4,3,11,Loyal
23148,225,1,539.99,2,1,3,6,At Risk
23149,152,2,32.28,3,2,1,6,At Risk
23150,54,4,49.22,5,4,2,11,Loyal
23151,224,4,607.96,2,4,3,9,Potential
23152,84,3,37.269999999999996,4,3,1,8,Potential
23153,314,2,34.98,1,2,1,4,At Risk
23154,229,3,563.77,2,3,3,8,Potential
23155,233,4,608.96,2,4,3,9,Potential
23156,217,5,616.95,2,5,3,10,Loyal
23157,167,3,69.97,3,3,2,8,Potential
23158,219,3,599.47,2,3,3,8,Potential
23159,127,4,562.96,4,4,3,11,Loyal
23160,134,4,673.97,3,4,3,10,Loyal
23161,151,2,574.98,3,2,3,8,Potential
23162,138,3,563.77,3,3,3,9,Potential
23163,134,4,600.46,3,4,3,10,Loyal
23164,351,4,4807.099999999999,1,4,5,10,Loyal
23165,230,2,548.98,2,2,3,7,Potential
23166,225,3,556.9300000000001,2,3,3,8,Potential
23167,129,1,539.99,4,1,3,8,Potential
23168,149,1,539.99,3,1,3,7,Potential
23169,129,4,685.47,4,4,3,11,Loyal
23170,148,2,574.98,3,2,3,8,Potential
23171,267,4,123.96000000000001,2,4,3,9,Potential
23172,354,5,4809.39,1,5,5,11,Loyal
23173,242,4,588.96,2,4,3,9,Potential
23174,148,3,553.97,3,3,3,9,Potential
23175,146,3,570.47,3,3,3,9,Potential
23176,214,1,539.99,2,1,3,6,At Risk
23177,232,3,553.97,2,3,3,8,Potential
23178,222,1,539.99,2,1,3,6,At Risk
23179,244,1,539.99,2,1,3,6,At Risk
23180,214,3,152.28,2,3,3,8,Potential
23181,194,4,588.96,3,4,3,10,Loyal
23182,20,3,37.269999999999996,5,3,1,9,Recent Customer
23183,209,2,548.98,2,2,3,7,Potential
23184,246,4,45.22,2,4,2,8,Potential
23185,127,5,638.95,4,5,3,12,Loyal
23186,123,2,548.98,4,2,3,9,Potential
23187,133,2,574.98,4,2,3,9,Potential
23188,337,4,119.96000000000001,1,4,3,8,Potential
23189,150,4,600.46,3,4,3,10,Loyal
23190,64,2,14.98,5,2,1,8,Potential
23191,198,2,34.98,3,2,1,6,At Risk
23192,146,2,32.28,3,2,1,6,At Risk
23193,218,2,32.28,2,2,1,5,At Risk
23194,85,3,69.97,4,3,2,9,Potential
23195,199,5,638.95,3,5,3,11,Loyal
23196,237,2,39.980000000000004,2,2,1,5,At Risk
23197,183,2,38.98,3,2,1,6,At Risk
23198,303,2,34.98,1,2,1,4,At Risk
23199,197,4,45.22,3,4,2,9,Potential
23200,237,4,91.95,2,4,2,8,Potential
23201,169,1,29.99,3,1,1,5,At Risk
23202,86,2,32.28,4,2,1,7,Potential
23203,97,3,69.97,4,3,2,9,Potential
23204,186,4,562.96,3,4,3,10,Loyal
23205,265,3,69.97,2,3,2,7,Potential
23206,178,3,69.97,3,3,2,8,Potential
23207,175,1,29.99,3,1,1,5,At Risk
23208,181,2,59.980000000000004,3,2,2,7,Potential
23209,351,3,4802.11,1,3,5,9,Potential
23210,99,3,553.97,4,3,3,10,Loyal
23211,108,3,583.97,4,3,3,10,Loyal
23212,67,1,29.99,5,1,1,7,Potential
23213,99,4,617.47,4,4,3,11,Loyal
23214,102,3,628.97,4,3,3,10,Loyal
23215,128,4,49.96,4,4,2,10,Loyal
23216,185,5,613.45,3,5,3,11,Loyal
23217,210,3,563.77,2,3,3,8,Potential
23218,45,2,38.980000000000004,5,2,1,8,Potential
23219,280,2,39.980000000000004,2,2,1,5,At Risk
23220,309,2,1174.48,1,2,4,7,Potential
23221,200,2,38.980000000000004,3,2,1,6,At Risk
23222,122,2,574.98,4,2,3,9,Potential
23223,348,2,1155.48,1,2,3,6,At Risk
23224,361,3,1183.47,1,3,4,8,Potential
23225,355,4,1184.46,1,4,4,9,Potential
23226,198,4,588.96,3,4,3,10,Loyal
23227,121,5,597.95,4,5,3,12,Loyal
23228,304,3,62.970000000000006,1,3,2,6,At Risk
23229,113,2,28.479999999999997,4,2,1,7,Potential
23230,308,2,1155.48,1,2,3,6,At Risk
23231,112,5,597.95,4,5,3,12,Loyal
23232,298,1,1120.49,1,1,3,5,At Risk
23233,34,5,639.95,5,5,3,13,Champions
23234,395,2,2478.3399999999997,1,2,4,7,Potential
23235,359,2,39.980000000000004,1,2,1,4,At Risk
23236,154,2,7.28,3,2,1,6,At Risk
23237,341,3,68.97,1,3,2,6,At Risk
23238,205,4,617.47,3,4,3,10,Loyal
23239,199,1,539.99,3,1,3,7,Potential
23240,125,3,69.97,4,3,2,9,Potential
23241,230,3,69.97,2,3,2,7,Potential
23242,194,3,553.97,3,3,3,9,Potential
23243,25,2,34.98,5,2,1,8,Recent Customer
23244,261,2,39.980000000000004,2,2,1,5,At Risk
23245,221,2,39.980000000000004,2,2,1,5,At Risk
23246,166,2,32.28,3,2,1,6,At Risk
23247,79,4,110.95,4,4,3,11,Loyal
23248,133,3,49.970000000000006,4,3,2,9,Potential
23249,360,3,49.970000000000006,1,3,2,6,At Risk
23250,127,2,64.98,4,2,2,8,Potential
23251,318,2,44.980000000000004,1,2,2,5,At Risk
23252,346,2,14.98,1,2,1,4,At Risk
23253,204,2,39.980000000000004,3,2,1,6,At Risk
23254,340,1,9.99,1,1,1,3,At Risk
23255,341,2,39.980000000000004,1,2,1,4,At Risk
23256,131,4,74.46,4,4,2,10,Loyal
23257,200,1,539.99,3,1,3,7,Potential
23258,221,2,14.98,2,2,1,5,At Risk
23259,80,3,49.970000000000006,4,3,2,9,Potential
23260,98,4,93.46,4,4,3,11,Loyal
23261,203,4,77.92,3,4,2,9,Potential
23262,108,3,49.970000000000006,4,3,2,9,Potential
23263,167,3,23.97,3,3,1,7,Potential
23264,192,1,539.99,3,1,3,7,Potential
23265,209,4,562.96,2,4,3,9,Potential
23266,200,4,603.96,3,4,3,10,Loyal
23267,316,5,4862.09,1,5,5,11,Loyal
23268,192,4,567.76,3,4,3,10,Loyal
23269,186,2,574.98,3,2,3,8,Potential
23270,180,4,617.47,3,4,3,10,Loyal
23271,174,3,49.970000000000006,3,3,2,8,Potential
23272,313,3,39.47,1,3,1,5,At Risk
23273,2,3,39.47,5,3,1,9,Recent Customer
23274,336,3,49.970000000000006,1,3,2,6,At Risk
23275,84,3,68.97,4,3,2,9,Potential
23276,202,2,2393.06,3,2,4,9,Potential
23277,359,3,22.93,1,3,1,5,At Risk
23278,229,1,9.99,2,1,1,4,At Risk
23279,93,2,124.99,4,2,3,9,Potential
23280,267,2,14.98,2,2,1,5,At Risk
23281,312,3,4828.11,1,3,5,9,Potential
23282,273,3,37.269999999999996,2,3,1,6,At Risk
23283,287,3,4828.11,2,3,5,10,Loyal
23284,190,2,39.980000000000004,3,2,1,6,At Risk
23285,12,3,69.97,5,3,2,10,Recent Customer
23286,196,1,29.99,3,1,1,5,At Risk
23287,181,4,608.96,3,4,3,10,Loyal
23288,180,2,38.98,3,2,1,6,At Risk
23289,350,2,34.98,1,2,1,4,At Risk
23290,18,2,7.28,5,2,1,8,Recent Customer
23291,7,3,42.93,5,3,2,10,Recent Customer
23292,183,2,34.98,3,2,1,6,At Risk
23293,150,3,152.28,3,3,3,9,Potential
23294,242,3,37.269999999999996,2,3,1,6,At Risk
23295,138,2,34.98,3,2,1,6,At Risk
23296,160,3,570.47,3,3,3,9,Potential
23297,148,3,37.269999999999996,3,3,1,7,Potential
23298,135,3,69.97,3,3,2,8,Potential
23299,337,1,29.99,1,1,1,3,At Risk
23300,286,4,133.47,2,4,3,9,Potential
23301,44,3,56.96,5,3,2,10,Loyal
23302,164,3,553.97,3,3,3,9,Potential
23303,97,3,37.269999999999996,4,3,1,8,Potential
23304,122,3,37.269999999999996,4,3,1,8,Potential
23305,270,2,7.28,2,2,1,5,At Risk
23306,294,3,4828.11,1,3,5,9,Potential
23307,263,3,67.93,2,3,2,7,Potential
23308,52,1,4.99,5,1,1,7,Potential
23309,324,2,59.980000000000004,1,2,2,5,At Risk
23310,387,5,3333.3225,1,5,5,11,Loyal
23311,362,3,3337.0425,1,3,5,9,Potential
23312,145,2,13.98,3,2,1,6,At Risk
23313,184,5,2906.0325000000003,3,5,4,12,Loyal
23314,196,5,2744.5225,3,5,4,12,Loyal
23315,94,3,15.23,4,3,1,8,Potential
23316,184,5,2835.0224999999996,3,5,4,12,Loyal
23317,131,2,39.980000000000004,4,2,1,7,Potential
23318,179,2,561.48,3,2,3,8,Potential
23319,109,2,574.98,4,2,3,9,Potential
23320,203,3,2730.5424999999996,3,3,4,10,Loyal
23321,198,5,3060.8199999999997,3,5,4,12,Loyal
23322,185,4,3042.8199999999997,3,4,4,11,Loyal
23323,185,4,2745.3325000000004,3,4,4,11,Loyal
23324,206,3,2730.5424999999996,3,3,4,10,Loyal
23325,190,4,2997.3199999999997,3,4,4,11,Loyal
23326,164,2,561.48,3,2,3,8,Potential
23327,118,4,73.96000000000001,4,4,2,10,Loyal
23328,156,4,2442.54,3,4,4,11,Loyal
23329,159,2,39.980000000000004,3,2,1,6,At Risk
23330,228,2,31.97,2,2,1,5,At Risk
23331,244,2,4144.34,2,2,5,9,Potential
23332,222,2,4144.34,2,2,5,9,Potential
23333,201,4,119.96000000000001,3,4,3,10,Loyal
23334,182,3,553.97,3,3,3,9,Potential
23335,102,2,32.28,4,2,1,7,Potential
23336,323,2,32.28,1,2,1,4,At Risk
23337,123,1,29.99,4,1,1,6,At Risk
23338,165,4,567.76,3,4,3,10,Loyal
23339,173,2,574.98,3,2,3,8,Potential
23340,120,3,553.97,4,3,3,10,Loyal
23341,113,2,561.48,4,2,3,9,Potential
23342,113,4,556.26,4,4,3,11,Loyal
23343,238,3,3936.5425,2,3,5,10,Loyal
23344,238,2,3882.5525,2,2,5,9,Potential
23345,189,1,4.99,3,1,1,5,At Risk
23346,284,1,4.99,2,1,1,4,At Risk
23347,145,1,4.99,3,1,1,5,At Risk
23348,214,5,4167.3099999999995,2,5,5,12,Loyal
23349,124,4,65.95,4,4,2,10,Loyal
23350,26,2,59.980000000000004,5,2,2,9,Recent Customer
23351,258,3,4828.11,2,3,5,10,Loyal
23352,165,1,539.99,3,1,3,7,Potential
23353,121,4,45.22,4,4,2,10,Loyal
23354,335,3,69.97,1,3,2,6,At Risk
23355,175,2,603.49,3,2,3,8,Potential
23356,175,4,588.96,3,4,3,10,Loyal
23357,289,3,98.48,1,3,3,7,Potential
23358,166,4,561.9200000000001,3,4,3,10,Loyal
23359,112,1,539.99,4,1,3,8,Potential
23360,329,1,29.99,1,1,1,3,At Risk
23361,13,2,32.28,5,2,1,8,Recent Customer
23362,83,2,7.28,4,2,1,7,Potential
23363,23,1,4.99,5,1,1,7,Recent Customer
23364,297,2,32.28,1,2,1,4,At Risk
23365,145,1,539.99,3,1,3,7,Potential
23366,297,4,59.25,1,4,2,7,Potential
23367,227,3,69.97,2,3,2,7,Potential
23368,211,1,4.99,2,1,1,4,At Risk
23369,141,4,608.96,3,4,3,10,Loyal
23370,122,3,563.77,4,3,3,10,Loyal
23371,146,2,564.48,3,2,3,8,Potential
23372,151,3,553.97,3,3,3,9,Potential
23373,129,2,561.48,4,2,3,9,Potential
23374,109,4,588.96,4,4,3,11,Loyal
23375,98,2,564.48,4,2,3,9,Potential
23376,301,3,5314.25,1,3,5,9,Potential
23377,100,3,556.9300000000001,4,3,3,10,Loyal
23378,258,5,5317.23,2,5,5,12,Loyal
23379,247,2,14.98,2,2,1,5,At Risk
23380,309,3,69.97,1,3,2,6,At Risk
23381,1,3,37.269999999999996,5,3,1,9,Recent Customer
23382,153,4,600.46,3,4,3,10,Loyal
23383,146,4,600.46,3,4,3,10,Loyal
23384,130,2,548.98,4,2,3,9,Potential
23385,263,5,4829.389999999999,2,5,5,12,Loyal
23386,128,2,548.98,4,2,3,9,Potential
23387,234,4,93.96000000000001,2,4,3,9,Potential
23388,54,3,69.97,5,3,2,10,Loyal
23389,275,3,37.269999999999996,2,3,1,6,At Risk
23390,146,1,539.99,3,1,3,7,Potential
23391,130,5,613.45,4,5,3,12,Loyal
23392,153,3,553.97,3,3,3,9,Potential
23393,146,3,615.47,3,3,3,9,Potential
23394,143,1,539.99,3,1,3,7,Potential
23395,138,3,553.97,3,3,3,9,Potential
23396,254,4,4891.61,2,4,5,11,Loyal
23397,227,3,4828.11,2,3,5,10,Loyal
23398,133,3,553.97,4,3,3,10,Loyal
23399,153,2,561.48,3,2,3,8,Potential
23400,44,1,29.99,5,1,1,7,Potential
23401,139,2,39.980000000000004,3,2,1,6,At Risk
23402,338,1,29.99,1,1,1,3,At Risk
23403,130,3,553.97,4,3,3,10,Loyal
23404,131,3,624.97,4,3,3,10,Loyal
23405,315,3,69.97,1,3,2,6,At Risk
23406,347,1,29.99,1,1,1,3,At Risk
23407,102,2,561.48,4,2,3,9,Potential
23408,221,4,4218.82,2,4,5,11,Loyal
23409,225,3,3917.5425,2,3,5,10,Loyal
23410,237,5,4016.5325,2,5,5,12,Loyal
23411,363,4,3577.8199999999997,1,4,5,10,Loyal
23412,344,5,3586.81,1,5,5,11,Loyal
23413,336,3,3617.83,1,3,5,9,Potential
23414,318,4,3391.0325,1,4,5,10,Loyal
23415,311,3,3588.83,1,3,5,9,Potential
23416,334,3,3598.83,1,3,5,9,Potential
23417,307,3,3337.0425,1,3,5,9,Potential
23418,320,5,3400.0224999999996,1,5,5,11,Loyal
23419,92,2,39.980000000000004,4,2,1,7,Potential
23420,222,2,4144.34,2,2,5,9,Potential
23421,186,5,4208.3099999999995,3,5,5,13,Champions
23422,192,4,3911.5325000000003,3,4,5,12,Loyal
23423,209,3,3936.5425,2,3,5,10,Loyal
23424,286,2,29.479999999999997,2,2,1,5,At Risk
23425,203,5,3951.5225,3,5,5,13,Champions
23426,108,2,39.980000000000004,4,2,1,7,Potential
23427,56,1,4.99,5,1,1,7,Potential
23428,180,2,39.980000000000004,3,2,1,6,At Risk
23429,204,3,3936.5425,3,3,5,11,Loyal
23430,213,1,4.99,2,1,1,4,At Risk
23431,213,4,4158.32,2,4,5,11,Loyal
23432,198,3,4179.33,3,3,5,11,Loyal
23433,201,2,3882.5525,3,2,5,10,Loyal
23434,194,2,3882.5525,3,2,5,10,Loyal
23435,185,3,3917.5425,3,3,5,11,Loyal
23436,205,5,3950.5224999999996,3,5,5,13,Champions
23437,109,1,4.99,4,1,1,6,At Risk
23438,134,3,123.48,3,3,3,9,Potential
23439,320,3,68.97,1,3,2,6,At Risk
23440,193,2,33.98,3,2,1,6,At Risk
23441,238,3,88.97,2,3,2,7,Potential
23442,331,1,4.99,1,1,1,3,At Risk
23443,103,4,722.77,4,4,3,11,Loyal
23444,115,2,548.98,4,2,3,9,Potential
23445,138,1,28.99,3,1,1,5,At Risk
23446,266,2,6.28,2,2,1,5,At Risk
23447,22,2,6.28,5,2,1,8,Recent Customer
23448,74,2,32.28,4,2,1,7,Potential
23449,350,2,7.28,1,2,1,4,At Risk
23450,146,4,578.46,3,4,3,10,Loyal
23451,280,2,34.98,2,2,1,5,At Risk
23452,359,2,32.28,1,2,1,4,At Risk
23453,112,5,632.45,4,5,3,12,Loyal
23454,117,4,567.76,4,4,3,11,Loyal
23455,46,2,12.940000000000001,5,2,1,8,Potential
23456,251,4,157.27,2,4,3,9,Potential
23457,144,3,69.97,3,3,2,8,Potential
23458,172,4,41.95,3,4,2,9,Potential
23459,131,2,39.980000000000004,4,2,1,7,Potential
23460,98,4,649.46,4,4,3,11,Loyal
23461,22,2,34.98,5,2,1,8,Recent Customer
23462,103,4,567.76,4,4,3,11,Loyal
23463,116,2,574.98,4,2,3,9,Potential
23464,76,1,29.99,4,1,1,6,At Risk
23465,309,2,34.98,1,2,1,4,At Risk
23466,363,1,29.99,1,1,1,3,At Risk
23467,11,1,29.99,5,1,1,7,Recent Customer
23468,36,3,69.97,5,3,2,10,Loyal
23469,287,1,29.99,2,1,1,4,At Risk
23470,253,6,106.92999999999999,2,5,3,10,Loyal
23471,103,4,600.46,4,4,3,11,Loyal
23472,327,2,32.28,1,2,1,4,At Risk
23473,335,5,132.95,1,5,3,9,Potential
23474,115,4,600.46,4,4,3,11,Loyal
23475,204,5,121.94,3,5,3,11,Loyal
23476,184,1,4.99,3,1,1,5,At Risk
23477,61,3,69.97,5,3,2,10,Loyal
23478,114,4,588.96,4,4,3,11,Loyal
23479,107,4,588.96,4,4,3,11,Loyal
23480,70,1,539.99,5,1,3,9,Potential
23481,218,1,29.99,2,1,1,4,At Risk
23482,64,1,29.99,5,1,1,7,Potential
23483,220,2,32.28,2,2,1,5,At Risk
23484,80,1,539.99,4,1,3,8,Potential
23485,30,3,89.97,5,3,2,10,Recent Customer
23486,234,5,5343.23,2,5,5,12,Loyal
23487,79,3,89.97,4,3,2,9,Potential
23488,84,1,4.99,4,1,1,6,At Risk
23489,35,2,34.98,5,2,1,8,Potential
23490,261,3,43.97,2,3,2,7,Potential
23491,187,3,43.97,3,3,2,8,Potential
23492,76,4,588.96,4,4,3,11,Loyal
23493,68,2,548.98,5,2,3,10,Loyal
23494,43,3,89.97,5,3,2,10,Loyal
23495,109,3,69.97,4,3,2,9,Potential
23496,294,3,69.97,1,3,2,6,At Risk
23497,111,1,29.99,4,1,1,6,At Risk
23498,300,1,4.99,1,1,1,3,At Risk
23499,70,1,539.99,5,1,3,9,Potential
23500,240,2,34.98,2,2,1,5,At Risk
23501,127,3,37.269999999999996,4,3,1,8,Potential
23502,351,2,32.28,1,2,1,4,At Risk
23503,314,2,7.28,1,2,1,4,At Risk
23504,246,2,32.28,2,2,1,5,At Risk
23505,89,5,616.95,4,5,3,12,Loyal
23506,85,1,539.99,4,1,3,8,Potential
23507,90,2,574.98,4,2,3,9,Potential
23508,70,2,561.48,5,2,3,10,Loyal
23509,89,5,575.71,4,5,3,12,Loyal
23510,150,3,553.97,3,3,3,9,Potential
23511,225,3,4843.11,2,3,5,10,Loyal
23512,272,1,29.99,2,1,1,4,At Risk
23513,32,3,64.47,5,3,2,10,Loyal
23514,125,3,69.97,4,3,2,9,Potential
23515,131,1,539.99,4,1,3,8,Potential
23516,125,3,599.47,4,3,3,10,Loyal
23517,101,4,78.96000000000001,4,4,2,10,Loyal
23518,32,1,4.99,5,1,1,7,Potential
23519,98,3,23.97,4,3,1,8,Potential
23520,128,2,548.98,4,2,3,9,Potential
23521,166,1,21.98,3,1,1,5,At Risk
23522,293,3,120.47,1,3,3,7,Potential
23523,332,3,3337.0425,1,3,5,9,Potential
23524,324,3,3598.83,1,3,5,9,Potential
23525,311,2,3302.0525,1,2,5,8,Potential
23526,308,2,3563.84,1,2,5,8,Potential
23527,243,2,56.97,2,2,2,6,At Risk
23528,135,2,75.97,3,2,2,7,Potential
23529,329,3,3617.83,1,3,5,9,Potential
23530,24,2,39.980000000000004,5,2,1,8,Recent Customer
23531,330,5,3337.2825000000003,1,5,5,11,Loyal
23532,323,3,3337.0425,1,3,5,9,Potential
23533,193,3,3917.5425,3,3,5,11,Loyal
23534,199,3,4179.33,3,3,5,11,Loyal
23535,169,1,4.99,3,1,1,5,At Risk
23536,232,2,39.980000000000004,2,2,1,5,At Risk
23537,78,2,59.980000000000004,4,2,2,8,Potential
23538,196,3,4198.33,3,3,5,11,Loyal
23539,179,2,4144.34,3,2,5,10,Loyal
23540,285,4,3626.8199999999997,2,4,5,11,Loyal
23541,278,3,3337.0425,2,3,5,10,Loyal
23542,287,3,3337.0425,2,3,5,10,Loyal
23543,162,2,12.940000000000001,3,2,1,6,At Risk
23544,163,6,3971.0125,3,5,5,13,Champions
23545,166,2,3882.5525,3,2,5,10,Loyal
23546,281,3,3337.0425,2,3,5,10,Loyal
23547,275,3,3598.83,2,3,5,10,Loyal
23548,39,3,48.97,5,3,2,10,Loyal
23549,245,2,93.49,2,2,3,7,Potential
23550,91,4,111.95,4,4,3,11,Loyal
23551,132,2,39.980000000000004,4,2,1,7,Potential
23552,65,3,103.48,5,3,3,11,Loyal
23553,156,1,4.99,3,1,1,5,At Risk
23554,209,1,4.99,2,1,1,4,At Risk
23555,310,2,34.98,1,2,1,4,At Risk
23556,366,1,29.99,1,1,1,3,At Risk
23557,260,2,7.28,2,2,1,5,At Risk
23558,109,2,34.98,4,2,1,7,Potential
23559,363,3,64.47,1,3,2,6,At Risk
23560,99,3,553.97,4,3,3,10,Loyal
23561,210,1,29.99,2,1,1,4,At Risk
23562,245,1,4.99,2,1,1,4,At Risk
23563,153,2,56.97,3,2,2,7,Potential
23564,136,2,34.98,3,2,1,6,At Risk
23565,33,2,34.98,5,2,1,8,Potential
23566,848,1,3578.27,1,1,5,7,Potential
23567,230,2,39.980000000000004,2,2,1,5,At Risk
23568,96,4,567.76,4,4,3,11,Loyal
23569,194,2,39.980000000000004,3,2,1,6,At Risk
23570,275,1,21.98,2,1,1,4,At Risk
23571,305,2,3563.84,1,2,5,8,Potential
23572,274,3,3617.83,2,3,5,10,Loyal
23573,247,3,3337.0425,2,3,5,10,Loyal
23574,267,3,3337.0425,2,3,5,10,Loyal
23575,253,2,3302.0525,2,2,5,9,Potential
23576,253,2,39.980000000000004,2,2,1,5,At Risk
23577,336,4,94.46000000000001,1,4,3,8,Potential
23578,319,3,37.269999999999996,1,3,1,5,At Risk
23579,88,2,34.98,4,2,1,7,Potential
23580,338,3,69.97,1,3,2,6,At Risk
23581,165,3,69.97,3,3,2,8,Potential
23582,121,4,628.97,4,4,3,11,Loyal
23583,230,5,4829.389999999999,2,5,5,12,Loyal
23584,85,2,574.98,4,2,3,9,Potential
23585,87,3,565.47,4,3,3,10,Loyal
23586,81,4,562.96,4,4,3,11,Loyal
23587,63,3,565.47,5,3,3,11,Loyal
23588,273,3,37.269999999999996,2,3,1,6,At Risk
23589,72,4,588.96,5,4,3,12,Loyal
23590,24,3,69.97,5,3,2,10,Recent Customer
23591,306,2,7.28,1,2,1,4,At Risk
23592,112,2,5279.26,4,2,5,11,Loyal
23593,179,6,3990.0125,3,5,5,13,Champions
23594,216,1,29.99,2,1,1,4,At Risk
23595,92,3,67.97,4,3,2,9,Potential
23596,150,2,38.980000000000004,3,2,1,6,At Risk
23597,367,4,2482.23,1,4,4,9,Potential
23598,141,2,32.28,3,2,1,6,At Risk
23599,44,3,42.93,5,3,2,10,Loyal
23600,322,2,6.28,1,2,1,4,At Risk
23601,219,2,6.28,2,2,1,5,At Risk
23602,348,2,38.980000000000004,1,2,1,4,At Risk
23603,42,5,2372.95,5,5,4,14,Champions
23604,125,1,3.99,4,1,1,6,At Risk
23605,61,4,2344.9599999999996,5,4,4,13,Champions
23606,378,4,2543.44,1,4,4,9,Potential
23607,380,2,2451.2999999999997,1,2,4,7,Potential
23608,340,3,2510.9399999999996,1,3,4,8,Potential
23609,258,2,12.98,2,2,1,5,At Risk
23610,8,2,38.980000000000004,5,2,1,8,Recent Customer
23611,229,1,3.99,2,1,1,4,At Risk
23612,48,3,2395.9599999999996,5,3,4,12,Loyal
23613,219,2,34.98,2,2,1,5,At Risk
23614,256,5,144.45,2,5,3,10,Loyal
23615,120,2,32.28,4,2,1,7,Potential
23616,131,2,819.48,4,2,3,9,Potential
23617,53,2,34.98,5,2,1,8,Potential
23618,355,4,2481.8199999999997,1,4,4,9,Potential
23619,135,4,806.76,3,4,3,10,Loyal
23620,163,4,78.96000000000001,3,4,2,9,Potential
23621,43,3,2309.9699999999993,5,3,4,12,Loyal
23622,222,4,572.26,2,4,3,9,Potential
23623,341,1,3.99,1,1,1,3,At Risk
23624,251,3,62.970000000000006,2,3,2,7,Potential
23625,104,4,78.96000000000001,4,4,2,10,Loyal
23626,189,2,38.980000000000004,3,2,1,6,At Risk
23627,143,2,38.980000000000004,3,2,1,6,At Risk
23628,256,3,69.97,2,3,2,7,Potential
23629,356,4,2466.3199999999997,1,4,4,9,Potential
23630,349,4,2481.8199999999997,1,4,4,9,Potential
23631,10,3,47.97,5,3,2,10,Recent Customer
23632,296,2,162.99,1,2,3,6,At Risk
23633,66,2,38.980000000000004,5,2,1,8,Potential
23634,169,1,3.99,3,1,1,5,At Risk
23635,359,2,2452.3399999999997,1,2,4,7,Potential
23636,341,3,2479.94,1,3,4,8,Potential
23637,141,2,28.479999999999997,3,2,1,6,At Risk
23638,127,1,29.99,4,1,1,6,At Risk
23639,337,3,69.97,1,3,2,6,At Risk
23640,181,3,3936.5425,3,3,5,11,Loyal
23641,236,3,64.47,2,3,2,7,Potential
23642,11,2,13.98,5,2,1,8,Recent Customer
23643,270,1,4.99,2,1,1,4,At Risk
23644,116,2,39.980000000000004,4,2,1,7,Potential
23645,157,3,4198.33,3,3,5,11,Loyal
23646,210,2,13.98,2,2,1,5,At Risk
23647,130,2,12.940000000000001,4,2,1,7,Potential
23648,177,2,4144.34,3,2,5,10,Loyal
23649,156,4,3945.5325,3,4,5,12,Loyal
23650,247,2,39.980000000000004,2,2,1,5,At Risk
23651,173,3,3917.5425,3,3,5,11,Loyal
23652,174,3,3907.5424999999996,3,3,5,11,Loyal
23653,164,5,3975.0325000000003,3,5,5,13,Champions
23654,184,2,59.980000000000004,3,2,2,7,Potential
23655,137,2,4144.34,3,2,5,10,Loyal
23656,140,2,4144.34,3,2,5,10,Loyal
23657,106,1,4.99,4,1,1,6,At Risk
23658,124,3,3936.5425,4,3,5,12,Loyal
23659,132,3,4179.33,4,3,5,12,Loyal
23660,139,3,3917.5425,3,3,5,11,Loyal
23661,140,4,3961.0325,3,4,5,12,Loyal
23662,120,3,3917.5425,4,3,5,12,Loyal
23663,115,2,3882.5525,4,2,5,11,Loyal
23664,97,4,3941.5325000000003,4,4,5,13,Champions
23665,105,4,4207.32,4,4,5,13,Champions
23666,123,4,2453.04,4,4,4,12,Loyal
23667,38,3,2398.0499999999997,5,3,4,12,Loyal
23668,107,2,564.48,4,2,3,9,Potential
23669,41,1,29.99,5,1,1,7,Potential
23670,365,3,42.93,1,3,2,6,At Risk
23671,125,3,193.98,4,3,3,10,Loyal
23672,235,1,29.99,2,1,1,4,At Risk
23673,254,1,4.99,2,1,1,4,At Risk
23674,38,3,69.97,5,3,2,10,Loyal
23675,132,1,29.99,4,1,1,6,At Risk
23676,338,1,4.99,1,1,1,3,At Risk
23677,98,1,29.99,4,1,1,6,At Risk
23678,304,1,29.99,1,1,1,3,At Risk
23679,357,2,39.980000000000004,1,2,1,4,At Risk
23680,98,1,539.99,4,1,3,8,Potential
23681,61,2,13.98,5,2,1,8,Potential
23682,353,2,59.980000000000004,1,2,2,5,At Risk
23683,120,3,553.97,4,3,3,10,Loyal
23684,6,2,34.98,5,2,1,8,Recent Customer
23685,147,1,29.99,3,1,1,5,At Risk
23686,62,4,94.46000000000001,5,4,3,12,Loyal
23687,209,1,29.99,2,1,1,4,At Risk
23688,382,1,1214.85,1,1,4,6,At Risk
23689,209,3,43.97,2,3,2,7,Potential
23690,362,2,38.98,1,2,1,4,At Risk
23691,231,1,29.99,2,1,1,4,At Risk
23692,203,3,42.93,3,3,2,8,Potential
23693,200,4,119.96,3,4,3,10,Loyal
23694,213,3,69.97,2,3,2,7,Potential
23695,357,6,150.93,1,5,3,9,Potential
23696,314,7,233.23,1,5,3,9,Potential
23697,290,3,69.97,1,3,2,6,At Risk
23698,34,1,29.99,5,1,1,7,Potential
23699,180,3,1274.33,3,3,4,10,Loyal
23700,38,1,29.99,5,1,1,7,Potential
23701,122,4,588.96,4,4,3,11,Loyal
23702,7,2,93.49,5,2,3,10,Recent Customer
23703,109,2,34.98,4,2,1,7,Potential
23704,120,4,600.46,4,4,3,11,Loyal
23705,74,4,94.46000000000001,4,4,3,11,Loyal
23706,90,1,539.99,4,1,3,8,Potential
23707,71,3,565.47,5,3,3,11,Loyal
23708,77,2,574.98,4,2,3,9,Potential
23709,62,2,548.98,5,2,3,10,Loyal
23710,166,1,29.99,3,1,1,5,At Risk
23711,342,2,34.98,1,2,1,4,At Risk
23712,168,2,38.98,3,2,1,6,At Risk
23713,41,2,34.98,5,2,1,8,Potential
23714,329,3,44.540000000000006,1,3,2,6,At Risk
23715,73,1,539.99,5,1,3,9,Potential
23716,288,2,26.97,2,2,1,5,At Risk
23717,248,1,29.99,2,1,1,4,At Risk
23718,103,4,567.76,4,4,3,11,Loyal
23719,16,2,39.980000000000004,5,2,1,8,Recent Customer
23720,68,2,34.98,5,2,1,8,Potential
23721,104,4,588.96,4,4,3,11,Loyal
23722,316,2,32.28,1,2,1,4,At Risk
23723,117,5,628.45,4,5,3,12,Loyal
23724,73,4,588.96,5,4,3,12,Loyal
23725,233,3,4828.11,2,3,5,10,Loyal
23726,96,4,562.96,4,4,3,11,Loyal
23727,217,2,34.98,2,2,1,5,At Risk
23728,294,3,69.97,1,3,2,6,At Risk
23729,360,3,71.58000000000001,1,3,2,6,At Risk
23730,209,3,4828.11,2,3,5,10,Loyal
23731,209,3,4828.11,2,3,5,10,Loyal
23732,299,5,74.45,1,5,2,8,Potential
23733,113,4,567.76,4,4,3,11,Loyal
23734,199,3,69.97,3,3,2,8,Potential
23735,333,2,34.98,1,2,1,4,At Risk
23736,270,3,42.93,2,3,2,7,Potential
23737,170,2,34.98,3,2,1,6,At Risk
23738,105,2,36.59,4,2,1,7,Potential
23739,91,4,573.42,4,4,3,11,Loyal
23740,179,2,36.59,3,2,1,6,At Risk
23741,102,1,32.6,4,1,1,6,At Risk
23742,114,3,615.47,4,3,3,10,Loyal
23743,339,2,39.980000000000004,1,2,1,4,At Risk
23744,100,4,567.76,4,4,3,11,Loyal
23745,274,4,44.22,2,4,2,8,Potential
23746,121,1,539.99,4,1,3,8,Potential
23747,279,4,1142.42,2,4,3,9,Potential
23748,114,3,36.269999999999996,4,3,1,8,Potential
23749,132,4,77.96000000000001,4,4,2,10,Loyal
23750,356,2,1155.48,1,2,3,6,At Risk
23751,324,2,1155.48,1,2,3,6,At Risk
23752,298,3,1164.47,1,3,4,8,Potential
23753,280,5,1193.45,2,5,4,11,Loyal
23754,100,3,68.97,4,3,2,9,Potential
23755,166,2,6.28,3,2,1,6,At Risk
23756,303,3,151.28,1,3,3,7,Potential
23757,275,2,38.980000000000004,2,2,1,5,At Risk
23758,349,2,1754.98,1,2,4,7,Potential
23759,373,2,2475.95,1,2,4,7,Potential
23760,290,3,1183.47,1,3,4,8,Potential
23761,221,3,68.97,2,3,2,7,Potential
23762,283,3,1164.47,2,3,4,9,Potential
23763,314,2,1735.98,1,2,4,7,Potential
23764,342,3,2457.3299999999995,1,3,4,8,Potential
23765,311,5,2535.81,1,5,4,10,Loyal
23766,182,3,68.97,3,3,2,8,Potential
23767,12,2,13.98,5,2,1,8,Recent Customer
23768,28,2,29.479999999999997,5,2,1,8,Recent Customer
23769,321,2,29.479999999999997,1,2,1,4,At Risk
23770,342,1,4.99,1,1,1,3,At Risk
23771,261,5,82.95,2,5,2,9,Potential
23772,198,2,38.980000000000004,3,2,1,6,At Risk
23773,304,3,88.97,1,3,2,6,At Risk
23774,299,5,1234.45,1,5,4,10,Loyal
23775,286,2,1155.48,2,2,3,7,Potential
23776,318,2,2478.3399999999997,1,2,4,7,Potential
23777,273,3,1179.47,2,3,4,9,Potential
23778,98,4,588.96,4,4,3,11,Loyal
23779,247,3,1147.77,2,3,3,8,Potential
23780,307,2,1750.98,1,2,4,7,Potential
23781,106,4,567.76,4,4,3,11,Loyal
23782,126,3,69.97,4,3,2,9,Potential
23783,332,2,58.980000000000004,1,2,2,5,At Risk
23784,357,2,34.98,1,2,1,4,At Risk
23785,360,3,37.269999999999996,1,3,1,5,At Risk
23786,203,2,38.98,3,2,1,6,At Risk
23787,310,3,71.58000000000001,1,3,2,6,At Risk
23788,160,1,1214.85,3,1,4,8,Potential
23789,127,4,1251.12,4,4,4,12,Loyal
23790,206,4,46.830000000000005,3,4,2,9,Potential
23791,213,3,71.58000000000001,2,3,2,7,Potential
23792,197,1,32.6,3,1,1,5,At Risk
23793,288,3,38.88,2,3,1,6,At Risk
23794,119,2,1249.84,4,2,4,10,Loyal
23795,316,3,71.58000000000001,1,3,2,6,At Risk
23796,208,2,36.59,2,2,1,5,At Risk
23797,292,2,67.59,1,2,2,5,At Risk
23798,317,3,67.93,1,3,2,6,At Risk
23799,48,3,1228.83,5,3,4,12,Loyal
23800,115,3,71.58000000000001,4,3,2,9,Potential
23801,348,2,82.59,1,2,2,5,At Risk
23802,57,1,32.6,5,1,1,7,Potential
23803,238,2,68.49,2,2,2,6,At Risk
23804,311,3,71.58000000000001,1,3,2,6,At Risk
23805,126,1,32.6,4,1,1,6,At Risk
23806,825,1,3578.27,1,1,5,7,Potential
23807,95,4,607.96,4,4,3,11,Loyal
23808,223,1,29.99,2,1,1,4,At Risk
23809,139,1,29.99,3,1,1,5,At Risk
23810,252,2,32.28,2,2,1,5,At Risk
23811,96,2,548.98,4,2,3,9,Potential
23812,119,3,69.97,4,3,2,9,Potential
23813,105,2,564.48,4,2,3,9,Potential
23814,141,1,29.99,3,1,1,5,At Risk
23815,117,4,724.47,4,4,3,11,Loyal
23816,120,3,563.77,4,3,3,10,Loyal
23817,221,1,29.99,2,1,1,4,At Risk
23818,115,3,553.97,4,3,3,10,Loyal
23819,201,3,4802.11,3,3,5,11,Loyal
23820,45,3,37.269999999999996,5,3,1,9,Potential
23821,73,5,638.95,5,5,3,13,Champions
23822,269,3,37.269999999999996,2,3,1,6,At Risk
23823,256,3,59.47,2,3,2,7,Potential
23824,357,3,69.97,1,3,2,6,At Risk
23825,104,2,32.28,4,2,1,7,Potential
23826,293,2,32.28,1,2,1,4,At Risk
23827,56,2,13.98,5,2,1,8,Potential
23828,78,2,548.98,4,2,3,9,Potential
23829,209,3,4802.11,2,3,5,10,Loyal
23830,162,3,4802.11,3,3,5,11,Loyal
23831,362,3,69.97,1,3,2,6,At Risk
23832,88,5,687.76,4,5,3,12,Loyal
23833,63,4,722.77,5,4,3,12,Loyal
23834,81,4,561.9200000000001,4,4,3,11,Loyal
23835,84,4,603.96,4,4,3,11,Loyal
23836,70,3,599.47,5,3,3,11,Loyal
23837,73,2,574.98,5,2,3,10,Loyal
23838,70,1,539.99,5,1,3,9,Potential
23839,289,1,29.99,1,1,1,3,At Risk
23840,68,1,539.99,5,1,3,9,Potential
23841,68,6,659.44,5,5,3,13,Champions
23842,133,3,4828.11,4,3,5,12,Loyal
23843,72,2,38.98,5,2,1,8,Potential
23844,66,3,563.77,5,3,3,11,Loyal
23845,74,4,607.96,4,4,3,11,Loyal
23846,124,3,4828.11,4,3,5,12,Loyal
23847,88,4,722.77,4,4,3,11,Loyal
23848,89,2,561.48,4,2,3,9,Potential
23849,81,4,600.46,4,4,3,11,Loyal
23850,78,1,539.99,4,1,3,8,Potential
23851,88,1,539.99,4,1,3,8,Potential
23852,77,4,588.96,4,4,3,11,Loyal
23853,73,4,588.96,5,4,3,12,Loyal
23854,80,3,583.97,4,3,3,10,Loyal
23855,70,4,624.46,5,4,3,12,Loyal
23856,89,2,603.49,4,2,3,9,Potential
23857,76,4,600.46,4,4,3,11,Loyal
23858,342,4,4712.74,1,4,5,10,Loyal
23859,394,3,4153.25,1,3,5,9,Potential
23860,85,2,548.98,4,2,3,9,Potential
23861,347,2,152.6,1,2,3,6,At Risk
23862,304,3,69.97,1,3,2,6,At Risk
23863,233,3,69.97,2,3,2,7,Potential
23864,184,3,84.97,3,3,2,8,Potential
23865,131,4,4891.61,4,4,5,13,Champions
23866,111,3,4828.11,4,3,5,12,Loyal
23867,93,3,4802.11,4,3,5,12,Loyal
23868,98,5,4829.389999999999,4,5,5,14,Champions
23869,325,2,34.98,1,2,1,4,At Risk
23870,39,5,624.95,5,5,3,13,Champions
23871,50,4,673.97,5,4,3,12,Loyal
23872,41,4,556.26,5,4,3,12,Loyal
23873,53,4,628.97,5,4,3,12,Loyal
23874,91,1,539.99,4,1,3,8,Potential
23875,66,3,37.269999999999996,5,3,1,9,Potential
23876,118,2,36.59,4,2,1,7,Potential
23877,61,4,78.96000000000001,5,4,2,11,Loyal
23878,53,4,588.96,5,4,3,12,Loyal
23879,306,3,64.47,1,3,2,6,At Risk
23880,56,3,553.97,5,3,3,11,Loyal
23881,59,2,548.98,5,2,3,10,Loyal
23882,49,2,603.49,5,2,3,10,Loyal
23883,36,5,575.71,5,5,3,13,Champions
23884,32,2,603.49,5,2,3,10,Loyal
23885,38,1,539.99,5,1,3,9,Potential
23886,56,4,562.96,5,4,3,12,Loyal
23887,57,2,548.98,5,2,3,10,Loyal
23888,329,2,34.98,1,2,1,4,At Risk
23889,38,3,69.97,5,3,2,10,Loyal
23890,157,2,32.28,3,2,1,6,At Risk
23891,237,1,29.99,2,1,1,4,At Risk
23892,238,1,4.99,2,1,1,4,At Risk
23893,226,2,58.980000000000004,2,2,2,6,At Risk
23894,318,3,69.97,1,3,2,6,At Risk
23895,53,1,539.99,5,1,3,9,Potential
23896,45,2,548.98,5,2,3,10,Loyal
23897,321,2,38.980000000000004,1,2,1,4,At Risk
23898,199,2,603.49,3,2,3,8,Potential
23899,94,4,574.46,4,4,3,11,Loyal
23900,160,1,539.99,3,1,3,7,Potential
23901,120,2,574.98,4,2,3,9,Potential
23902,167,2,564.48,3,2,3,8,Potential
23903,176,1,539.99,3,1,3,7,Potential
23904,285,3,1198.97,2,3,4,9,Potential
23905,162,2,574.98,3,2,3,8,Potential
23906,294,1,2443.35,1,1,4,6,At Risk
23907,269,1,1120.49,2,1,3,6,At Risk
23908,63,2,574.98,5,2,3,10,Loyal
23909,78,2,548.98,4,2,3,9,Potential
23910,297,2,6.28,1,2,1,4,At Risk
23911,143,3,36.269999999999996,3,3,1,7,Potential
23912,88,1,3.99,4,1,1,6,At Risk
23913,30,4,47.96,5,4,2,11,Recent Customer
23914,146,2,6.28,3,2,1,6,At Risk
23915,60,2,28.479999999999997,5,2,1,8,Potential
23916,152,1,3.99,3,1,1,5,At Risk
23917,174,3,553.97,3,3,3,9,Potential
23918,316,3,68.97,1,3,2,6,At Risk
23919,212,3,58.47,2,3,2,7,Potential
23920,285,2,1735.98,2,2,4,8,Potential
23921,293,4,2465.2799999999997,1,4,4,9,Potential
23922,275,4,2466.3199999999997,2,4,4,10,Loyal
23923,227,2,1174.48,2,2,4,8,Potential
23924,239,2,1129.48,2,2,3,7,Potential
23925,272,3,2457.3299999999995,2,3,4,9,Potential
23926,214,1,2443.35,2,1,4,7,Potential
23927,165,3,36.269999999999996,3,3,1,7,Potential
23928,297,3,36.269999999999996,1,3,1,5,At Risk
23929,133,3,83.97,4,3,2,9,Potential
23930,232,6,1243.44,2,5,4,11,Loyal
23931,7,3,68.97,5,3,2,10,Recent Customer
23932,63,4,588.96,5,4,3,12,Loyal
23933,173,3,563.77,3,3,3,9,Potential
23934,4,3,36.269999999999996,5,3,1,9,Recent Customer
23935,204,1,4.99,3,1,1,5,At Risk
23936,242,4,123.96000000000001,2,4,3,9,Potential
23937,344,2,38.980000000000004,1,2,1,4,At Risk
23938,232,1,1120.49,2,1,3,6,At Risk
23939,298,2,1709.98,1,2,4,7,Potential
23940,222,1,1120.49,2,1,3,6,At Risk
23941,366,2,38.980000000000004,1,2,1,4,At Risk
23942,232,2,6.28,2,2,1,5,At Risk
23943,62,2,39.980000000000004,5,2,1,8,Potential
23944,302,2,1155.48,1,2,3,6,At Risk
23945,112,1,4.99,4,1,1,6,At Risk
23946,101,2,53.980000000000004,4,2,2,8,Potential
23947,64,2,38.980000000000004,5,2,1,8,Potential
23948,75,2,68.49,4,2,2,8,Potential
23949,281,4,92.96000000000001,2,4,3,9,Potential
23950,131,3,88.97,4,3,2,9,Potential
23951,98,3,36.269999999999996,4,3,1,8,Potential
23952,151,2,38.980000000000004,3,2,1,6,At Risk
23953,271,1,3.99,2,1,1,4,At Risk
23954,296,5,1178.45,1,5,4,10,Loyal
23955,42,4,44.22,5,4,2,11,Loyal
23956,202,2,67.49,3,2,2,7,Potential
23957,94,2,38.980000000000004,4,2,1,7,Potential
23958,71,6,663.44,5,5,3,13,Champions
23959,339,2,38.980000000000004,1,2,1,4,At Risk
23960,167,4,600.46,3,4,3,10,Loyal
23961,155,4,685.47,3,4,3,10,Loyal
23962,366,1,28.99,1,1,1,3,At Risk
23963,162,3,68.97,3,3,2,8,Potential
23964,338,3,36.269999999999996,1,3,1,5,At Risk
23965,274,2,38.980000000000004,2,2,1,5,At Risk
23966,305,2,29.479999999999997,1,2,1,4,At Risk
23967,206,1,4.99,3,1,1,5,At Risk
23968,131,2,39.980000000000004,4,2,1,7,Potential
23969,199,3,36.269999999999996,3,3,1,7,Potential
23970,93,3,36.269999999999996,4,3,1,8,Potential
23971,53,4,98.96000000000001,5,4,3,12,Loyal
23972,96,3,68.97,4,3,2,9,Potential
23973,65,2,33.98,5,2,1,8,Potential
23974,38,3,36.269999999999996,5,3,1,9,Potential
23975,68,2,38.980000000000004,5,2,1,8,Potential
23976,305,1,4.99,1,1,1,3,At Risk
23977,180,4,123.96000000000001,3,4,3,10,Loyal
23978,24,2,39.980000000000004,5,2,1,8,Recent Customer
23979,228,2,6.28,2,2,1,5,At Risk
23980,127,3,68.97,4,3,2,9,Potential
23981,339,2,33.98,1,2,1,4,At Risk
23982,176,2,548.98,3,2,3,8,Potential
23983,255,3,1195.47,2,3,4,9,Potential
23984,270,2,1155.48,2,2,3,7,Potential
23985,156,2,39.980000000000004,3,2,1,6,At Risk
23986,258,4,1184.46,2,4,4,10,Loyal
23987,250,3,1147.77,2,3,3,8,Potential
23988,238,3,1179.47,2,3,4,9,Potential
23989,352,2,58.980000000000004,1,2,2,5,At Risk
23990,82,2,548.98,4,2,3,9,Potential
23991,92,2,548.98,4,2,3,9,Potential
23992,178,5,3167.8199999999997,3,5,4,12,Loyal
23993,176,4,3072.3199999999997,3,4,4,11,Loyal
23994,162,5,2790.5225,3,5,4,12,Loyal
23995,160,2,2983.34,3,2,4,9,Potential
23996,171,5,2744.5225,3,5,4,12,Loyal
23997,287,2,39.980000000000004,2,2,1,5,At Risk
23998,176,3,2756.5425,3,3,4,10,Loyal
23999,180,3,2730.5424999999996,3,3,4,10,Loyal
24000,165,2,2983.34,3,2,4,9,Potential
24001,173,2,2983.34,3,2,4,9,Potential
24002,168,5,2744.5225,3,5,4,12,Loyal
24003,180,4,2806.5325,3,4,4,11,Loyal
24004,175,5,2744.5225,3,5,4,12,Loyal
24005,171,3,2756.5425,3,3,4,10,Loyal
24006,161,2,2721.5525,3,2,4,9,Potential
24007,162,4,3042.8199999999997,3,4,4,11,Loyal
24008,164,3,2730.5424999999996,3,3,4,10,Loyal
24009,172,3,2746.0424999999996,3,3,4,10,Loyal
24010,72,3,565.47,5,3,3,11,Loyal
24011,226,3,1179.47,2,3,4,9,Potential
24012,107,3,68.97,4,3,2,9,Potential
24013,261,3,88.97,2,3,2,7,Potential
24014,109,2,38.980000000000004,4,2,1,7,Potential
24015,230,2,1155.48,2,2,3,7,Potential
24016,192,4,44.22,3,4,2,9,Potential
24017,143,3,553.97,3,3,3,9,Potential
24018,138,2,574.98,3,2,3,8,Potential
24019,228,1,1120.49,2,1,3,6,At Risk
24020,164,2,13.98,3,2,1,6,At Risk
24021,105,4,156.27,4,4,3,11,Loyal
24022,75,2,561.48,4,2,3,9,Potential
24023,92,4,588.96,4,4,3,11,Loyal
24024,124,2,603.49,4,2,3,9,Potential
24025,153,4,578.46,3,4,3,10,Loyal
24026,233,4,1212.97,2,4,4,10,Loyal
24027,142,4,561.9200000000001,3,4,3,10,Loyal
24028,37,5,597.95,5,5,3,13,Champions
24029,59,4,562.96,5,4,3,12,Loyal
24030,217,2,1170.48,2,2,4,8,Potential
24031,241,2,1170.48,2,2,4,8,Potential
24032,38,3,563.77,5,3,3,11,Loyal
24033,128,2,574.98,4,2,3,9,Potential
24034,226,4,1203.46,2,4,4,10,Loyal
24035,298,2,13.98,1,2,1,4,At Risk
24036,131,4,607.96,4,4,3,11,Loyal
24037,33,1,539.99,5,1,3,9,Potential
24038,48,3,570.47,5,3,3,11,Loyal
24039,238,1,1700.99,2,1,4,7,Potential
24040,206,4,2482.23,3,4,4,11,Loyal
24041,91,3,93.97,4,3,3,10,Loyal
24042,24,2,12.98,5,2,1,8,Recent Customer
24043,57,2,31.279999999999998,5,2,1,8,Potential
24044,192,2,1174.48,3,2,4,9,Potential
24045,116,1,4.99,4,1,1,6,At Risk
24046,127,3,553.97,4,3,3,10,Loyal
24047,208,2,1174.48,2,2,4,8,Potential
24048,193,2,1174.48,3,2,4,9,Potential
24049,148,2,574.98,3,2,3,8,Potential
24050,192,3,1164.47,3,3,4,10,Loyal
24051,202,2,1170.48,3,2,4,9,Potential
24052,137,2,548.98,3,2,3,8,Potential
24053,186,1,2443.35,3,1,4,8,Potential
24054,190,2,1174.48,3,2,4,9,Potential
24055,192,2,1170.48,3,2,4,9,Potential
24056,59,4,628.97,5,4,3,12,Loyal
24057,53,2,574.98,5,2,3,10,Loyal
24058,159,3,1164.47,3,3,4,10,Loyal
24059,148,3,583.97,3,3,3,9,Potential
24060,133,2,603.49,4,2,3,9,Potential
24061,389,2,2413.06,1,2,4,7,Potential
24062,177,1,28.99,3,1,1,5,At Risk
24063,365,4,2433.04,1,4,4,9,Potential
24064,345,1,4.99,1,1,1,3,At Risk
24065,161,2,1170.48,3,2,4,9,Potential
24066,113,4,2514.93,4,4,4,12,Loyal
24067,121,4,2492.3199999999997,4,4,4,12,Loyal
24068,96,3,2457.3299999999995,4,3,4,11,Loyal
24069,188,2,1174.48,3,2,4,9,Potential
24070,113,3,36.269999999999996,4,3,1,8,Potential
24071,253,2,12.940000000000001,2,2,1,5,At Risk
24072,244,2,6.28,2,2,1,5,At Risk
24073,134,2,68.49,3,2,2,7,Potential
24074,133,2,38.980000000000004,4,2,1,7,Potential
24075,100,3,68.97,4,3,2,9,Potential
24076,113,4,77.96000000000001,4,4,2,10,Loyal
24077,139,4,588.96,3,4,3,10,Loyal
24078,296,1,3.99,1,1,1,3,At Risk
24079,253,2,39.980000000000004,2,2,1,5,At Risk
24080,185,2,53.980000000000004,3,2,2,7,Potential
24081,144,2,31.279999999999998,3,2,1,6,At Risk
24082,148,2,39.980000000000004,3,2,1,6,At Risk
24083,348,2,2419.06,1,2,4,7,Potential
24084,327,4,2407.04,1,4,4,9,Potential
24085,326,2,39.980000000000004,1,2,1,4,At Risk
24086,126,2,53.980000000000004,4,2,2,8,Potential
24087,64,2,38.980000000000004,5,2,1,8,Potential
24088,260,2,6.28,2,2,1,5,At Risk
24089,244,3,1744.97,2,3,4,9,Potential
24090,238,2,1735.98,2,2,4,8,Potential
24091,65,2,2478.3399999999997,5,2,4,11,Loyal
24092,89,4,2481.8199999999997,4,4,4,12,Loyal
24093,361,4,2466.3199999999997,1,4,4,9,Potential
24094,365,2,39.980000000000004,1,2,1,4,At Risk
24095,218,2,29.479999999999997,2,2,1,5,At Risk
24096,251,2,7.28,2,2,1,5,At Risk
24097,29,2,6.28,5,2,1,8,Recent Customer
24098,107,5,655.45,4,5,3,12,Loyal
24099,121,3,563.77,4,3,3,10,Loyal
24100,209,4,1169.46,2,4,4,10,Loyal
24101,202,2,1170.48,3,2,4,9,Potential
24102,369,3,1779.47,1,3,4,8,Potential
24103,346,2,1754.98,1,2,4,7,Potential
24104,155,2,1155.48,3,2,3,8,Potential
24105,319,2,2419.06,1,2,4,7,Potential
24106,144,2,39.980000000000004,3,2,1,6,At Risk
24107,88,2,123.99,4,2,3,9,Potential
24108,278,1,3.99,2,1,1,4,At Risk
24109,291,1,4.99,1,1,1,3,At Risk
24110,316,2,2393.06,1,2,4,7,Potential
24111,167,1,4.99,3,1,1,5,At Risk
24112,109,2,1155.48,4,2,3,9,Potential
24113,320,2,39.980000000000004,1,2,1,4,At Risk
24114,182,3,1179.47,3,3,4,10,Loyal
24115,113,3,1164.47,4,3,4,11,Loyal
24116,230,1,1700.99,2,1,4,7,Potential
24117,130,2,12.98,4,2,1,7,Potential
24118,4,2,7.28,5,2,1,8,Recent Customer
24119,139,2,13.98,3,2,1,6,At Risk
24120,310,1,3.99,1,1,1,3,At Risk
24121,101,1,539.99,4,1,3,8,Potential
24122,125,1,4.99,4,1,1,6,At Risk
24123,206,2,7.28,3,2,1,6,At Risk
24124,31,2,59.980000000000004,5,2,2,9,Potential
24125,102,2,13.98,4,2,1,7,Potential
24126,164,2,29.479999999999997,3,2,1,6,At Risk
24127,106,2,548.98,4,2,3,9,Potential
24128,189,3,93.97,3,3,3,9,Potential
24129,184,1,3.99,3,1,1,5,At Risk
24130,234,3,47.97,2,3,2,7,Potential
24131,4,2,13.98,5,2,1,8,Recent Customer
24132,106,1,4.99,4,1,1,6,At Risk
24133,262,3,48.970000000000006,2,3,2,7,Potential
24134,43,1,4.99,5,1,1,7,Potential
24135,307,2,2419.06,1,2,4,7,Potential
24136,302,2,2413.06,1,2,4,7,Potential
24137,244,2,6.28,2,2,1,5,At Risk
24138,99,3,1194.97,4,3,4,11,Loyal
24139,81,2,38.980000000000004,4,2,1,7,Potential
24140,276,2,2419.06,2,2,4,8,Potential
24141,354,3,15.23,1,3,1,5,At Risk
24142,104,2,7.28,4,2,1,7,Potential
24143,35,2,6.28,5,2,1,8,Potential
24144,107,2,39.980000000000004,4,2,1,7,Potential
24145,27,2,13.98,5,2,1,8,Recent Customer
24146,277,2,59.980000000000004,2,2,2,6,At Risk
24147,41,2,38.980000000000004,5,2,1,8,Potential
24148,301,2,11.940000000000001,1,2,1,4,At Risk
24149,137,2,7.28,3,2,1,6,At Risk
24150,100,1,3.99,4,1,1,6,At Risk
24151,152,2,58.980000000000004,3,2,2,7,Potential
24152,67,1,4.99,5,1,1,7,Potential
24153,290,3,2418.05,1,3,4,8,Potential
24154,304,2,29.479999999999997,1,2,1,4,At Risk
24155,98,1,539.99,4,1,3,8,Potential
24156,125,2,6.28,4,2,1,7,Potential
24157,250,2,2419.06,2,2,4,8,Potential
24158,258,3,2398.0499999999997,2,3,4,9,Potential
24159,169,3,2756.5425,3,3,4,10,Loyal
24160,168,3,3046.84,3,3,4,10,Loyal
24161,173,2,2983.34,3,2,4,9,Potential
24162,176,3,3004.83,3,3,4,10,Loyal
24163,175,3,2756.5425,3,3,4,10,Loyal
24164,168,5,2760.0225,3,5,4,12,Loyal
24165,169,3,3046.84,3,3,4,10,Loyal
24166,146,5,2789.5224999999996,3,5,4,12,Loyal
24167,147,2,2983.34,3,2,4,9,Potential
24168,128,5,2790.5225,4,5,4,13,Champions
24169,152,4,2735.5325,3,4,4,11,Loyal
24170,141,3,3018.33,3,3,4,10,Loyal
24171,133,5,3006.31,4,5,4,13,Champions
24172,147,4,2735.5325,3,4,4,11,Loyal
24173,131,5,2771.5225,4,5,4,13,Champions
24174,128,2,2983.34,4,2,4,10,Loyal
24175,135,3,2743.0424999999996,3,3,4,10,Loyal
24176,143,4,3042.8199999999997,3,4,4,11,Loyal
24177,152,2,2721.5525,3,2,4,9,Potential
24178,147,4,2810.5325,3,4,4,11,Loyal
24179,146,5,3052.31,3,5,4,12,Loyal
24180,134,2,38.980000000000004,3,2,1,6,At Risk
24181,328,2,6.28,1,2,1,4,At Risk
24182,120,4,562.96,4,4,3,11,Loyal
24183,245,4,2461.5499999999997,2,4,4,10,Loyal
24184,174,2,1155.48,3,2,3,8,Potential
24185,24,2,7.28,5,2,1,8,Recent Customer
24186,177,3,1147.77,3,3,3,9,Potential
24187,169,2,1155.48,3,2,3,8,Potential
24188,202,2,12.940000000000001,3,2,1,6,At Risk
24189,153,2,1174.48,3,2,4,9,Potential
24190,226,3,2428.05,2,3,4,9,Potential
24191,111,1,539.99,4,1,3,8,Potential
24192,136,2,1155.48,3,2,3,8,Potential
24193,131,4,1199.46,4,4,4,12,Loyal
24194,218,3,2418.05,2,3,4,9,Potential
24195,260,2,59.980000000000004,2,2,2,6,At Risk
24196,195,2,39.980000000000004,3,2,1,6,At Risk
24197,125,2,1155.48,4,2,3,9,Potential
24198,231,4,2433.04,2,4,4,10,Loyal
24199,100,2,1155.48,4,2,3,9,Potential
24200,93,1,1120.49,4,1,3,8,Potential
24201,201,3,2428.05,3,3,4,10,Loyal
24202,153,1,1120.49,3,1,3,7,Potential
24203,168,3,2469.05,3,3,4,10,Loyal
24204,98,5,597.95,4,5,3,12,Loyal
24205,119,3,615.47,4,3,3,10,Loyal
24206,346,2,1754.98,1,2,4,7,Potential
24207,45,1,4.99,5,1,1,7,Potential
24208,154,2,1709.98,3,2,4,9,Potential
24209,178,2,1735.98,3,2,4,9,Potential
24210,310,3,1729.97,1,3,4,8,Potential
24211,106,2,1170.48,4,2,4,10,Loyal
24212,144,2,1155.48,3,2,3,8,Potential
24213,132,4,1214.46,4,4,4,12,Loyal
24214,112,3,583.97,4,3,3,10,Loyal
24215,45,3,88.97,5,3,2,10,Loyal
24216,53,3,48.970000000000006,5,3,2,10,Loyal
24217,145,3,1209.47,3,3,4,10,Loyal
24218,269,1,4.99,2,1,1,4,At Risk
24219,181,4,2433.04,3,4,4,11,Loyal
24220,128,3,67.93,4,3,2,9,Potential
24221,55,3,553.97,5,3,3,11,Loyal
24222,118,3,37.269999999999996,4,3,1,8,Potential
24223,298,2,32.28,1,2,1,4,At Risk
24224,47,1,539.99,5,1,3,9,Potential
24225,178,2,93.49,3,2,3,8,Potential
24226,170,3,69.97,3,3,2,8,Potential
24227,186,2,34.98,3,2,1,6,At Risk
24228,79,3,15.23,4,3,1,8,Potential
24229,251,2,7.28,2,2,1,5,At Risk
24230,163,2,13.98,3,2,1,6,At Risk
24231,35,3,563.77,5,3,3,11,Loyal
24232,42,3,553.97,5,3,3,11,Loyal
24233,60,3,553.97,5,3,3,11,Loyal
24234,49,3,563.77,5,3,3,11,Loyal
24235,120,5,4829.389999999999,4,5,5,14,Champions
24236,270,4,121.57000000000001,2,4,3,9,Potential
24237,45,3,71.58000000000001,5,3,2,10,Loyal
24238,41,4,608.96,5,4,3,12,Loyal
24239,58,4,588.96,5,4,3,12,Loyal
24240,41,1,4.99,5,1,1,7,Potential
24241,152,4,2997.3199999999997,3,4,4,11,Loyal
24242,148,3,2756.5425,3,3,4,10,Loyal
24243,228,3,48.970000000000006,2,3,2,7,Potential
24244,250,3,3617.83,2,3,5,10,Loyal
24245,42,3,17.27,5,3,1,9,Potential
24246,265,1,9.99,2,1,1,4,At Risk
24247,150,2,2721.5525,3,2,4,9,Potential
24248,132,5,2770.5224999999996,4,5,4,13,Champions
24249,126,3,2756.5425,4,3,4,11,Loyal
24250,129,4,2738.4925000000003,4,4,4,12,Loyal
24251,146,2,2983.34,3,2,4,9,Potential
24252,120,5,2744.5225,4,5,4,13,Champions
24253,112,1,9.99,4,1,1,6,At Risk
24254,34,2,603.49,5,2,3,10,Loyal
24255,30,2,13.98,5,2,1,8,Recent Customer
24256,310,2,39.980000000000004,1,2,1,4,At Risk
24257,114,5,2770.5224999999996,4,5,4,13,Champions
24258,63,1,4.99,5,1,1,7,Potential
24259,21,1,29.99,5,1,1,7,Recent Customer
24260,53,3,44.97,5,3,2,10,Loyal
24261,201,3,71.58000000000001,3,3,2,8,Potential
24262,219,3,38.88,2,3,1,6,At Risk
24263,201,2,34.89,3,2,1,6,At Risk
24264,108,3,71.58000000000001,4,3,2,9,Potential
24265,192,4,96.07,3,4,3,10,Loyal
24266,119,5,2749.3225,4,5,4,13,Champions
24267,219,3,22.93,2,3,1,6,At Risk
24268,247,3,49.970000000000006,2,3,2,7,Potential
24269,138,2,14.98,3,2,1,6,At Risk
24270,111,6,2844.5125,4,5,4,13,Champions
24271,98,4,2745.3325000000004,4,4,4,12,Loyal
24272,119,4,2735.5325,4,4,4,12,Loyal
24273,100,2,2721.5525,4,2,4,10,Loyal
24274,93,3,3018.33,4,3,4,11,Loyal
24275,337,3,831.33,1,3,3,7,Potential
24276,327,3,23.97,1,3,1,5,At Risk
24277,340,1,9.99,1,1,1,3,At Risk
24278,242,3,184.48,2,3,3,8,Potential
24279,17,3,79.47,5,3,2,10,Recent Customer
24280,196,3,27.77,3,3,1,7,Potential
24281,261,2,3302.0525,2,2,5,9,Potential
24282,95,3,3917.5425,4,3,5,12,Loyal
24283,103,5,3946.5225,4,5,5,14,Champions
24284,83,6,4837.34,4,5,5,14,Champions
24285,208,1,32.6,2,1,1,4,At Risk
24286,42,5,575.71,5,5,3,13,Champions
24287,45,3,100.09,5,3,3,11,Loyal
24288,115,3,71.58000000000001,4,3,2,9,Potential
24289,300,1,32.6,1,1,1,3,At Risk
24290,190,1,32.6,3,1,1,5,At Risk
24291,51,1,539.99,5,1,3,9,Potential
24292,350,3,38.88,1,3,1,5,At Risk
24293,366,2,34.89,1,2,1,4,At Risk
24294,139,3,45.580000000000005,3,3,2,8,Potential
24295,51,4,608.96,5,4,3,12,Loyal
24296,59,2,574.98,5,2,3,10,Loyal
24297,347,3,38.88,1,3,1,5,At Risk
24298,323,3,86.58,1,3,2,6,At Risk
24299,321,3,38.88,1,3,1,5,At Risk
24300,96,2,4144.34,4,2,5,11,Loyal
24301,110,2,4144.34,4,2,5,11,Loyal
24302,97,2,3882.5525,4,2,5,11,Loyal
24303,118,4,4207.32,4,4,5,13,Champions
24304,105,5,3946.5225,4,5,5,14,Champions
24305,119,4,3945.5325,4,4,5,13,Champions
24306,3,2,7.28,5,2,1,8,Recent Customer
24307,96,4,4158.32,4,4,5,13,Champions
24308,34,5,612.95,5,5,3,13,Champions
24309,55,2,4793.12,5,2,5,12,Loyal
24310,33,5,4829.389999999999,5,5,5,15,Champions
24311,45,3,624.97,5,3,3,11,Loyal
24312,187,2,36.59,3,2,1,6,At Risk
24313,256,3,45.58,2,3,2,7,Potential
24314,318,2,57.09,1,2,2,5,At Risk
24315,258,1,32.6,2,1,1,4,At Risk
24316,89,3,38.88,4,3,1,8,Potential
24317,343,2,34.89,1,2,1,4,At Risk
24318,279,3,71.58000000000001,2,3,2,7,Potential
24319,78,2,36.59,4,2,1,7,Potential
24320,172,3,38.88,3,3,1,7,Potential
24321,54,2,548.98,5,2,3,10,Loyal
24322,149,2,68.49,3,2,2,7,Potential
24323,55,4,600.46,5,4,3,12,Loyal
24324,40,4,600.46,5,4,3,12,Loyal
24325,52,4,567.76,5,4,3,12,Loyal
24326,43,4,556.26,5,4,3,12,Loyal
24327,35,2,548.98,5,2,3,10,Loyal
24328,43,2,574.98,5,2,3,10,Loyal
24329,40,2,603.49,5,2,3,10,Loyal
24330,56,2,574.98,5,2,3,10,Loyal
24331,59,2,548.98,5,2,3,10,Loyal
24332,55,5,4816.09,5,5,5,15,Champions
24333,58,5,616.95,5,5,3,13,Champions
24334,48,2,574.98,5,2,3,10,Loyal
24335,56,2,574.98,5,2,3,10,Loyal
24336,42,2,548.98,5,2,3,10,Loyal
24337,44,4,600.46,5,4,3,12,Loyal
24338,37,3,553.97,5,3,3,11,Loyal
24339,397,1,2384.07,1,1,4,6,At Risk
24340,339,2,2393.06,1,2,4,7,Potential
24341,339,4,2453.04,1,4,4,9,Potential
24342,49,3,4828.11,5,3,5,13,Champions
24343,327,3,2443.55,1,3,4,8,Potential
24344,337,3,4329.61,1,3,5,9,Potential
24345,321,3,2398.0499999999997,1,3,4,8,Potential
24346,281,4,2473.04,2,4,4,10,Loyal
24347,298,2,2419.06,1,2,4,7,Potential
24348,290,3,2443.55,1,3,4,8,Potential
24349,301,2,2419.06,1,2,4,7,Potential
24350,271,3,71.58000000000001,2,3,2,7,Potential
24351,298,2,2393.06,1,2,4,7,Potential
24352,255,2,2393.06,2,2,4,8,Potential
24353,269,3,2398.0499999999997,2,3,4,9,Potential
24354,274,3,2418.05,2,3,4,9,Potential
24355,259,2,36.59,2,2,1,5,At Risk
24356,38,3,615.47,5,3,3,11,Loyal
24357,261,3,2443.55,2,3,4,9,Potential
24358,250,3,2418.05,2,3,4,9,Potential
24359,269,4,2420.34,2,4,4,10,Loyal
24360,267,4,3626.8199999999997,2,4,5,11,Loyal
24361,256,4,3391.0325,2,4,5,11,Loyal
24362,272,5,3600.7699999999995,2,5,5,12,Loyal
24363,7,2,13.98,5,2,1,8,Recent Customer
24364,64,5,3965.5225,5,5,5,15,Champions
24365,272,4,3331.0325000000003,2,4,5,11,Loyal
24366,74,2,4144.34,4,2,5,11,Loyal
24367,77,3,4179.33,4,3,5,12,Loyal
24368,78,5,3946.5225,4,5,5,14,Champions
24369,93,1,4.99,4,1,1,6,At Risk
24370,160,3,67.93,3,3,2,8,Potential
24371,90,4,4193.82,4,4,5,13,Champions
24372,215,3,3356.0425,2,3,5,10,Loyal
24373,183,3,27.77,3,3,1,7,Potential
24374,2,1,21.49,5,1,1,7,Recent Customer
24375,296,3,31.729999999999997,1,3,1,5,At Risk
24376,53,1,4.99,5,1,1,7,Potential
24377,89,4,3945.5325,4,4,5,13,Champions
24378,66,4,4173.32,5,4,5,14,Champions
24379,280,2,13.98,2,2,1,5,At Risk
24380,175,1,4.99,3,1,1,5,At Risk
24381,64,5,3970.5225,5,5,5,15,Champions
24382,187,3,143.78,3,3,3,9,Potential
24383,168,1,2384.07,3,1,4,8,Potential
24384,124,3,2428.05,4,3,4,11,Loyal
24385,38,4,562.96,5,4,3,12,Loyal
24386,391,4,4143.74,1,4,5,10,Loyal
24387,35,1,539.99,5,1,3,9,Potential
24388,53,4,588.96,5,4,3,12,Loyal
24389,349,3,45.58,1,3,2,6,At Risk
24390,222,1,32.6,2,1,1,4,At Risk
24391,244,3,42.84,2,3,2,7,Potential
24392,292,3,4329.61,1,3,5,9,Potential
24393,356,2,36.59,1,2,1,4,At Risk
24394,212,2,36.59,2,2,1,5,At Risk
24395,304,2,36.59,1,2,1,4,At Risk
24396,278,3,38.88,2,3,1,6,At Risk
24397,333,3,38.88,1,3,1,5,At Risk
24398,286,3,42.84,2,3,2,7,Potential
24399,307,3,132.94,1,3,3,7,Potential
24400,45,4,608.96,5,4,3,12,Loyal
24401,183,3,45.58,3,3,2,8,Potential
24402,42,2,574.98,5,2,3,10,Loyal
24403,388,2,2393.06,1,2,4,7,Potential
24404,372,1,2384.07,1,1,4,6,At Risk
24405,372,2,2419.06,1,2,4,7,Potential
24406,40,3,195.59,5,3,3,11,Loyal
24407,77,3,71.58000000000001,4,3,2,9,Potential
24408,63,4,96.07,5,4,3,12,Loyal
24409,39,3,71.58000000000001,5,3,2,10,Loyal
24410,82,3,193.89000000000001,4,3,3,10,Loyal
24411,313,3,71.58000000000001,1,3,2,6,At Risk
24412,268,3,38.88,2,3,1,6,At Risk
24413,382,4,2407.04,1,4,4,9,Potential
24414,374,3,2398.0499999999997,1,3,4,8,Potential
24415,353,1,4.99,1,1,1,3,At Risk
24416,153,4,96.07,3,4,3,10,Loyal
24417,386,6,2467.02,1,5,4,10,Loyal
24418,277,3,4329.61,2,3,5,10,Loyal
24419,277,3,71.58000000000001,2,3,2,7,Potential
24420,371,2,2393.06,1,2,4,7,Potential
24421,368,3,2447.05,1,3,4,8,Potential
24422,283,2,152.6,2,2,3,7,Potential
24423,307,1,32.6,1,1,1,3,At Risk
24424,314,4,249.58,1,4,3,8,Potential
24425,390,2,2419.06,1,2,4,7,Potential
24426,100,3,71.58000000000001,4,3,2,9,Potential
24427,376,4,2400.34,1,4,4,9,Potential
24428,71,2,152.6,5,2,3,10,Loyal
24429,346,5,146.06,1,5,3,9,Potential
24430,245,5,130.56,2,5,3,10,Loyal
24431,262,4,4334.599999999999,2,4,5,11,Loyal
24432,264,2,2438.06,2,2,4,8,Potential
24433,369,4,2442.54,1,4,4,9,Potential
24434,386,3,2398.0499999999997,1,3,4,8,Potential
24435,286,4,46.830000000000005,2,4,2,8,Potential
24436,338,2,2438.06,1,2,4,7,Potential
24437,342,4,2427.04,1,4,4,9,Potential
24438,13,4,96.07,5,4,3,12,Recent Customer
24439,151,3,71.58000000000001,3,3,2,8,Potential
24440,280,3,61.08,2,3,2,7,Potential
24441,244,2,2419.06,2,2,4,8,Potential
24442,157,2,82.59,3,2,2,7,Potential
24443,23,2,34.89,5,2,1,8,Recent Customer
24444,237,3,2443.55,2,3,4,9,Potential
24445,244,2,2419.06,2,2,4,8,Potential
24446,227,3,2447.05,2,3,4,9,Potential
24447,330,2,751.34,1,2,3,6,At Risk
24448,116,3,71.58000000000001,4,3,2,9,Potential
24449,260,3,38.88,2,3,1,6,At Risk
24450,318,2,67.59,1,2,2,5,At Risk
24451,291,3,38.88,1,3,1,5,At Risk
24452,329,1,32.6,1,1,1,3,At Risk
24453,102,3,60.47,4,3,2,9,Potential
24454,232,1,21.49,2,1,1,4,At Risk
24455,289,3,75.47,1,3,2,6,At Risk
24456,190,1,21.49,3,1,1,5,At Risk
24457,229,3,3356.0425,2,3,5,10,Loyal
24458,86,2,4144.34,4,2,5,11,Loyal
24459,74,4,3961.0325,4,4,5,13,Champions
24460,243,2,3302.0525,2,2,5,9,Potential
24461,241,2,3302.0525,2,2,5,9,Potential
24462,242,3,3617.83,2,3,5,10,Loyal
24463,92,3,3917.5425,4,3,5,12,Loyal
24464,229,1,4.99,2,1,1,4,At Risk
24465,239,3,3356.0425,2,3,5,10,Loyal
24466,239,3,3337.0425,2,3,5,10,Loyal
24467,241,3,3337.0425,2,3,5,10,Loyal
24468,69,2,4144.34,5,2,5,12,Loyal
24469,347,3,64.47,1,3,2,6,At Risk
24470,273,2,39.980000000000004,2,2,1,5,At Risk
24471,303,1,4.99,1,1,1,3,At Risk
24472,44,2,12.940000000000001,5,2,1,8,Potential
24473,153,2,13.98,3,2,1,6,At Risk
24474,60,2,3882.5525,5,2,5,12,Loyal
24475,38,4,3945.5325,5,4,5,14,Champions
24476,244,2,3563.84,2,2,5,9,Potential
24477,208,2,3302.0525,2,2,5,9,Potential
24478,187,3,3337.0425,3,3,5,11,Loyal
24479,12,2,7.28,5,2,1,8,Recent Customer
24480,41,5,4175.61,5,5,5,15,Champions
24481,44,3,4179.33,5,3,5,13,Champions
24482,45,2,3882.5525,5,2,5,12,Loyal
24483,135,3,23.97,3,3,1,7,Potential
24484,211,2,3563.84,2,2,5,9,Potential
24485,199,3,3356.0425,3,3,5,11,Loyal
24486,362,2,36.59,1,2,1,4,At Risk
24487,159,1,4.99,3,1,1,5,At Risk
24488,38,2,13.98,5,2,1,8,Potential
24489,291,1,4.99,1,1,1,3,At Risk
24490,133,2,36.59,4,2,1,7,Potential
24491,774,1,3578.27,1,1,5,7,Potential
24492,332,4,791.32,1,4,3,8,Potential
24493,789,1,3578.27,1,1,5,7,Potential
24494,363,1,9.99,1,1,1,3,At Risk
24495,15,2,14.98,5,2,1,8,Recent Customer
24496,239,3,4349.61,2,3,5,10,Loyal
24497,359,3,71.58000000000001,1,3,2,6,At Risk
24498,233,4,2407.04,2,4,4,10,Loyal
24499,253,1,32.6,2,1,1,4,At Risk
24500,231,3,71.58000000000001,2,3,2,7,Potential
24501,764,1,3578.27,1,1,5,7,Potential
24502,196,4,3623.3199999999997,3,4,5,12,Loyal
24503,183,3,3617.83,3,3,5,11,Loyal
24504,202,2,3563.84,3,2,5,10,Loyal
24505,201,2,3302.0525,3,2,5,10,Loyal
24506,194,2,3563.84,3,2,5,10,Loyal
24507,137,1,32.6,3,1,1,5,At Risk
24508,105,4,121.57000000000001,4,4,3,11,Loyal
24509,83,2,34.89,4,2,1,7,Potential
24510,118,3,61.08,4,3,2,9,Potential
24511,154,2,36.59,3,2,1,6,At Risk
24512,200,1,32.6,3,1,1,5,At Risk
24513,293,3,38.88,1,3,1,5,At Risk
24514,195,2,36.59,3,2,1,6,At Risk
24515,40,3,71.58000000000001,5,3,2,10,Loyal
24516,355,3,38.88,1,3,1,5,At Risk
24517,31,3,86.58,5,3,2,10,Loyal
24518,206,2,36.59,3,2,1,6,At Risk
24519,115,3,38.88,4,3,1,8,Potential
24520,215,3,2462.55,2,3,4,9,Potential
24521,347,2,2419.06,1,2,4,7,Potential
24522,359,3,2482.5600000000004,1,3,4,8,Potential
24523,356,6,2492.02,1,5,4,10,Loyal
24524,135,2,34.89,3,2,1,6,At Risk
24525,324,2,7.28,1,2,1,4,At Risk
24526,338,2,2419.06,1,2,4,7,Potential
24527,336,2,2419.06,1,2,4,7,Potential
24528,359,4,2420.34,1,4,4,9,Potential
24529,359,3,2398.0499999999997,1,3,4,8,Potential
24530,273,2,36.59,2,2,1,5,At Risk
24531,194,2,67.49,3,2,2,7,Potential
24532,87,2,38.980000000000004,4,2,1,7,Potential
24533,30,2,32.28,5,2,1,8,Recent Customer
24534,332,4,2533.93,1,4,4,9,Potential
24535,199,1,3.99,3,1,1,5,At Risk
24536,242,2,586.97,2,2,3,7,Potential
24537,334,4,2511.3199999999997,1,4,4,9,Potential
24538,64,1,3.99,5,1,1,7,Potential
24539,283,2,38.980000000000004,2,2,1,5,At Risk
24540,234,3,69.97,2,3,2,7,Potential
24541,42,3,37.269999999999996,5,3,1,9,Potential
24542,57,2,123.99,5,2,3,10,Loyal
24543,220,2,53.980000000000004,2,2,2,6,At Risk
24544,327,2,6.28,1,2,1,4,At Risk
24545,125,3,69.97,4,3,2,9,Potential
24546,289,3,37.269999999999996,1,3,1,5,At Risk
24547,219,2,38.980000000000004,2,2,1,5,At Risk
24548,255,2,38.980000000000004,2,2,1,5,At Risk
24549,279,4,2514.93,2,4,4,10,Loyal
24550,359,3,37.269999999999996,1,3,1,5,At Risk
24551,338,5,142.45,1,5,3,9,Potential
24552,57,2,38.980000000000004,5,2,1,8,Potential
24553,37,1,3.99,5,1,1,7,Potential
24554,170,3,69.97,3,3,2,8,Potential
24555,171,5,58.95,3,5,2,10,Loyal
24556,220,2,6.28,2,2,1,5,At Risk
24557,245,3,69.97,2,3,2,7,Potential
24558,276,3,2487.3299999999995,2,3,4,9,Potential
24559,121,2,6.28,4,2,1,7,Potential
24560,40,3,2404.9699999999993,5,3,4,12,Loyal
24561,356,1,3.99,1,1,1,3,At Risk
24562,118,1,3.99,4,1,1,6,At Risk
24563,187,2,6.28,3,2,1,6,At Risk
24564,119,2,38.980000000000004,4,2,1,7,Potential
24565,197,2,574.98,3,2,3,8,Potential
24566,69,1,4.99,5,1,1,7,Potential
24567,315,2,6.28,1,2,1,4,At Risk
24568,203,2,13.98,3,2,1,6,At Risk
24569,246,3,2479.94,2,3,4,9,Potential
24570,66,2,58.980000000000004,5,2,2,9,Potential
24571,32,3,27.77,5,3,1,9,Potential
24572,288,1,3.99,2,1,1,4,At Risk
24573,254,2,2563.35,2,2,4,8,Potential
24574,175,4,98.96000000000001,3,4,3,10,Loyal
24575,51,1,4.99,5,1,1,7,Potential
24576,202,3,89.97,3,3,2,8,Potential
24577,253,3,2487.3299999999995,2,3,4,9,Potential
24578,84,3,27.77,4,3,1,8,Potential
24579,44,2,38.980000000000004,5,2,1,8,Potential
24580,159,3,596.96,3,3,3,9,Potential
24581,93,2,39.980000000000004,4,2,1,7,Potential
24582,231,4,2466.3199999999997,2,4,4,10,Loyal
24583,227,3,2487.3299999999995,2,3,4,9,Potential
24584,237,2,30.479999999999997,2,2,1,5,At Risk
24585,211,5,3366.0225,2,5,5,12,Loyal
24586,33,2,4144.34,5,2,5,12,Loyal
24587,46,2,3882.5525,5,2,5,12,Loyal
24588,193,2,13.98,3,2,1,6,At Risk
24589,315,3,68.97,1,3,2,6,At Risk
24590,37,4,3911.5325000000003,5,4,5,14,Champions
24591,177,2,58.980000000000004,3,2,2,7,Potential
24592,53,4,3896.5325,5,4,5,14,Champions
24593,10,1,4.99,5,1,1,7,Recent Customer
24594,336,2,39.980000000000004,1,2,1,4,At Risk
24595,300,3,61.96,1,3,2,6,At Risk
24596,47,3,4168.83,5,3,5,13,Champions
24597,49,7,4009.5024999999996,5,5,5,15,Champions
24598,51,5,4228.3099999999995,5,5,5,15,Champions
24599,169,2,26.97,3,2,1,6,At Risk
24600,121,1,4.99,4,1,1,6,At Risk
24601,41,2,3882.5525,5,2,5,12,Loyal
24602,41,2,3882.5525,5,2,5,12,Loyal
24603,105,2,39.980000000000004,4,2,1,7,Potential
24604,395,6,3681.7999999999997,1,5,5,11,Loyal
24605,374,5,3627.81,1,5,5,11,Loyal
24606,381,3,2155.9175,1,3,4,8,Potential
24607,146,1,4.99,3,1,1,5,At Risk
24608,345,2,2120.9275,1,2,4,7,Potential
24609,360,2,2120.9275,1,2,4,7,Potential
24610,141,2,39.980000000000004,3,2,1,6,At Risk
24611,365,4,2219.4175,1,4,4,9,Potential
24612,347,5,2152.1975,1,5,4,10,Loyal
24613,360,4,2148.2075,1,4,4,9,Potential
24614,347,2,2120.9275,1,2,4,7,Potential
24615,328,3,2155.9175,1,3,4,8,Potential
24616,174,3,71.58000000000001,3,3,2,8,Potential
24617,271,2,34.89,2,2,1,5,At Risk
24618,230,1,32.6,2,1,1,4,At Risk
24619,321,1,32.6,1,1,1,3,At Risk
24620,94,3,195.59,4,3,3,10,Loyal
24621,252,2,12.940000000000001,2,2,1,5,At Risk
24622,251,4,96.07,2,4,3,9,Potential
24623,16,1,32.6,5,1,1,7,Recent Customer
24624,200,3,38.88,3,3,1,7,Potential
24625,117,2,13.98,4,2,1,7,Potential
24626,166,3,38.88,3,3,1,7,Potential
24627,199,2,68.49,3,2,2,7,Potential
24628,78,1,32.6,4,1,1,6,At Risk
24629,272,3,100.09,2,3,3,8,Potential
24630,245,1,4.99,2,1,1,4,At Risk
24631,71,5,146.06,5,5,3,13,Champions
24632,215,5,2483.0299999999997,2,5,4,11,Loyal
24633,239,3,2447.05,2,3,4,9,Potential
24634,111,5,130.56,4,5,3,12,Loyal
24635,4,3,71.58000000000001,5,3,2,10,Recent Customer
24636,71,1,32.6,5,1,1,7,Potential
24637,81,2,13.98,4,2,1,7,Potential
24638,86,2,57.09,4,2,2,8,Potential
24639,59,2,39.980000000000004,5,2,1,8,Potential
24640,225,2,2419.06,2,2,4,8,Potential
24641,239,1,2384.07,2,1,4,7,Potential
24642,153,3,38.88,3,3,1,7,Potential
24643,206,2,34.89,3,2,1,6,At Risk
24644,243,2,2393.06,2,2,4,8,Potential
24645,217,2,2438.06,2,2,4,8,Potential
24646,770,1,3578.27,1,1,5,7,Potential
24647,89,2,39.980000000000004,4,2,1,7,Potential
24648,258,4,791.32,2,4,3,9,Potential
24649,239,1,4.99,2,1,1,4,At Risk
24650,148,2,36.59,3,2,1,6,At Risk
24651,237,3,71.58000000000001,2,3,2,7,Potential
24652,362,3,91.58,1,3,2,6,At Risk
24653,184,2,2393.06,3,2,4,9,Potential
24654,203,4,2453.04,3,4,4,11,Loyal
24655,131,1,32.6,4,1,1,6,At Risk
24656,254,2,34.89,2,2,1,5,At Risk
24657,63,3,100.09,5,3,3,11,Loyal
24658,252,3,38.88,2,3,1,6,At Risk
24659,124,3,15.23,4,3,1,8,Potential
24660,362,2,2419.06,1,2,4,7,Potential
24661,369,3,4181.76,1,3,5,9,Potential
24662,350,4,2493.54,1,4,4,9,Potential
24663,24,2,58.980000000000004,5,2,2,9,Recent Customer
24664,163,6,4368.58,3,5,5,13,Champions
24665,182,3,109.97,3,3,3,9,Potential
24666,73,3,4370.61,5,3,5,13,Champions
24667,21,2,36.59,5,2,1,8,Recent Customer
24668,183,4,2473.04,3,4,4,11,Loyal
24669,358,2,2419.06,1,2,4,7,Potential
24670,309,2,2419.06,1,2,4,7,Potential
24671,49,4,4354.6,5,4,5,14,Champions
24672,2,3,71.58000000000001,5,3,2,10,Recent Customer
24673,308,3,2428.05,1,3,4,8,Potential
24674,328,1,2384.07,1,1,4,6,At Risk
24675,331,2,2419.06,1,2,4,7,Potential
24676,207,4,2461.5499999999997,2,4,4,10,Loyal
24677,260,1,32.6,2,1,1,4,At Risk
24678,170,3,100.09,3,3,3,9,Potential
24679,73,3,71.58000000000001,5,3,2,10,Loyal
24680,314,3,2418.05,1,3,4,8,Potential
24681,329,4,2453.04,1,4,4,9,Potential
24682,97,2,59.980000000000004,4,2,2,8,Potential
24683,207,2,2393.06,2,2,4,8,Potential
24684,212,2,2393.06,2,2,4,8,Potential
24685,190,2,2393.06,3,2,4,9,Potential
24686,6,3,38.88,5,3,1,9,Recent Customer
24687,234,3,91.58,2,3,2,7,Potential
24688,155,2,2393.06,3,2,4,9,Potential
24689,99,2,1155.48,4,2,3,9,Potential
24690,98,5,609.45,4,5,3,12,Loyal
24691,247,1,3.99,2,1,1,4,At Risk
24692,40,2,38.980000000000004,5,2,1,8,Potential
24693,292,2,7.28,1,2,1,4,At Risk
24694,266,2,57.980000000000004,2,2,2,6,At Risk
24695,325,3,166.28,1,3,3,7,Potential
24696,150,2,23.779999999999998,3,2,1,6,At Risk
24697,113,2,1170.48,4,2,4,10,Loyal
24698,117,2,574.98,4,2,3,9,Potential
24699,50,2,29.479999999999997,5,2,1,8,Potential
24700,119,4,2452.04,4,4,4,12,Loyal
24701,163,3,1744.97,3,3,4,10,Loyal
24702,88,2,1174.48,4,2,4,10,Loyal
24703,300,1,4.99,1,1,1,3,At Risk
24704,1,1,21.49,5,1,1,7,Recent Customer
24705,103,2,1155.48,4,2,3,9,Potential
24706,96,4,578.46,4,4,3,11,Loyal
24707,100,2,2393.06,4,2,4,10,Loyal
24708,73,2,2419.06,5,2,4,11,Loyal
24709,153,2,1735.98,3,2,4,9,Potential
24710,322,4,1732.26,1,4,4,9,Potential
24711,322,2,1750.98,1,2,4,7,Potential
24712,88,1,1120.49,4,1,3,8,Potential
24713,336,2,7.28,1,2,1,4,At Risk
24714,9,3,67.97,5,3,2,10,Recent Customer
24715,116,2,29.479999999999997,4,2,1,7,Potential
24716,122,4,561.9200000000001,4,4,3,11,Loyal
24717,95,1,539.99,4,1,3,8,Potential
24718,297,2,1750.98,1,2,4,7,Potential
24719,101,3,68.97,4,3,2,9,Potential
24720,239,3,15.23,2,3,1,6,At Risk
24721,132,3,89.97,4,3,2,9,Potential
24722,134,2,33.98,3,2,1,6,At Risk
24723,281,4,1793.47,2,4,4,10,Loyal
24724,122,2,28.979999999999997,4,2,1,7,Potential
24725,269,3,38.88,2,3,1,6,At Risk
24726,149,3,71.58000000000001,3,3,2,8,Potential
24727,32,3,71.58000000000001,5,3,2,10,Loyal
24728,158,2,57.09,3,2,2,7,Potential
24729,255,2,58.980000000000004,2,2,2,6,At Risk
24730,257,2,39.980000000000004,2,2,1,5,At Risk
24731,56,1,4.99,5,1,1,7,Potential
24732,177,4,99.57000000000001,3,4,3,10,Loyal
24733,56,2,7.28,5,2,1,8,Potential
24734,318,6,2492.02,1,5,4,10,Loyal
24735,321,4,2478.04,1,4,4,9,Potential
24736,243,3,71.58000000000001,2,3,2,7,Potential
24737,302,4,46.830000000000005,1,4,2,7,Potential
24738,177,4,2433.04,3,4,4,11,Loyal
24739,175,4,2453.04,3,4,4,11,Loyal
24740,271,4,96.07,2,4,3,9,Potential
24741,365,1,32.6,1,1,1,3,At Risk
24742,307,2,36.59,1,2,1,4,At Risk
24743,167,3,37.93,3,3,1,7,Potential
24744,112,1,4.99,4,1,1,6,At Risk
24745,188,2,29.979999999999997,3,2,1,6,At Risk
24746,360,2,13.98,1,2,1,4,At Risk
24747,16,3,64.97,5,3,2,10,Recent Customer
24748,340,2,39.980000000000004,1,2,1,4,At Risk
24749,127,3,64.97,4,3,2,9,Potential
24750,113,2,29.979999999999997,4,2,1,7,Potential
24751,215,3,147.28,2,3,3,8,Potential
24752,252,3,756.33,2,3,3,8,Potential
24753,237,4,791.32,2,4,3,9,Potential
24754,171,6,2439.98,3,5,4,12,Loyal
24755,172,2,39.980000000000004,3,2,1,6,At Risk
24756,163,3,2398.0499999999997,3,3,4,10,Loyal
24757,32,5,4343.59,5,5,5,15,Champions
24758,115,2,34.89,4,2,1,7,Potential
24759,58,5,4369.59,5,5,5,15,Champions
24760,170,2,2419.06,3,2,4,9,Potential
24761,155,2,2419.06,3,2,4,9,Potential
24762,167,2,2393.06,3,2,4,9,Potential
24763,291,1,4.99,1,1,1,3,At Risk
24764,168,3,2398.0499999999997,3,3,4,10,Loyal
24765,115,4,99.57000000000001,4,4,3,11,Loyal
24766,188,3,71.58000000000001,3,3,2,8,Potential
24767,151,3,86.58,3,3,2,8,Potential
24768,281,1,32.6,2,1,1,4,At Risk
24769,98,2,34.89,4,2,1,7,Potential
24770,180,3,2398.0499999999997,3,3,4,10,Loyal
24771,333,2,59.980000000000004,1,2,2,5,At Risk
24772,294,3,195.59,1,3,3,7,Potential
24773,288,2,7.28,2,2,1,5,At Risk
24774,203,1,32.6,3,1,1,5,At Risk
24775,2,2,36.59,5,2,1,8,Recent Customer
24776,343,3,91.58,1,3,2,6,At Risk
24777,351,3,71.58000000000001,1,3,2,6,At Risk
24778,342,5,2858.4925000000003,1,5,4,10,Loyal
24779,311,2,2419.06,1,2,4,7,Potential
24780,328,1,2384.07,1,1,4,6,At Risk
24781,756,1,2181.5625,1,1,4,6,At Risk
24782,178,4,2420.34,3,4,4,11,Loyal
24783,134,4,2420.34,3,4,4,11,Loyal
24784,301,2,2393.06,1,2,4,7,Potential
24785,133,4,2406.0,4,4,4,12,Loyal
24786,744,1,2443.35,1,1,4,6,At Risk
24787,140,2,2393.06,3,2,4,9,Potential
24788,136,3,2418.05,3,3,4,10,Loyal
24789,124,2,2419.06,4,2,4,10,Loyal
24790,139,4,2433.04,3,4,4,11,Loyal
24791,134,2,2419.06,3,2,4,9,Potential
24792,123,2,2419.06,4,2,4,10,Loyal
24793,106,2,2419.06,4,2,4,10,Loyal
24794,104,4,2448.04,4,4,4,12,Loyal
24795,104,5,2507.0299999999997,4,5,4,13,Champions
24796,118,3,2398.0499999999997,4,3,4,11,Loyal
24797,113,2,2393.06,4,2,4,10,Loyal
24798,111,4,2407.04,4,4,4,12,Loyal
24799,96,4,2452.04,4,4,4,12,Loyal
24800,106,2,2419.06,4,2,4,10,Loyal
24801,118,2,2419.06,4,2,4,10,Loyal
24802,302,4,2407.04,1,4,4,9,Potential
24803,249,1,32.6,2,1,1,4,At Risk
24804,299,1,2384.07,1,1,4,6,At Risk
24805,216,1,4.99,2,1,1,4,At Risk
24806,302,2,2413.06,1,2,4,7,Potential
24807,292,3,2469.05,1,3,4,8,Potential
24808,297,4,2407.04,1,4,4,9,Potential
24809,295,2,2419.06,1,2,4,7,Potential
24810,95,2,2419.06,4,2,4,10,Loyal
24811,120,2,2438.06,4,2,4,10,Loyal
24812,240,2,82.59,2,2,2,6,At Risk
24813,291,3,71.58000000000001,1,3,2,6,At Risk
24814,87,2,2419.06,4,2,4,10,Loyal
24815,295,2,2438.06,1,2,4,7,Potential
24816,215,1,4.99,2,1,1,4,At Risk
24817,743,1,2181.5625,1,1,4,6,At Risk
24818,278,2,2438.06,2,2,4,8,Potential
24819,290,2,2393.06,1,2,4,7,Potential
24820,359,3,38.88,1,3,1,5,At Risk
24821,191,3,42.84,3,3,2,8,Potential
24822,175,3,195.59,3,3,3,9,Potential
24823,11,4,95.57000000000001,5,4,3,12,Recent Customer
24824,745,1,2181.5625,1,1,4,6,At Risk
24825,136,1,4.99,3,1,1,5,At Risk
24826,203,4,96.07,3,4,3,10,Loyal
24827,297,2,34.89,1,2,1,4,At Risk
24828,73,2,2419.06,5,2,4,11,Loyal
24829,355,2,34.89,1,2,1,4,At Risk
24830,291,4,96.07,1,4,3,8,Potential
24831,78,3,2398.0499999999997,4,3,4,11,Loyal
24832,733,1,2181.5625,1,1,4,6,At Risk
24833,134,2,1754.98,3,2,4,9,Potential
24834,277,3,1744.97,2,3,4,9,Potential
24835,80,2,1170.48,4,2,4,10,Loyal
24836,97,2,29.479999999999997,4,2,1,7,Potential
24837,165,4,587.9200000000001,3,4,3,10,Loyal
24838,132,2,23.779999999999998,4,2,1,7,Potential
24839,365,3,33.43,1,3,1,5,At Risk
24840,49,2,29.479999999999997,5,2,1,8,Potential
24841,43,3,2319.2599999999998,5,3,4,12,Loyal
24842,227,2,23.779999999999998,2,2,1,5,At Risk
24843,130,3,88.98,4,3,2,9,Potential
24844,49,2,25.479999999999997,5,2,1,8,Potential
24845,118,4,69.46000000000001,4,4,2,10,Loyal
24846,236,2,23.779999999999998,2,2,1,5,At Risk
24847,226,4,2552.8199999999997,2,4,4,10,Loyal
24848,16,1,21.49,5,1,1,7,Recent Customer
24849,86,3,27.77,4,3,1,8,Potential
24850,144,3,624.97,3,3,3,9,Potential
24851,203,2,29.479999999999997,3,2,1,6,At Risk
24852,219,3,2457.3299999999995,2,3,4,9,Potential
24853,165,2,39.980000000000004,3,2,1,6,At Risk
24854,207,2,23.779999999999998,2,2,1,5,At Risk
24855,346,2,25.479999999999997,1,2,1,4,At Risk
24856,112,3,27.77,4,3,1,8,Potential
24857,214,1,4.99,2,1,1,4,At Risk
24858,292,2,39.980000000000004,1,2,1,4,At Risk
24859,4,2,39.980000000000004,5,2,1,8,Recent Customer
24860,227,5,2520.31,2,5,4,11,Loyal
24861,93,2,75.48,4,2,2,8,Potential
24862,234,2,75.48,2,2,2,6,At Risk
24863,326,3,27.77,1,3,1,5,At Risk
24864,194,5,155.72,3,5,3,11,Loyal
24865,188,2,2478.3399999999997,3,2,4,9,Potential
24866,326,3,27.77,1,3,1,5,At Risk
24867,177,1,21.49,3,1,1,5,At Risk
24868,196,5,2501.31,3,5,4,12,Loyal
24869,128,2,39.980000000000004,4,2,1,7,Potential
24870,201,3,2457.3299999999995,3,3,4,10,Loyal
24871,199,4,35.72,3,4,1,8,Potential
24872,320,2,23.779999999999998,1,2,1,4,At Risk
24873,63,2,548.98,5,2,3,10,Loyal
24874,105,1,21.49,4,1,1,6,At Risk
24875,216,3,27.77,2,3,1,6,At Risk
24876,284,3,49.97,2,3,2,7,Potential
24877,27,3,34.47,5,3,1,9,Recent Customer
24878,255,2,23.779999999999998,2,2,1,5,At Risk
24879,114,1,21.49,4,1,1,6,At Risk
24880,42,2,39.980000000000004,5,2,1,8,Potential
24881,231,1,4.99,2,1,1,4,At Risk
24882,324,2,23.779999999999998,1,2,1,4,At Risk
24883,390,3,2487.3299999999995,1,3,4,8,Potential
24884,121,2,23.779999999999998,4,2,1,7,Potential
24885,18,3,31.729999999999997,5,3,1,9,Recent Customer
24886,214,3,80.47,2,3,2,7,Potential
24887,324,5,2218.8974999999996,1,5,4,10,Loyal
24888,310,3,2174.9175,1,3,4,8,Potential
24889,317,5,2269.9075,1,5,4,10,Loyal
24890,356,2,39.980000000000004,1,2,1,4,At Risk
24891,52,1,4.99,5,1,1,7,Potential
24892,41,2,7.28,5,2,1,8,Potential
24893,254,2,23.779999999999998,2,2,1,5,At Risk
24894,346,1,4.99,1,1,1,3,At Risk
24895,332,1,4.99,1,1,1,3,At Risk
24896,72,3,15.23,5,3,1,9,Potential
24897,198,1,4.99,3,1,1,5,At Risk
24898,280,2,7.28,2,2,1,5,At Risk
24899,343,5,105.45,1,5,3,9,Potential
24900,329,3,2155.9175,1,3,4,8,Potential
24901,330,3,2174.9175,1,3,4,8,Potential
24902,309,2,2120.9275,1,2,4,7,Potential
24903,326,4,2164.9075,1,4,4,9,Potential
24904,315,5,2199.8975,1,5,4,10,Loyal
24905,303,4,2195.9075,1,4,4,9,Potential
24906,300,3,61.96,1,3,2,6,At Risk
24907,298,4,2183.9075,1,4,4,9,Potential
24908,287,3,2155.9175,2,3,4,9,Potential
24909,279,4,2149.9075000000003,2,4,4,10,Loyal
24910,293,4,2183.9074999999993,1,4,4,9,Potential
24911,182,4,102.96000000000001,3,4,3,10,Loyal
24912,291,2,2120.9275,1,2,4,7,Potential
24913,263,3,2155.9175,2,3,4,9,Potential
24914,272,4,2149.9075,2,4,4,10,Loyal
24915,265,3,2145.9175,2,3,4,9,Potential
24916,272,5,2169.8975,2,5,4,11,Loyal
24917,261,4,2179.9075000000003,2,4,4,10,Loyal
24918,253,2,2120.9275,2,2,4,8,Potential
24919,272,6,2212.8875,2,5,4,11,Loyal
24920,272,3,2155.9175,2,3,4,9,Potential
24921,262,4,2180.4074999999993,2,4,4,10,Loyal
24922,247,3,2145.9175,2,3,4,9,Potential
24923,255,5,2159.3975,2,5,4,11,Loyal
24924,241,5,2143.8974999999996,2,5,4,11,Loyal
24925,45,3,32.269999999999996,5,3,1,9,Potential
24926,36,3,64.97,5,3,2,10,Loyal
24927,300,4,191.27,1,4,3,8,Potential
24928,291,2,27.279999999999998,1,2,1,4,At Risk
24929,227,3,64.97,2,3,2,7,Potential
24930,351,3,64.97,1,3,2,6,At Risk
24931,206,2,36.59,3,2,1,6,At Risk
24932,245,3,71.58000000000001,2,3,2,7,Potential
24933,304,1,32.6,1,1,1,3,At Risk
24934,57,1,32.6,5,1,1,7,Potential
24935,145,3,38.88,3,3,1,7,Potential
24936,80,3,38.88,4,3,1,8,Potential
24937,57,1,32.6,5,1,1,7,Potential
24938,215,3,38.88,2,3,1,6,At Risk
24939,164,2,7.28,3,2,1,6,At Risk
24940,366,2,34.89,1,2,1,4,At Risk
24941,313,1,32.6,1,1,1,3,At Risk
24942,92,2,2419.06,4,2,4,10,Loyal
24943,64,3,71.58000000000001,5,3,2,10,Loyal
24944,305,4,125.57000000000001,1,4,3,8,Potential
24945,262,2,152.6,2,2,3,7,Potential
24946,283,3,38.88,2,3,1,6,At Risk
24947,241,2,39.980000000000004,2,2,1,5,At Risk
24948,128,2,36.59,4,2,1,7,Potential
24949,92,1,32.6,4,1,1,6,At Risk
24950,137,3,38.88,3,3,1,7,Potential
24951,183,1,32.6,3,1,1,5,At Risk
24952,350,3,71.58000000000001,1,3,2,6,At Risk
24953,230,2,27.279999999999998,2,2,1,5,At Risk
24954,114,3,71.58000000000001,4,3,2,9,Potential
24955,206,1,742.35,3,1,3,7,Potential
24956,206,2,751.34,3,2,3,8,Potential
24957,209,2,777.34,2,2,3,7,Potential
24958,73,1,2384.07,5,1,4,10,Loyal
24959,288,2,2419.06,2,2,4,8,Potential
24960,315,4,3008.8199999999997,1,4,4,9,Potential
24961,209,3,71.58000000000001,2,3,2,7,Potential
24962,191,1,32.6,3,1,1,5,At Risk
24963,283,1,32.6,2,1,1,4,At Risk
24964,12,4,121.57000000000001,5,4,3,12,Recent Customer
24965,221,3,71.58000000000001,2,3,2,7,Potential
24966,284,2,2419.06,2,2,4,8,Potential
24967,30,1,4.99,5,1,1,7,Recent Customer
24968,216,3,44.540000000000006,2,3,2,7,Potential
24969,339,2,34.89,1,2,1,4,At Risk
24970,228,3,38.88,2,3,1,6,At Risk
24971,90,2,152.6,4,2,3,9,Potential
24972,87,3,2398.0499999999997,4,3,4,11,Loyal
24973,239,3,71.58000000000001,2,3,2,7,Potential
24974,143,3,100.09,3,3,3,9,Potential
24975,103,3,67.93,4,3,2,9,Potential
24976,758,1,2181.5625,1,1,4,6,At Risk
24977,749,1,2181.5625,1,1,4,6,At Risk
24978,199,4,155.08,3,4,3,10,Loyal
24979,79,2,2419.06,4,2,4,10,Loyal
24980,239,1,32.6,2,1,1,4,At Risk
24981,138,1,32.6,3,1,1,5,At Risk
24982,276,2,34.89,2,2,1,5,At Risk
24983,91,3,38.88,4,3,1,8,Potential
24984,180,2,36.59,3,2,1,6,At Risk
24985,145,4,96.07,3,4,3,10,Loyal
24986,88,1,4.99,4,1,1,6,At Risk
24987,78,2,2413.06,4,2,4,10,Loyal
24988,300,2,2419.06,1,2,4,7,Potential
24989,360,2,36.59,1,2,1,4,At Risk
24990,279,4,2468.04,2,4,4,10,Loyal
24991,291,2,34.89,1,2,1,4,At Risk
24992,238,3,42.84,2,3,2,7,Potential
24993,51,3,61.08,5,3,2,10,Loyal
24994,366,2,34.89,1,2,1,4,At Risk
24995,314,1,4.99,1,1,1,3,At Risk
24996,90,3,2418.05,4,3,4,11,Loyal
24997,41,2,2438.06,5,2,4,11,Loyal
24998,302,2,2438.06,1,2,4,7,Potential
24999,133,1,32.6,4,1,1,6,At Risk
25000,47,3,2418.05,5,3,4,12,Loyal
25001,206,3,49.970000000000006,3,3,2,8,Potential
25002,211,1,4.99,2,1,1,4,At Risk
25003,227,2,49.48,2,2,2,6,At Risk
25004,8,1,24.99,5,1,1,7,Recent Customer
25005,305,3,64.97,1,3,2,6,At Risk
25006,214,2,29.979999999999997,2,2,1,5,At Risk
25007,279,2,27.279999999999998,2,2,1,5,At Risk
25008,41,2,2438.06,5,2,4,11,Loyal
25009,113,2,14.98,4,2,1,7,Potential
25010,102,2,1540.4275,4,2,4,10,Loyal
25011,113,5,1589.3975,4,5,4,13,Champions
25012,291,4,74.46,1,4,2,7,Potential
25013,80,3,69.97,4,3,2,9,Potential
25014,50,2,2419.06,5,2,4,11,Loyal
25015,297,4,2461.5499999999997,1,4,4,9,Potential
25016,188,1,4.99,3,1,1,5,At Risk
25017,156,2,14.98,3,2,1,6,At Risk
25018,244,4,197.88,2,4,3,9,Potential
25019,68,3,23.97,5,3,1,9,Potential
25020,120,3,1549.4175,4,3,4,11,Loyal
25021,113,4,1554.4075,4,4,4,12,Loyal
25022,96,3,1564.9175,4,3,4,11,Loyal
25023,287,3,38.88,2,3,1,6,At Risk
25024,171,1,32.6,3,1,1,5,At Risk
25025,300,3,2469.05,1,3,4,8,Potential
25026,336,2,6.28,1,2,1,4,At Risk
25027,22,3,60.47,5,3,2,10,Recent Customer
25028,23,2,23.779999999999998,5,2,1,8,Recent Customer
25029,183,6,2272.1975,3,5,4,12,Loyal
25030,161,4,2180.4075,3,4,4,11,Loyal
25031,272,2,25.479999999999997,2,2,1,5,At Risk
25032,180,5,2184.8975,3,5,4,12,Loyal
25033,177,2,2120.9275,3,2,4,9,Potential
25034,223,4,2164.9075,2,4,4,10,Loyal
25035,226,4,2183.9075,2,4,4,10,Loyal
25036,237,2,2120.9275,2,2,4,8,Potential
25037,221,3,2174.9175,2,3,4,9,Potential
25038,33,2,2438.06,5,2,4,11,Loyal
25039,71,1,32.6,5,1,1,7,Potential
25040,58,4,2420.34,5,4,4,13,Champions
25041,68,1,32.6,5,1,1,7,Potential
25042,39,2,2419.06,5,2,4,11,Loyal
25043,159,3,161.59,3,3,3,9,Potential
25044,254,2,36.59,2,2,1,5,At Risk
25045,362,3,38.88,1,3,1,5,At Risk
25046,758,1,2181.5625,1,1,4,6,At Risk
25047,59,4,2448.04,5,4,4,13,Champions
25048,314,3,3046.84,1,3,4,8,Potential
25049,275,2,2393.06,2,2,4,8,Potential
25050,272,2,2419.06,2,2,4,8,Potential
25051,229,3,2174.9175,2,3,4,9,Potential
25052,214,3,2155.9175,2,3,4,9,Potential
25053,242,4,2183.9074999999993,2,4,4,10,Loyal
25054,190,3,103.48,3,3,3,9,Potential
25055,131,2,7.28,4,2,1,7,Potential
25056,162,2,7.28,3,2,1,6,At Risk
25057,243,2,2120.9275,2,2,4,8,Potential
25058,94,2,7.28,4,2,1,7,Potential
25059,273,3,2462.55,2,3,4,9,Potential
25060,264,2,2419.06,2,2,4,8,Potential
25061,738,1,2443.35,1,1,4,6,At Risk
25062,292,2,13.98,1,2,1,4,At Risk
25063,55,2,2419.06,5,2,4,11,Loyal
25064,271,3,2447.05,2,3,4,9,Potential
25065,305,3,71.58000000000001,1,3,2,6,At Risk
25066,3,3,15.23,5,3,1,9,Recent Customer
25067,37,3,71.58000000000001,5,3,2,10,Loyal
25068,108,1,32.6,4,1,1,6,At Risk
25069,219,3,71.58000000000001,2,3,2,7,Potential
25070,133,2,68.49,4,2,2,8,Potential
25071,17,3,38.88,5,3,1,9,Recent Customer
25072,42,3,2469.05,5,3,4,12,Loyal
25073,37,3,2473.05,5,3,4,12,Loyal
25074,251,2,2393.06,2,2,4,8,Potential
25075,271,3,2469.05,2,3,4,9,Potential
25076,41,3,2469.05,5,3,4,12,Loyal
25077,46,2,2419.06,5,2,4,11,Loyal
25078,57,4,2473.04,5,4,4,13,Champions
25079,245,2,2419.06,2,2,4,8,Potential
25080,265,4,2433.04,2,4,4,10,Loyal
25081,162,2,777.34,3,2,3,8,Potential
25082,110,2,34.89,4,2,1,7,Potential
25083,82,2,36.59,4,2,1,7,Potential
25084,48,2,2393.06,5,2,4,11,Loyal
25085,374,3,1228.83,1,3,4,8,Potential
25086,395,5,1308.31,1,5,4,10,Loyal
25087,372,2,1249.84,1,2,4,7,Potential
25088,381,2,1249.84,1,2,4,7,Potential
25089,130,2,34.89,4,2,1,7,Potential
25090,50,3,67.93,5,3,2,10,Loyal
25091,297,2,36.59,1,2,1,4,At Risk
25092,387,4,1257.82,1,4,4,9,Potential
25093,746,1,2181.5625,1,1,4,6,At Risk
25094,748,1,2443.35,1,1,4,6,At Risk
25095,728,1,2443.35,1,1,4,6,At Risk
25096,351,4,1236.78,1,4,4,9,Potential
25097,350,2,1268.84,1,2,4,7,Potential
25098,341,4,1251.12,1,4,4,9,Potential
25099,340,2,1249.84,1,2,4,7,Potential
25100,726,1,2443.35,1,1,4,6,At Risk
25101,27,2,68.49,5,2,2,9,Recent Customer
25102,344,3,71.58000000000001,1,3,2,6,At Risk
25103,178,3,90.58000000000001,3,3,2,8,Potential
25104,292,3,3018.33,1,3,4,8,Potential
25105,270,4,2433.04,2,4,4,10,Loyal
25106,229,3,2170.9175,2,3,4,9,Potential
25107,244,5,2143.8975,2,5,4,11,Loyal
25108,176,4,2199.4075,3,4,4,11,Loyal
25109,247,1,4.99,2,1,1,4,At Risk
25110,187,2,39.980000000000004,3,2,1,6,At Risk
25111,238,3,2145.9175,2,3,4,9,Potential
25112,160,3,2155.9175,3,3,4,10,Loyal
25113,163,4,2180.4075,3,4,4,11,Loyal
25114,166,3,2155.9175,3,3,4,10,Loyal
25115,227,3,2155.9175,2,3,4,9,Potential
25116,244,2,39.980000000000004,2,2,1,5,At Risk
25117,30,2,7.28,5,2,1,8,Recent Customer
25118,162,2,7.28,3,2,1,6,At Risk
25119,225,4,2148.2075,2,4,4,10,Loyal
25120,227,3,2155.9174999999996,2,3,4,9,Potential
25121,224,3,2155.9175,2,3,4,9,Potential
25122,63,2,39.980000000000004,5,2,1,8,Potential
25123,140,2,39.980000000000004,3,2,1,6,At Risk
25124,248,3,64.47,2,3,2,7,Potential
25125,126,2,68.49,4,2,2,8,Potential
25126,226,3,2174.9175,2,3,4,9,Potential
25127,212,3,2174.9175,2,3,4,9,Potential
25128,158,3,60.47,3,3,2,8,Potential
25129,342,3,60.47,1,3,2,6,At Risk
25130,265,2,7.28,2,2,1,5,At Risk
25131,192,1,4.99,3,1,1,5,At Risk
25132,134,1,4.99,3,1,1,5,At Risk
25133,183,3,2155.9175,3,3,4,10,Loyal
25134,47,2,39.980000000000004,5,2,1,8,Potential
25135,58,2,7.28,5,2,1,8,Potential
25136,299,2,39.980000000000004,1,2,1,4,At Risk
25137,8,2,7.28,5,2,1,8,Recent Customer
25138,194,2,2120.9275,3,2,4,9,Potential
25139,103,3,60.47,4,3,2,9,Potential
25140,70,1,21.49,5,1,1,7,Potential
25141,264,1,4.99,2,1,1,4,At Risk
25142,300,2,13.98,1,2,1,4,At Risk
25143,55,2,39.980000000000004,5,2,1,8,Potential
25144,134,2,25.479999999999997,3,2,1,6,At Risk
25145,222,2,23.779999999999998,2,2,1,5,At Risk
25146,363,2,1223.84,1,2,4,7,Potential
25147,182,2,39.980000000000004,3,2,1,6,At Risk
25148,335,2,1249.84,1,2,4,7,Potential
25149,60,3,45.58,5,3,2,10,Loyal
25150,268,2,2419.06,2,2,4,8,Potential
25151,88,2,36.59,4,2,1,7,Potential
25152,318,2,34.89,1,2,1,4,At Risk
25153,119,4,96.07,4,4,3,11,Loyal
25154,37,3,45.58,5,3,2,10,Loyal
25155,245,2,2419.06,2,2,4,8,Potential
25156,352,2,36.59,1,2,1,4,At Risk
25157,210,2,7.28,2,2,1,5,At Risk
25158,147,3,71.58000000000001,3,3,2,8,Potential
25159,127,3,71.58000000000001,4,3,2,9,Potential
25160,228,4,46.830000000000005,2,4,2,8,Potential
25161,249,2,2438.06,2,2,4,8,Potential
25162,260,1,2384.07,2,1,4,7,Potential
25163,257,4,2433.04,2,4,4,10,Loyal
25164,256,2,34.89,2,2,1,5,At Risk
25165,44,3,91.58000000000001,5,3,2,10,Loyal
25166,126,5,134.56,4,5,3,12,Loyal
25167,70,3,71.58000000000001,5,3,2,10,Loyal
25168,159,3,38.88,3,3,1,7,Potential
25169,252,1,2384.07,2,1,4,7,Potential
25170,103,1,32.6,4,1,1,6,At Risk
25171,278,2,36.59,2,2,1,5,At Risk
25172,224,4,96.07,2,4,3,9,Potential
25173,225,3,36.96,2,3,1,6,At Risk
25174,250,3,92.08,2,3,3,8,Potential
25175,260,1,2384.07,2,1,4,7,Potential
25176,127,2,36.59,4,2,1,7,Potential
25177,4,3,36.96,5,3,1,9,Recent Customer
25178,24,2,36.59,5,2,1,8,Recent Customer
25179,126,3,71.58000000000001,4,3,2,9,Potential
25180,253,3,2447.05,2,3,4,9,Potential
25181,331,1,32.6,1,1,1,3,At Risk
25182,223,2,67.59,2,2,2,6,At Risk
25183,229,2,82.59,2,2,2,6,At Risk
25184,263,2,2438.06,2,2,4,8,Potential
25185,260,4,2453.04,2,4,4,10,Loyal
25186,259,3,2462.55,2,3,4,9,Potential
25187,8,3,71.58000000000001,5,3,2,10,Recent Customer
25188,272,2,13.98,2,2,1,5,At Risk
25189,28,2,152.6,5,2,3,10,Recent Customer
25190,138,2,36.59,3,2,1,6,At Risk
25191,254,2,2419.06,2,2,4,8,Potential
25192,262,5,2480.9900000000002,2,5,4,11,Loyal
25193,240,2,2419.06,2,2,4,8,Potential
25194,211,1,32.6,2,1,1,4,At Risk
25195,170,2,36.59,3,2,1,6,At Risk
25196,84,2,54.980000000000004,4,2,2,8,Potential
25197,262,2,36.59,2,2,1,5,At Risk
25198,314,2,1249.84,1,2,4,7,Potential
25199,322,2,1249.84,1,2,4,7,Potential
25200,35,3,100.09,5,3,3,11,Loyal
25201,100,4,96.07,4,4,3,11,Loyal
25202,75,2,36.59,4,2,1,7,Potential
25203,322,2,1223.84,1,2,4,7,Potential
25204,317,2,1249.84,1,2,4,7,Potential
25205,90,3,32.269999999999996,4,3,1,8,Potential
25206,303,1,24.99,1,1,1,3,At Risk
25207,267,4,86.95,2,4,2,8,Potential
25208,253,2,27.279999999999998,2,2,1,5,At Risk
25209,188,4,98.96000000000001,3,4,3,10,Loyal
25210,235,2,23.779999999999998,2,2,1,5,At Risk
25211,100,3,79.47,4,3,2,9,Potential
25212,75,3,27.77,4,3,1,8,Potential
25213,209,5,2184.8975,2,5,4,11,Loyal
25214,190,4,2149.9075000000003,3,4,4,11,Loyal
25215,208,3,2155.9174999999996,2,3,4,9,Potential
25216,146,3,79.47,3,3,2,8,Potential
25217,279,2,39.980000000000004,2,2,1,5,At Risk
25218,202,5,2184.8975,3,5,4,12,Loyal
25219,298,2,39.980000000000004,1,2,1,4,At Risk
25220,325,2,23.779999999999998,1,2,1,4,At Risk
25221,181,5,2143.8975,3,5,4,12,Loyal
25222,157,2,2120.9275,3,2,4,9,Potential
25223,308,4,102.96000000000001,1,4,3,8,Potential
25224,302,2,7.28,1,2,1,4,At Risk
25225,185,3,2129.9175,3,3,4,10,Loyal
25226,193,5,2158.8975,3,5,4,12,Loyal
25227,113,2,39.980000000000004,4,2,1,7,Potential
25228,183,2,2120.9275,3,2,4,9,Potential
25229,197,3,2155.9175,3,3,4,10,Loyal
25230,261,3,80.96000000000001,2,3,2,7,Potential
25231,202,5,2189.8975,3,5,4,12,Loyal
25232,6,2,12.940000000000001,5,2,1,8,Recent Customer
25233,202,2,7.28,3,2,1,6,At Risk
25234,198,3,2174.9175,3,3,4,10,Loyal
25235,157,3,2155.9175,3,3,4,10,Loyal
25236,128,2,39.980000000000004,4,2,1,7,Potential
25237,12,4,118.46000000000001,5,4,3,12,Recent Customer
25238,237,2,7.28,2,2,1,5,At Risk
25239,124,2,7.28,4,2,1,7,Potential
25240,168,2,2120.9275,3,2,4,9,Potential
25241,224,1,4.99,2,1,1,4,At Risk
25242,175,2,2120.9275,3,2,4,9,Potential
25243,180,3,2155.9175,3,3,4,10,Loyal
25244,332,3,21.93,1,3,1,5,At Risk
25245,167,2,58.980000000000004,3,2,2,7,Potential
25246,81,3,27.77,4,3,1,8,Potential
25247,63,1,4.99,5,1,1,7,Potential
25248,69,2,39.980000000000004,5,2,1,8,Potential
25249,159,5,1868.5582,3,5,4,12,Loyal
25250,154,5,1883.5582,3,5,4,12,Loyal
25251,57,2,39.980000000000004,5,2,1,8,Potential
25252,160,6,1893.0482,3,5,4,12,Loyal
25253,316,4,73.96000000000001,1,4,2,7,Potential
25254,182,3,51.96,3,3,2,8,Potential
25255,175,1,32.6,3,1,1,5,At Risk
25256,336,3,67.93,1,3,2,6,At Risk
25257,207,3,147.28,2,3,3,8,Potential
25258,161,2,49.48,3,2,2,7,Potential
25259,291,3,32.269999999999996,1,3,1,5,At Risk
25260,151,2,34.89,3,2,1,6,At Risk
25261,310,3,71.58000000000001,1,3,2,6,At Risk
25262,47,4,35.72,5,4,1,10,Loyal
25263,143,3,60.47,3,3,2,8,Potential
25264,99,4,80.57000000000001,4,4,2,10,Loyal
25265,316,2,54.980000000000004,1,2,2,5,At Risk
25266,208,2,57.980000000000004,2,2,2,6,At Risk
25267,312,2,25.479999999999997,1,2,1,4,At Risk
25268,130,3,60.47,4,3,2,9,Potential
25269,141,2,23.779999999999998,3,2,1,6,At Risk
25270,163,3,1854.5782,3,3,4,10,Loyal
25271,154,3,1854.5782,3,3,4,10,Loyal
25272,177,3,1873.5782,3,3,4,10,Loyal
25273,165,4,1898.0682,3,4,4,11,Loyal
25274,119,3,71.58000000000001,4,3,2,9,Potential
25275,167,2,34.89,3,2,1,6,At Risk
25276,173,3,38.88,3,3,1,7,Potential
25277,106,4,96.07,4,4,3,11,Loyal
25278,119,2,36.59,4,2,1,7,Potential
25279,37,1,32.6,5,1,1,7,Potential
25280,37,3,38.88,5,3,1,9,Potential
25281,309,2,1249.84,1,2,4,7,Potential
25282,21,1,32.6,5,1,1,7,Recent Customer
25283,191,3,38.88,3,3,1,7,Potential
25284,242,2,2419.06,2,2,4,8,Potential
25285,229,2,2438.06,2,2,4,8,Potential
25286,233,2,2393.06,2,2,4,8,Potential
25287,246,2,2983.34,2,2,4,8,Potential
25288,256,2,2721.5525,2,2,4,8,Potential
25289,219,4,2453.04,2,4,4,10,Loyal
25290,217,2,2419.06,2,2,4,8,Potential
25291,40,3,38.88,5,3,1,9,Potential
25292,260,4,158.88,2,4,3,9,Potential
25293,124,2,67.59,4,2,2,8,Potential
25294,156,4,1882.5682,3,4,4,11,Loyal
25295,15,2,39.980000000000004,5,2,1,8,Recent Customer
25296,9,2,25.479999999999997,5,2,1,8,Recent Customer
25297,65,2,23.779999999999998,5,2,1,8,Potential
25298,146,1,4.99,3,1,1,5,At Risk
25299,298,1,4.99,1,1,1,3,At Risk
25300,237,2,75.48,2,2,2,6,At Risk
25301,99,2,1170.48,4,2,4,10,Loyal
25302,52,4,69.46000000000001,5,4,2,11,Loyal
25303,70,2,574.98,5,2,3,10,Loyal
25304,264,2,67.49,2,2,2,6,At Risk
25305,291,2,1725.98,1,2,4,7,Potential
25306,258,4,1769.96,2,4,4,10,Loyal
25307,219,3,1759.97,2,3,4,9,Potential
25308,116,1,1120.49,4,1,3,8,Potential
25309,65,4,562.96,5,4,3,12,Loyal
25310,365,3,60.47,1,3,2,6,At Risk
25311,136,2,1735.98,3,2,4,9,Potential
25312,81,3,1198.97,4,3,4,11,Loyal
25313,188,1,3.99,3,1,1,5,At Risk
25314,309,2,7.28,1,2,1,4,At Risk
25315,54,2,6.28,5,2,1,8,Potential
25316,176,1,4.99,3,1,1,5,At Risk
25317,194,3,88.98,3,3,2,8,Potential
25318,108,2,25.479999999999997,4,2,1,7,Potential
25319,69,4,2420.34,5,4,4,13,Champions
25320,69,2,2419.06,5,2,4,11,Loyal
25321,103,2,1735.98,4,2,4,10,Loyal
25322,230,2,7.28,2,2,1,5,At Risk
25323,222,3,1714.97,2,3,4,9,Potential
25324,338,2,39.980000000000004,1,2,1,4,At Risk
25325,250,2,6.28,2,2,1,5,At Risk
25326,207,3,78.97,2,4,2,8,Potential
25327,222,1,4.99,2,1,1,4,At Risk
25328,211,3,89.97,2,4,2,8,Potential
25329,322,3,100.09,1,4,3,8,Potential
25330,31,3,100.09,5,4,3,12,Loyal
25331,237,2,7.28,2,2,1,5,At Risk
25332,244,2,39.980000000000004,2,2,1,5,At Risk
25333,139,3,100.09,3,4,3,10,Loyal
25334,239,3,2398.0499999999997,2,4,4,10,Loyal
25335,358,2,59.980000000000004,1,2,2,5,At Risk
25336,278,1,24.99,2,1,1,4,At Risk
25337,363,2,29.979999999999997,1,2,1,4,At Risk
25338,273,2,27.279999999999998,2,2,1,5,At Risk
25339,316,2,1223.84,1,2,4,7,Potential
25340,72,1,4.99,5,1,1,7,Potential
25341,217,3,64.97,2,4,2,8,Potential
25342,270,1,24.99,2,1,1,4,At Risk
25343,297,1,24.99,1,1,1,3,At Risk
25344,103,3,801.83,4,4,3,11,Loyal
25345,142,1,24.99,3,1,1,5,At Risk
25346,18,4,114.96000000000001,5,4,3,12,Recent Customer
25347,290,2,59.980000000000004,1,2,2,5,At Risk
25348,270,3,64.97,2,4,2,8,Potential
25349,185,1,4.99,3,1,1,5,At Risk
25350,139,3,32.269999999999996,3,4,1,8,Potential
25351,299,2,49.48,1,2,2,5,At Risk
25352,148,2,29.979999999999997,3,2,1,6,At Risk
25353,145,2,27.279999999999998,3,2,1,6,At Risk
25354,62,1,24.99,5,1,1,7,Potential
25355,179,2,59.980000000000004,3,2,2,7,Potential
25356,286,2,27.279999999999998,2,2,1,5,At Risk
25357,113,3,147.28,4,4,3,11,Loyal
25358,196,2,27.279999999999998,3,2,1,6,At Risk
25359,252,1,24.99,2,1,1,4,At Risk
25360,108,3,32.269999999999996,4,4,1,9,Potential
25361,727,1,2443.35,1,1,4,6,At Risk
25362,101,2,751.34,4,2,3,9,Potential
25363,721,1,2443.35,1,1,4,6,At Risk
25364,77,2,751.34,4,2,3,9,Potential
25365,56,4,780.82,5,4,3,12,Loyal
25366,319,2,1243.84,1,2,4,7,Potential
25367,31,1,4.99,5,1,1,7,Potential
25368,300,4,1283.82,1,4,4,9,Potential
25369,145,3,156.59,3,4,3,10,Loyal
25370,284,4,1263.82,2,4,4,10,Loyal
25371,715,1,2181.5625,1,1,4,6,At Risk
25372,301,1,32.6,1,1,1,3,At Risk
25373,128,3,71.58000000000001,4,4,2,10,Loyal
25374,214,3,71.58000000000001,2,4,2,8,Potential
25375,7,1,32.6,5,1,1,7,Recent Customer
25376,53,1,32.6,5,1,1,7,Potential
25377,73,1,32.6,5,1,1,7,Potential
25378,342,3,38.88,1,4,1,6,At Risk
25379,275,1,1214.85,2,1,4,7,Potential
25380,287,2,1249.84,2,2,4,8,Potential
25381,292,3,1228.83,1,4,4,9,Potential
25382,305,4,1283.82,1,4,4,9,Potential
25383,294,3,1228.83,1,4,4,9,Potential
25384,305,2,1249.84,1,2,4,7,Potential
25385,302,2,1249.84,1,2,4,7,Potential
25386,260,2,1249.84,2,2,4,8,Potential
25387,259,2,1249.84,2,2,4,8,Potential
25388,252,2,1249.84,2,2,4,8,Potential
25389,258,3,1303.83,2,4,4,10,Loyal
25390,269,3,1274.33,2,4,4,10,Loyal
25391,245,4,1256.78,2,4,4,10,Loyal
25392,233,2,1249.84,2,2,4,8,Potential
25393,705,1,2443.35,1,1,4,6,At Risk
25394,243,2,1249.84,2,2,4,8,Potential
25395,240,2,1223.84,2,2,4,8,Potential
25396,215,3,2398.0499999999997,2,4,4,10,Loyal
25397,219,4,2427.04,2,4,4,10,Loyal
25398,239,2,2419.06,2,2,4,8,Potential
25399,239,2,2393.06,2,2,4,8,Potential
25400,226,3,2469.05,2,4,4,10,Loyal
25401,221,2,2393.06,2,2,4,8,Potential
25402,229,2,1249.84,2,2,4,8,Potential
25403,241,4,1283.82,2,4,4,10,Loyal
25404,242,4,2433.04,2,4,4,10,Loyal
25405,227,4,2433.04,2,4,4,10,Loyal
25406,238,4,2433.04,2,4,4,10,Loyal
25407,234,3,2398.0499999999997,2,4,4,10,Loyal
25408,246,4,2735.5325,2,4,4,10,Loyal
25409,225,1,2384.07,2,1,4,7,Potential
25410,234,1,2384.07,2,1,4,7,Potential
25411,234,1,1214.85,2,1,4,7,Potential
25412,221,2,1223.84,2,2,4,8,Potential
25413,217,3,1228.83,2,4,4,10,Loyal
25414,237,4,2453.04,2,4,4,10,Loyal
25415,232,4,2433.04,2,4,4,10,Loyal
25416,194,4,40.22,3,4,2,9,Potential
25417,217,5,1308.31,2,5,4,11,Loyal
25418,243,2,1223.84,2,2,4,8,Potential
25419,219,2,1249.84,2,2,4,8,Potential
25420,193,2,1268.84,3,2,4,9,Potential
25421,198,2,1249.84,3,2,4,9,Potential
25422,221,3,71.58000000000001,2,4,2,8,Potential
25423,238,4,2478.04,2,4,4,10,Loyal
25424,92,3,71.58000000000001,4,4,2,10,Loyal
25425,234,2,2438.06,2,2,4,8,Potential
25426,233,2,2419.06,2,2,4,8,Potential
25427,235,2,2393.06,2,2,4,8,Potential
25428,236,2,36.59,2,2,1,5,At Risk
25429,224,2,2393.06,2,2,4,8,Potential
25430,215,2,2419.06,2,2,4,8,Potential
25431,87,3,71.58000000000001,4,4,2,10,Loyal
25432,197,2,1249.84,3,2,4,9,Potential
25433,89,1,4.99,4,1,1,6,At Risk
25434,288,3,38.88,2,4,1,7,Potential
25435,344,2,36.59,1,2,1,4,At Risk
25436,190,2,1243.84,3,2,4,9,Potential
25437,36,2,13.98,5,2,1,8,Potential
25438,105,4,95.57000000000001,4,4,3,11,Loyal
25439,362,3,71.58000000000001,1,4,2,7,Potential
25440,33,2,57.09,5,2,2,9,Potential
25441,286,3,71.58000000000001,2,4,2,8,Potential
25442,120,2,1735.98,4,2,4,10,Loyal
25443,223,2,1750.98,2,2,4,8,Potential
25444,210,2,1754.98,2,2,4,8,Potential
25445,212,2,1735.98,2,2,4,8,Potential
25446,67,4,1151.76,5,4,3,12,Loyal
25447,91,3,1164.47,4,4,4,12,Loyal
25448,71,2,1174.48,5,2,4,11,Loyal
25449,92,4,608.96,4,4,3,11,Loyal
25450,75,4,567.76,4,4,3,11,Loyal
25451,64,2,574.98,5,2,3,10,Loyal
25452,75,1,2384.07,4,1,4,9,Potential
25453,100,2,1170.48,4,2,4,10,Loyal
25454,113,2,1155.48,4,2,3,9,Potential
25455,77,3,565.47,4,4,3,11,Loyal
25456,18,1,4.99,5,1,1,7,Recent Customer
25457,50,4,2420.34,5,4,4,13,Champions
25458,39,2,2413.06,5,2,4,11,Loyal
25459,73,3,553.97,5,4,3,12,Loyal
25460,75,3,553.97,4,4,3,11,Loyal
25461,100,3,1775.97,4,4,4,12,Loyal
25462,204,4,1764.96,3,4,4,11,Loyal
25463,34,1,2384.07,5,1,4,10,Loyal
25464,41,4,2453.04,5,4,4,13,Champions
25465,75,2,1155.48,4,2,3,9,Potential
25466,230,1,4.99,2,1,1,4,At Risk
25467,85,4,1151.76,4,4,3,11,Loyal
25468,71,2,548.98,5,2,3,10,Loyal
25469,284,2,39.980000000000004,2,2,1,5,At Risk
25470,266,2,162.99,2,2,3,7,Potential
25471,72,2,39.980000000000004,5,2,1,8,Potential
25472,177,3,27.77,3,4,1,8,Potential
25473,248,1,4.99,2,1,1,4,At Risk
25474,188,2,38.980000000000004,3,2,1,6,At Risk
25475,50,2,39.980000000000004,5,2,1,8,Potential
25476,300,1,4.99,1,1,1,3,At Risk
25477,222,1,3.99,2,1,1,4,At Risk
25478,122,2,1735.98,4,2,4,10,Loyal
25479,104,5,1799.95,4,5,4,13,Champions
25480,72,1,1120.49,5,1,3,9,Potential
25481,205,2,2478.3399999999997,3,2,4,9,Potential
25482,95,2,162.99,4,2,3,9,Potential
25483,17,2,7.28,5,2,1,8,Recent Customer
25484,55,3,2469.05,5,4,4,13,Champions
25485,322,2,1223.84,1,2,4,7,Potential
25486,79,2,548.98,4,2,3,9,Potential
25487,145,3,31.729999999999997,3,4,1,8,Potential
25488,84,1,1120.49,4,1,3,8,Potential
25489,34,3,1147.77,5,4,3,12,Loyal
25490,191,2,7.28,3,2,1,6,At Risk
25491,195,2,7.28,3,2,1,6,At Risk
25492,190,4,1764.96,3,4,4,11,Loyal
25493,48,6,1243.44,5,5,4,14,Champions
25494,197,2,39.980000000000004,3,2,1,6,At Risk
25495,225,2,39.980000000000004,2,2,1,5,At Risk
25496,171,2,13.98,3,2,1,6,At Risk
25497,159,1,1700.99,3,1,4,8,Potential
25498,167,3,1785.97,3,4,4,11,Loyal
25499,57,2,38.980000000000004,5,2,1,8,Potential
25500,73,2,1170.48,5,2,4,11,Loyal
25501,48,2,1155.48,5,2,3,10,Loyal
25502,45,2,1174.48,5,2,4,11,Loyal
25503,206,3,48.970000000000006,3,4,2,9,Potential
25504,80,4,578.46,4,4,3,11,Loyal
25505,136,2,38.980000000000004,3,2,1,6,At Risk
25506,78,2,1155.48,4,2,3,9,Potential
25507,299,1,4.99,1,1,1,3,At Risk
25508,87,1,539.99,4,1,3,8,Potential
25509,93,1,21.49,4,1,1,6,At Risk
25510,74,5,1212.95,4,5,4,13,Champions
25511,68,3,1134.47,5,4,3,12,Loyal
25512,320,2,38.980000000000004,1,2,1,4,At Risk
25513,309,2,7.28,1,2,1,4,At Risk
25514,228,2,7.28,2,2,1,5,At Risk
25515,81,2,39.980000000000004,4,2,1,7,Potential
25516,306,1,21.49,1,1,1,3,At Risk
25517,111,2,39.980000000000004,4,2,1,7,Potential
25518,155,2,39.980000000000004,3,2,1,6,At Risk
25519,86,2,39.980000000000004,4,2,1,7,Potential
25520,224,4,114.46,2,4,3,9,Potential
25521,348,2,30.479999999999997,1,2,1,4,At Risk
25522,89,4,628.97,4,4,3,11,Loyal
25523,165,2,38.980000000000004,3,2,1,6,At Risk
25524,298,2,25.479999999999997,1,2,1,4,At Risk
25525,65,6,663.44,5,5,3,13,Champions
25526,319,3,60.47,1,4,2,7,Potential
25527,125,2,7.28,4,2,1,7,Potential
25528,78,3,565.47,4,4,3,11,Loyal
25529,339,1,21.49,1,1,1,3,At Risk
25530,167,2,23.779999999999998,3,2,1,6,At Risk
25531,87,4,1188.46,4,4,4,12,Loyal
25532,326,2,1223.84,1,2,4,7,Potential
25533,184,3,27.77,3,4,1,8,Potential
25534,168,1,4.99,3,1,1,5,At Risk
25535,149,2,39.980000000000004,3,2,1,6,At Risk
25536,15,1,21.49,5,1,1,7,Recent Customer
25537,99,2,38.980000000000004,4,2,1,7,Potential
25538,309,3,1228.83,1,4,4,9,Potential
25539,261,3,1277.83,2,4,4,10,Loyal
25540,230,2,1223.84,2,2,4,8,Potential
25541,209,1,21.49,2,1,1,4,At Risk
25542,68,2,13.98,5,2,1,8,Potential
25543,66,3,49.97,5,4,2,11,Loyal
25544,15,1,3.99,5,1,1,7,Recent Customer
25545,34,2,38.980000000000004,5,2,1,8,Potential
25546,92,3,1179.47,4,4,4,12,Loyal
25547,353,1,3.99,1,1,1,3,At Risk
25548,78,2,603.49,4,2,3,9,Potential
25549,206,2,7.28,3,2,1,6,At Risk
25550,80,2,574.98,4,2,3,9,Potential
25551,46,3,143.78,5,4,3,12,Loyal
25552,54,3,553.97,5,4,3,12,Loyal
25553,83,1,1120.49,4,1,3,8,Potential
25554,277,2,7.28,2,2,1,5,At Risk
25555,98,5,1277.5582,4,5,4,13,Champions
25556,115,4,1253.0682,4,4,4,12,Loyal
25557,97,4,1262.8682,4,4,4,12,Loyal
25558,120,5,1307.0582,4,5,4,13,Champions
25559,106,4,1253.0682,4,4,4,12,Loyal
25560,103,5,1288.0582,4,5,4,13,Champions
25561,98,5,1288.0582,4,5,4,13,Champions
25562,95,2,1239.0882000000001,4,2,4,10,Loyal
25563,116,2,1239.0882000000001,4,2,4,10,Loyal
25564,94,4,1253.0682,4,4,4,12,Loyal
25565,100,2,1239.0882000000001,4,2,4,10,Loyal
25566,105,4,1253.0682,4,4,4,12,Loyal
25567,112,2,1239.0882000000001,4,2,4,10,Loyal
25568,105,4,1253.0682,4,4,4,12,Loyal
25569,234,3,89.97,2,4,2,8,Potential
25570,28,2,29.479999999999997,5,2,1,8,Recent Customer
25571,43,4,588.96,5,4,3,12,Loyal
25572,65,4,1169.46,5,4,4,13,Champions
25573,87,2,1155.48,4,2,3,9,Potential
25574,217,3,1273.83,2,4,4,10,Loyal
25575,57,1,539.99,5,1,3,9,Potential
25576,78,2,1170.48,4,2,4,10,Loyal
25577,34,2,1155.48,5,2,3,10,Loyal
25578,47,2,1155.48,5,2,3,10,Loyal
25579,308,2,39.980000000000004,1,2,1,4,At Risk
25580,223,2,39.980000000000004,2,2,1,5,At Risk
25581,124,3,34.47,4,4,1,9,Potential
25582,54,3,1164.47,5,4,4,13,Champions
25583,47,3,583.97,5,4,3,12,Loyal
25584,48,4,1169.46,5,4,4,13,Champions
25585,34,4,1188.46,5,4,4,13,Champions
25586,216,2,1223.84,2,2,4,8,Potential
25587,36,1,539.99,5,1,3,9,Potential
25588,244,2,1223.84,2,2,4,8,Potential
25589,41,1,539.99,5,1,3,9,Potential
25590,48,3,583.97,5,4,3,12,Loyal
25591,35,2,548.98,5,2,3,10,Loyal
25592,270,2,38.980000000000004,2,2,1,5,At Risk
25593,194,2,1264.84,3,2,4,9,Potential
25594,183,1,1214.85,3,1,4,8,Potential
25595,39,3,553.97,5,4,3,12,Loyal
25596,43,1,539.99,5,1,3,9,Potential
25597,43,1,539.99,5,1,3,9,Potential
25598,56,4,1151.76,5,4,3,12,Loyal
25599,49,2,1174.48,5,2,4,11,Loyal
25600,154,2,1268.84,3,2,4,9,Potential
25601,59,3,583.97,5,4,3,12,Loyal
25602,169,3,1763.97,3,4,4,11,Loyal
25603,43,4,1169.46,5,4,4,13,Champions
25604,43,2,1174.48,5,2,4,11,Loyal
25605,381,4,600.46,1,4,3,8,Potential
25606,173,2,1249.84,3,2,4,9,Potential
25607,166,4,1253.32,3,4,4,11,Loyal
25608,372,1,539.99,1,1,3,5,At Risk
25609,394,3,565.47,1,4,3,8,Potential
25610,35,2,574.98,5,2,3,10,Loyal
25611,385,2,564.48,1,2,3,6,At Risk
25612,356,2,574.98,1,2,3,6,At Risk
25613,159,2,1249.84,3,2,4,9,Potential
25614,160,3,1228.83,3,4,4,11,Loyal
25615,347,2,574.98,1,2,3,6,At Risk
25616,353,1,539.99,1,1,3,5,At Risk
25617,161,2,1249.84,3,2,4,9,Potential
25618,393,3,2398.0499999999997,1,4,4,9,Potential
25619,152,3,1273.83,3,4,4,11,Loyal
25620,294,2,39.980000000000004,1,2,1,4,At Risk
25621,122,3,89.97,4,4,2,10,Loyal
25622,228,3,2398.0499999999997,2,4,4,10,Loyal
25623,220,3,2398.0499999999997,2,4,4,10,Loyal
25624,260,3,38.88,2,4,1,7,Potential
25625,394,4,2433.04,1,4,4,9,Potential
25626,356,2,548.98,1,2,3,6,At Risk
25627,354,3,47.97,1,4,2,7,Potential
25628,301,2,6.28,1,2,1,4,At Risk
25629,282,2,23.779999999999998,2,2,1,5,At Risk
25630,302,2,39.980000000000004,1,2,1,4,At Risk
25631,143,2,38.980000000000004,3,2,1,6,At Risk
25632,329,2,53.980000000000004,1,2,2,5,At Risk
25633,196,4,110.46000000000001,3,4,3,10,Loyal
25634,122,2,1750.98,4,2,4,10,Loyal
25635,151,2,1754.98,3,2,4,9,Potential
25636,50,2,1174.48,5,2,4,11,Loyal
25637,180,3,2510.9399999999996,3,4,4,11,Loyal
25638,305,2,39.980000000000004,1,2,1,4,At Risk
25639,104,3,1228.83,4,4,4,12,Loyal
25640,346,3,2428.05,1,4,4,9,Potential
25641,395,2,561.48,1,2,3,6,At Risk
25642,339,3,583.97,1,4,3,8,Potential
25643,245,2,39.980000000000004,2,2,1,5,At Risk
25644,120,3,18.97,4,4,1,9,Potential
25645,355,1,21.49,1,1,1,3,At Risk
25646,346,1,539.99,1,1,3,5,At Risk
25647,311,3,563.77,1,4,3,8,Potential
25648,215,1,4.99,2,1,1,4,At Risk
25649,64,2,1264.84,5,2,4,11,Loyal
25650,128,3,60.47,4,4,2,10,Loyal
25651,131,3,1785.97,4,4,4,12,Loyal
25652,149,2,39.980000000000004,3,2,1,6,At Risk
25653,260,2,30.479999999999997,2,2,1,5,At Risk
25654,12,2,39.980000000000004,5,2,1,8,Recent Customer
25655,314,4,571.72,1,4,3,8,Potential
25656,287,1,539.99,2,1,3,6,At Risk
25657,283,5,609.45,2,5,3,10,Loyal
25658,153,2,1735.98,3,2,4,9,Potential
25659,287,4,567.76,2,4,3,9,Potential
25660,72,2,1735.98,5,2,4,11,Loyal
25661,80,2,1735.98,4,2,4,10,Loyal
25662,136,3,94.97,3,4,3,10,Loyal
25663,169,3,94.97,3,4,3,10,Loyal
25664,102,3,27.77,4,4,1,9,Potential
25665,275,1,4.99,2,1,1,4,At Risk
25666,240,2,39.980000000000004,2,2,1,5,At Risk
25667,276,2,23.779999999999998,2,2,1,5,At Risk
25668,160,3,88.97,3,4,2,9,Potential
25669,302,2,38.980000000000004,1,2,1,4,At Risk
25670,66,3,48.970000000000006,5,4,2,11,Loyal
25671,322,2,30.479999999999997,1,2,1,4,At Risk
25672,348,2,7.28,1,2,1,4,At Risk
25673,129,2,7.28,4,2,1,7,Potential
25674,328,2,2419.06,1,2,4,7,Potential
25675,348,2,548.98,1,2,3,6,At Risk
25676,261,3,66.97,2,4,2,8,Potential
25677,222,2,59.980000000000004,2,2,2,6,At Risk
25678,10,3,60.47,5,4,2,11,Recent Customer
25679,145,2,39.980000000000004,3,2,1,6,At Risk
25680,228,3,27.77,2,4,1,7,Potential
25681,335,3,2398.0499999999997,1,4,4,9,Potential
25682,247,2,38.980000000000004,2,2,1,5,At Risk
25683,75,4,1251.12,4,4,4,12,Loyal
25684,111,2,23.779999999999998,4,2,1,7,Potential
25685,182,1,21.49,3,1,1,5,At Risk
25686,315,2,6.28,1,2,1,4,At Risk
25687,54,2,12.98,5,2,1,8,Potential
25688,153,3,68.97,3,4,2,9,Potential
25689,203,2,6.28,3,2,1,6,At Risk
25690,268,2,38.980000000000004,2,2,1,5,At Risk
25691,333,3,27.77,1,4,1,6,At Risk
25692,326,3,66.97,1,4,2,7,Potential
25693,47,4,1236.78,5,4,4,13,Champions
25694,59,2,1223.84,5,2,4,11,Loyal
25695,237,2,33.98,2,2,1,5,At Risk
25696,123,3,42.97,4,4,2,10,Loyal
25697,359,3,68.97,1,4,2,7,Potential
25698,146,3,68.97,3,4,2,9,Potential
25699,237,3,47.97,2,4,2,8,Potential
25700,46,2,1268.84,5,2,4,11,Loyal
25701,352,4,600.46,1,4,3,8,Potential
25702,306,2,2419.06,1,2,4,7,Potential
25703,337,4,607.96,1,4,3,8,Potential
25704,119,2,1239.0882000000001,4,2,4,10,Loyal
25705,64,3,1274.0782,5,4,4,13,Champions
25706,87,2,1239.0882000000001,4,2,4,10,Loyal
25707,92,5,1262.0582,4,5,4,13,Champions
25708,64,4,1253.0682,5,4,4,13,Champions
25709,69,5,1308.0582,5,5,4,14,Champions
25710,62,2,1239.0882000000001,5,2,4,11,Loyal
25711,63,3,1274.0782,5,4,4,13,Champions
25712,62,5,1262.0582,5,5,4,14,Champions
25713,82,5,1288.0582,4,5,4,13,Champions
25714,63,5,1308.0582,5,5,4,14,Champions
25715,64,3,1274.0782,5,4,4,13,Champions
25716,73,3,1302.5882000000001,5,4,4,13,Champions
25717,88,3,1274.0782,4,4,4,12,Loyal
25718,79,3,1274.0782,4,4,4,12,Loyal
25719,350,3,60.47,1,4,2,7,Potential
25720,303,4,2433.04,1,4,4,9,Potential
25721,312,3,583.97,1,4,3,8,Potential
25722,385,2,777.34,1,2,3,6,At Risk
25723,388,2,777.34,1,2,3,6,At Risk
25724,297,5,2442.0299999999997,1,5,4,10,Loyal
25725,299,2,2419.06,1,2,4,7,Potential
25726,330,6,663.44,1,5,3,9,Potential
25727,315,1,539.99,1,1,3,5,At Risk
25728,327,2,574.98,1,2,3,6,At Risk
25729,254,4,2433.04,2,4,4,10,Loyal
25730,269,3,2469.05,2,4,4,10,Loyal
25731,310,2,548.98,1,2,3,6,At Risk
25732,328,5,638.95,1,5,3,9,Potential
25733,182,4,76.96000000000001,3,4,2,9,Potential
25734,220,1,2384.07,2,1,4,7,Potential
25735,241,4,2407.04,2,4,4,10,Loyal
25736,239,4,2453.04,2,4,4,10,Loyal
25737,141,4,1764.96,3,4,4,11,Loyal
25738,219,3,2398.0499999999997,2,4,4,10,Loyal
25739,316,1,539.99,1,1,3,5,At Risk
25740,228,1,53.99,2,1,2,5,At Risk
25741,331,4,567.76,1,4,3,8,Potential
25742,184,5,2462.03,3,5,4,12,Loyal
25743,351,3,786.33,1,4,3,8,Potential
25744,186,5,2428.29,3,5,4,12,Loyal
25745,185,4,2473.04,3,4,4,11,Loyal
25746,310,2,561.48,1,2,3,6,At Risk
25747,321,1,539.99,1,1,3,5,At Risk
25748,323,1,539.99,1,1,3,5,At Risk
25749,363,1,742.35,1,1,3,5,At Risk
25750,249,3,553.97,2,4,3,9,Potential
25751,111,3,1759.97,4,4,4,12,Loyal
25752,359,3,756.33,1,4,3,8,Potential
25753,80,1,3.99,4,1,1,6,At Risk
25754,144,2,23.779999999999998,3,2,1,6,At Risk
25755,153,2,6.28,3,2,1,6,At Risk
25756,192,4,2493.54,3,4,4,11,Loyal
25757,298,4,628.97,1,4,3,8,Potential
25758,202,3,2428.05,3,4,4,11,Loyal
25759,341,1,742.35,1,1,3,5,At Risk
25760,301,4,567.76,1,4,3,8,Potential
25761,302,4,562.96,1,4,3,8,Potential
25762,147,6,2517.02,3,5,4,12,Loyal
25763,10,3,38.88,5,4,1,10,Recent Customer
25764,229,3,71.58000000000001,2,4,2,8,Potential
25765,236,2,2438.06,2,2,4,8,Potential
25766,71,1,32.6,5,1,1,7,Potential
25767,225,4,2453.04,2,4,4,10,Loyal
25768,286,3,75.47,2,4,2,8,Potential
25769,372,4,2514.93,1,4,4,9,Potential
25770,36,1,2294.99,5,1,4,10,Loyal
25771,108,2,25.479999999999997,4,2,1,7,Potential
25772,177,2,75.48,3,2,2,7,Potential
25773,160,3,60.47,3,4,2,9,Potential
25774,147,4,2537.3199999999997,3,4,4,11,Loyal
25775,127,2,2451.2999999999997,4,2,4,10,Loyal
25776,104,5,2514.6099999999997,4,5,4,13,Champions
25777,55,3,2309.9699999999993,5,4,4,13,Champions
25778,93,1,2443.35,4,1,4,9,Potential
25779,391,3,2479.94,1,4,4,9,Potential
25780,372,3,2479.94,1,4,4,9,Potential
25781,187,2,39.980000000000004,3,2,1,6,At Risk
25782,246,2,58.980000000000004,2,2,2,6,At Risk
25783,336,1,4.99,1,1,1,3,At Risk
25784,147,1,4.99,3,1,1,5,At Risk
25785,17,1,4.99,5,1,1,7,Recent Customer
25786,43,2,2329.9799999999996,5,2,4,11,Loyal
25787,205,3,27.77,3,4,1,8,Potential
25788,346,3,60.47,1,4,2,7,Potential
25789,50,2,25.479999999999997,5,2,1,8,Potential
25790,24,4,69.46000000000001,5,4,2,11,Recent Customer
25791,63,3,60.47,5,4,2,11,Loyal
25792,51,2,75.48,5,2,2,9,Potential
25793,394,3,2479.94,1,4,4,9,Potential
25794,87,2,23.779999999999998,4,2,1,7,Potential
25795,386,4,2482.23,1,4,4,9,Potential
25796,115,2,2475.95,4,2,4,10,Loyal
25797,111,1,21.49,4,1,1,6,At Risk
25798,109,2,2452.3399999999997,4,2,4,10,Loyal
25799,364,2,13.98,1,2,1,4,At Risk
25800,261,2,39.980000000000004,2,2,1,5,At Risk
25801,363,1,4.99,1,1,1,3,At Risk
25802,3,3,60.47,5,4,2,11,Recent Customer
25803,352,2,30.479999999999997,1,2,1,4,At Risk
25804,330,1,4.99,1,1,1,3,At Risk
25805,65,5,2501.31,5,5,4,14,Champions
25806,151,2,23.779999999999998,3,2,1,6,At Risk
25807,31,3,88.98,5,4,2,11,Loyal
25808,132,4,77.96000000000001,4,4,2,10,Loyal
25809,155,1,21.49,3,1,1,5,At Risk
25810,231,4,114.46000000000001,2,4,3,9,Potential
25811,365,4,86.45,1,4,2,7,Potential
25812,60,3,113.97,5,4,3,12,Loyal
25813,310,2,26.97,1,2,1,4,At Risk
25814,150,3,61.96,3,4,2,9,Potential
25815,349,2,39.980000000000004,1,2,1,4,At Risk
25816,183,2,7.28,3,2,1,6,At Risk
25817,3,2,7.28,5,2,1,8,Recent Customer
25818,281,3,35.96,2,4,1,7,Potential
25819,169,3,1873.5782,3,4,4,11,Loyal
25820,352,3,48.97,1,4,2,7,Potential
25821,158,4,1879.0682,3,4,4,11,Loyal
25822,167,2,1819.5882000000001,3,2,4,9,Potential
25823,170,5,1887.5582,3,5,4,12,Loyal
25824,119,2,39.980000000000004,4,2,1,7,Potential
25825,186,1,4.99,3,1,1,5,At Risk
25826,135,3,1854.5782,3,4,4,11,Loyal
25827,128,3,1873.5782,4,4,4,12,Loyal
25828,123,3,1873.5782,4,4,4,12,Loyal
25829,152,4,1894.0682000000002,3,4,4,11,Loyal
25830,130,4,1833.5682,4,4,4,12,Loyal
25831,138,4,1882.5682,3,4,4,11,Loyal
25832,125,5,1850.8582000000001,4,5,4,13,Champions
25833,125,2,36.59,4,2,1,7,Potential
25834,129,2,27.279999999999998,4,2,1,7,Potential
25835,347,2,27.279999999999998,1,2,1,4,At Risk
25836,112,2,34.89,4,2,1,7,Potential
25837,236,1,24.99,2,1,1,4,At Risk
25838,30,3,64.97,5,4,2,11,Recent Customer
25839,358,6,107.94,1,5,3,9,Potential
25840,199,2,1249.84,3,2,4,9,Potential
25841,155,3,64.97,3,4,2,9,Potential
25842,273,2,27.279999999999998,2,2,1,5,At Risk
25843,220,2,27.279999999999998,2,2,1,5,At Risk
25844,355,1,24.99,1,1,1,3,At Risk
25845,36,2,13.98,5,2,1,8,Potential
25846,135,3,64.97,3,4,2,9,Potential
25847,129,1,24.99,4,1,1,6,At Risk
25848,296,2,27.279999999999998,1,2,1,4,At Risk
25849,357,3,35.23,1,4,1,6,At Risk
25850,249,3,64.47,2,4,2,8,Potential
25851,56,1,24.99,5,1,1,7,Potential
25852,249,2,29.979999999999997,2,2,1,5,At Risk
25853,35,2,27.279999999999998,5,2,1,8,Potential
25854,241,2,27.279999999999998,2,2,1,5,At Risk
25855,338,4,40.22,1,4,2,7,Potential
25856,44,2,750.3000000000001,5,2,3,10,Loyal
25857,1106,1,3399.99,1,1,5,7,Potential
25858,2,3,32.269999999999996,5,4,1,10,Recent Customer
25859,229,3,64.97,2,4,2,8,Potential
25860,125,2,27.279999999999998,4,2,1,7,Potential
25861,1119,1,3399.99,1,1,5,7,Potential
25862,157,3,64.97,3,4,2,9,Potential
25863,187,5,4631.11,3,5,5,13,Champions
25864,720,1,2443.35,1,1,4,6,At Risk
25865,205,3,4643.83,3,4,5,12,Loyal
25866,176,4,4603.82,3,4,5,12,Loyal
25867,214,2,5784.0599999999995,2,2,5,9,Potential
25868,238,4,5798.04,2,4,5,11,Loyal
25869,163,3,79.97,3,4,2,9,Potential
25870,239,3,37.93,2,4,1,7,Potential
25871,145,3,64.97,3,4,2,9,Potential
25872,219,3,5819.049999999999,2,4,5,11,Loyal
25873,87,2,39.980000000000004,4,2,1,7,Potential
25874,85,2,34.89,4,2,1,7,Potential
25875,713,1,2443.35,1,1,4,6,At Risk
25876,164,5,4629.07,3,5,5,13,Champions
25877,5,3,79.97,5,4,2,11,Recent Customer
25878,165,3,4649.83,3,4,5,12,Loyal
25879,165,4,4658.82,3,4,5,12,Loyal
25880,128,3,32.269999999999996,4,4,1,9,Potential
25881,25,1,24.99,5,1,1,7,Recent Customer
25882,245,3,64.97,2,4,2,8,Potential
25883,715,1,2443.35,1,1,4,6,At Risk
25884,233,2,39.980000000000004,2,2,1,5,At Risk
25885,158,2,59.980000000000004,3,2,2,7,Potential
25886,166,5,4673.3099999999995,3,5,5,13,Champions
25887,162,5,4673.3099999999995,3,5,5,13,Champions
25888,182,4,4623.82,3,4,5,12,Loyal
25889,164,5,4651.11,3,5,5,13,Champions
25890,348,1,24.99,1,1,1,3,At Risk
25891,231,2,5759.0599999999995,2,2,5,9,Potential
25892,717,1,2443.35,1,1,4,6,At Risk
25893,278,1,24.99,2,1,1,4,At Risk
25894,187,2,49.48,3,2,2,7,Potential
25895,173,3,4649.83,3,4,5,12,Loyal
25896,218,4,121.57000000000001,2,4,3,9,Potential
25897,110,1,32.6,4,1,1,6,At Risk
25898,206,3,38.88,3,4,1,8,Potential
25899,324,3,71.58000000000001,1,4,2,7,Potential
25900,256,2,41.59,2,2,2,6,At Risk
25901,238,3,5793.049999999999,2,4,5,11,Loyal
25902,341,3,64.97,1,4,2,7,Potential
25903,238,4,5773.04,2,4,5,11,Loyal
25904,58,4,89.46000000000001,5,4,2,11,Loyal
25905,146,3,4598.83,3,4,5,12,Loyal
25906,77,2,6.28,4,2,1,7,Potential
25907,15,2,6.28,5,2,1,8,Recent Customer
25908,3,2,27.279999999999998,5,2,1,8,Recent Customer
25909,142,5,4658.8099999999995,3,5,5,13,Champions
25910,144,3,4623.83,3,4,5,12,Loyal
25911,671,1,2181.5625,1,1,4,6,At Risk
25912,216,3,63.47,2,4,2,8,Potential
25913,76,2,6.28,4,2,1,7,Potential
25914,155,3,37.93,3,4,1,8,Potential
25915,94,3,42.97,4,4,2,10,Loyal
25916,135,3,4649.83,3,4,5,12,Loyal
25917,133,4,4699.82,4,4,5,13,Champions
25918,85,3,1260.5782,4,4,4,12,Loyal
25919,62,3,1248.0782,5,4,4,13,Champions
25920,180,2,1819.5882000000001,3,2,4,9,Potential
25921,90,4,1253.0682,4,4,4,12,Loyal
25922,77,3,1274.0782,4,4,4,12,Loyal
25923,361,2,6.28,1,2,1,4,At Risk
25924,189,3,5819.049999999999,3,4,5,12,Loyal
25925,275,2,13.98,2,2,1,5,At Risk
25926,73,5,1308.0582,5,5,4,14,Champions
25927,75,5,1272.5182,4,5,4,13,Champions
25928,86,6,1316.0482,4,5,4,13,Champions
25929,294,2,27.279999999999998,1,2,1,4,At Risk
25930,238,2,29.979999999999997,2,2,1,5,At Risk
25931,189,2,27.279999999999998,3,2,1,6,At Risk
25932,8,2,49.48,5,2,2,9,Recent Customer
25933,154,2,49.48,3,2,2,7,Potential
25934,30,3,64.97,5,4,2,11,Recent Customer
25935,62,4,1256.0282000000002,5,4,4,13,Champions
25936,64,3,1248.0782,5,4,4,13,Champions
25937,84,5,1299.5582,4,5,4,13,Champions
25938,88,5,1308.0582,4,5,4,13,Champions
25939,83,4,1264.5682000000002,4,4,4,12,Loyal
25940,68,5,1277.5582,5,5,4,14,Champions
25941,65,5,1255.3582,5,5,4,14,Champions
25942,132,3,4598.83,4,4,5,13,Champions
25943,201,5,5808.03,3,5,5,13,Champions
25944,85,3,1274.0782,4,4,4,12,Loyal
25945,88,3,1248.0782,4,4,4,12,Loyal
25946,177,3,1873.5782,3,4,4,11,Loyal
25947,166,3,1854.5782,3,4,4,11,Loyal
25948,168,2,1819.5882000000001,3,2,4,9,Potential
25949,128,4,1882.5682,4,4,4,12,Loyal
25950,42,4,54.25,5,4,2,11,Loyal
25951,124,5,4703.3099999999995,4,5,5,14,Champions
25952,141,3,4598.83,3,4,5,12,Loyal
25953,307,2,59.980000000000004,1,2,2,5,At Risk
25954,247,2,27.279999999999998,2,2,1,5,At Risk
25955,145,3,4643.83,3,4,5,12,Loyal
25956,186,1,24.99,3,1,1,5,At Risk
25957,229,4,89.46000000000001,2,4,2,8,Potential
25958,150,2,1903.48,3,2,4,9,Potential
25959,296,2,27.279999999999998,1,2,1,4,At Risk
25960,125,3,1957.47,4,4,4,12,Loyal
25961,141,3,1938.47,3,4,4,11,Loyal
25962,206,3,5819.049999999999,3,4,5,12,Loyal
25963,26,1,24.99,5,1,1,7,Recent Customer
25964,134,3,4649.83,3,4,5,12,Loyal
25965,260,3,32.269999999999996,2,4,1,7,Potential
25966,206,2,27.279999999999998,3,2,1,6,At Risk
25967,212,2,29.979999999999997,2,2,1,5,At Risk
25968,72,1,24.99,5,1,1,7,Potential
25969,106,3,4649.83,4,4,5,13,Champions
25970,97,4,4603.82,4,4,5,13,Champions
25971,258,5,2749.3225,2,5,4,11,Loyal
25972,192,5,5780.99,3,5,5,13,Champions
25973,204,3,5793.049999999999,3,4,5,12,Loyal
25974,193,3,5819.049999999999,3,4,5,12,Loyal
25975,197,5,5807.03,3,5,5,13,Champions
25976,189,2,5759.0599999999995,3,2,5,10,Loyal
25977,117,3,4624.83,4,4,5,13,Champions
25978,192,3,5813.049999999999,3,4,5,12,Loyal
25979,201,2,5784.0599999999995,3,2,5,10,Loyal
25980,204,3,5819.049999999999,3,4,5,12,Loyal
25981,229,3,3018.33,2,4,4,10,Loyal
25982,194,3,5819.049999999999,3,4,5,12,Loyal
25983,171,2,29.979999999999997,3,2,1,6,At Risk
25984,121,3,4624.83,4,4,5,13,Champions
25985,97,5,4658.8099999999995,4,5,5,14,Champions
25986,117,3,4624.83,4,4,5,13,Champions
25987,97,3,4639.83,4,4,5,13,Champions
25988,160,3,64.97,3,4,2,9,Potential
25989,243,5,2744.5225,2,5,4,11,Loyal
25990,202,4,5847.039999999999,3,4,5,12,Loyal
25991,236,6,2845.5225,2,5,4,11,Loyal
25992,231,2,2721.5525,2,2,4,8,Potential
25993,118,5,4648.3099999999995,4,5,5,14,Champions
25994,115,5,4626.11,4,5,5,14,Champions
25995,582,1,2443.35,1,1,4,6,At Risk
25996,93,3,4598.83,4,4,5,13,Champions
25997,95,3,4623.83,4,4,5,13,Champions
25998,88,3,4649.83,4,4,5,13,Champions
25999,583,1,2181.5625,1,1,4,6,At Risk
26000,242,3,32.269999999999996,2,4,1,7,Potential
26001,83,5,4673.3099999999995,4,5,5,14,Champions
26002,87,5,4699.3099999999995,4,5,5,14,Champions
26003,86,5,4648.3099999999995,4,5,5,14,Champions
26004,87,5,4698.8099999999995,4,5,5,14,Champions
26005,62,3,4623.83,5,4,5,14,Champions
26006,65,1,24.99,5,1,1,7,Potential
26007,236,1,24.99,2,1,1,4,At Risk
26008,9,2,49.48,5,2,2,9,Recent Customer
26009,32,4,40.22,5,4,2,11,Loyal
26010,333,1,24.99,1,1,1,3,At Risk
26011,184,3,5768.049999999999,3,4,5,12,Loyal
26012,208,3,5794.049999999999,2,4,5,11,Loyal
26013,561,1,2443.35,1,1,4,6,At Risk
26014,78,4,4713.33,4,4,5,13,Champions
26015,92,2,4614.84,4,2,5,11,Loyal
26016,79,6,4683.299999999999,4,5,5,14,Champions
26017,360,4,89.46000000000001,1,4,2,7,Potential
26018,207,4,5869.039999999999,2,4,5,11,Loyal
26019,144,3,1957.47,3,4,4,11,Loyal
26020,105,4,1932.46,4,4,4,12,Loyal
26021,101,4,1917.46,4,4,4,12,Loyal
26022,119,3,1938.47,4,4,4,12,Loyal
26023,125,4,1917.46,4,4,4,12,Loyal
26024,115,5,1952.45,4,5,4,13,Champions
26025,99,4,1917.46,4,4,4,12,Loyal
26026,328,1,4.99,1,1,1,3,At Risk
26027,93,3,1938.47,4,4,4,12,Loyal
26028,98,3,1938.47,4,4,4,12,Loyal
26029,100,4,1930.76,4,4,4,12,Loyal
26030,228,1,21.49,2,1,1,4,At Risk
26031,4,2,23.779999999999998,5,2,1,8,Recent Customer
26032,358,2,7.28,1,2,1,4,At Risk
26033,121,2,1903.48,4,2,4,10,Loyal
26034,154,1,21.49,3,1,1,5,At Risk
26035,194,3,88.98,3,4,2,9,Potential
26036,86,3,88.98,4,4,2,10,Loyal
26037,342,2,38.980000000000004,1,2,1,4,At Risk
26038,153,5,2503.0299999999997,3,5,4,12,Loyal
26039,85,2,27.279999999999998,4,2,1,7,Potential
26040,205,3,3018.33,3,4,4,11,Loyal
26041,195,6,5860.98,3,5,5,13,Champions
26042,184,2,5759.0599999999995,3,2,5,10,Loyal
26043,92,4,191.27,4,4,3,11,Loyal
26044,284,4,86.95,2,4,2,8,Potential
26045,122,2,27.279999999999998,4,2,1,7,Potential
26046,117,3,93.48,4,4,3,11,Loyal
26047,254,3,64.97,2,4,2,8,Potential
26048,188,4,191.27,3,4,3,10,Loyal
26049,576,1,2181.5625,1,1,4,6,At Risk
26050,73,3,4624.83,5,4,5,14,Champions
26051,35,1,4.99,5,1,1,7,Potential
26052,255,1,24.99,2,1,1,4,At Risk
26053,316,2,27.279999999999998,1,2,1,4,At Risk
26054,304,1,24.99,1,1,1,3,At Risk
26055,205,2,5784.0599999999995,3,2,5,10,Loyal
26056,203,3,5838.049999999999,3,4,5,12,Loyal
26057,190,7,5927.51,3,5,5,13,Champions
26058,198,3,5838.049999999999,3,4,5,12,Loyal
26059,260,4,118.96000000000001,2,4,3,9,Potential
26060,202,3,5794.049999999999,3,4,5,12,Loyal
26061,204,3,5838.049999999999,3,4,5,12,Loyal
26062,256,2,49.48,2,2,2,6,At Risk
26063,92,2,29.979999999999997,4,2,1,7,Potential
26064,215,2,49.48,2,2,2,6,At Risk
26065,104,2,49.48,4,2,2,8,Potential
26066,195,6,5832.0199999999995,3,5,5,13,Champions
26067,72,3,64.97,5,4,2,11,Loyal
26068,86,1,24.99,4,1,1,6,At Risk
26069,330,3,51.46,1,4,2,7,Potential
26070,186,3,5768.049999999999,3,4,5,12,Loyal
26071,282,4,89.46000000000001,2,4,2,8,Potential
26072,52,1,24.99,5,1,1,7,Potential
26073,63,2,59.980000000000004,5,2,2,9,Potential
26074,157,2,7.28,3,2,1,6,At Risk
26075,204,3,5768.049999999999,3,4,5,12,Loyal
26076,222,3,76.96000000000001,2,4,2,8,Potential
26077,66,2,7.28,5,2,1,8,Potential
26078,339,3,64.97,1,4,2,7,Potential
26079,199,3,64.97,3,4,2,9,Potential
26080,234,1,24.99,2,1,1,4,At Risk
26081,323,3,64.97,1,4,2,7,Potential
26082,166,3,5768.049999999999,3,4,5,12,Loyal
26083,155,3,5794.049999999999,3,4,5,12,Loyal
26084,168,3,5768.049999999999,3,4,5,12,Loyal
26085,226,3,64.47,2,4,2,8,Potential
26086,100,3,149.98,4,4,3,11,Loyal
26087,110,3,64.97,4,4,2,10,Loyal
26088,138,2,49.48,3,2,2,7,Potential
26089,161,4,5798.04,3,4,5,12,Loyal
26090,159,3,5819.049999999999,3,4,5,12,Loyal
26091,182,5,5828.03,3,5,5,13,Champions
26092,45,3,64.97,5,4,2,11,Loyal
26093,70,5,4657.8099999999995,5,5,5,15,Champions
26094,88,5,4648.3099999999995,4,5,5,14,Champions
26095,170,3,15.23,3,4,1,8,Potential
26096,168,4,5843.539999999999,3,4,5,12,Loyal
26097,160,4,5773.04,3,4,5,12,Loyal
26098,172,3,5793.049999999999,3,4,5,12,Loyal
26099,258,2,39.980000000000004,2,2,1,5,At Risk
26100,14,2,7.28,5,2,1,8,Recent Customer
26101,205,1,24.99,3,1,1,5,At Risk
26102,304,3,147.28,1,4,3,8,Potential
26103,22,3,32.269999999999996,5,4,1,10,Recent Customer
26104,161,4,114.96000000000001,3,4,3,10,Loyal
26105,231,4,40.22,2,4,2,8,Potential
26106,179,3,5768.049999999999,3,4,5,12,Loyal
26107,162,5,5800.33,3,5,5,13,Champions
26108,24,3,32.269999999999996,5,4,1,10,Recent Customer
26109,99,3,64.97,4,4,2,10,Loyal
26110,173,2,5759.0599999999995,3,2,5,10,Loyal
26111,160,3,5794.049999999999,3,4,5,12,Loyal
26112,170,3,5794.049999999999,3,4,5,12,Loyal
26113,193,3,2730.5424999999996,3,4,4,11,Loyal
26114,176,5,5853.03,3,5,5,13,Champions
26115,196,6,3052.7999999999997,3,5,4,12,Loyal
26116,156,3,5794.049999999999,3,4,5,12,Loyal
26117,251,3,32.269999999999996,2,4,1,7,Potential
26118,225,3,35.23,2,4,1,7,Potential
26119,45,3,64.97,5,4,2,11,Loyal
26120,62,5,3335.2396,5,5,5,15,Champions
26121,68,4,3300.2496,5,4,5,14,Champions
26122,41,3,64.97,5,4,2,11,Loyal
26123,353,3,64.97,1,4,2,7,Potential
26124,232,3,64.97,2,4,2,8,Potential
26125,240,2,29.979999999999997,2,2,1,5,At Risk
26126,49,1,28.99,5,1,1,7,Potential
26127,754,1,2049.0982,1,1,4,6,At Risk
26128,206,3,68.97,3,4,2,9,Potential
26129,44,1,21.49,5,1,1,7,Potential
26130,312,1,21.49,1,1,1,3,At Risk
26131,142,5,1952.45,3,5,4,12,Loyal
26132,363,2,39.980000000000004,1,2,1,4,At Risk
26133,101,3,1938.47,4,4,4,12,Loyal
26134,105,5,1926.45,4,5,4,13,Champions
26135,122,5,1967.45,4,5,4,13,Champions
26136,172,2,39.980000000000004,3,2,1,6,At Risk
26137,145,1,69.99,3,1,2,6,At Risk
26138,98,3,1957.47,4,4,4,12,Loyal
26139,333,3,34.47,1,4,1,6,At Risk
26140,103,4,1917.46,4,4,4,12,Loyal
26141,356,2,78.97999999999999,1,2,2,5,At Risk
26142,139,5,1952.45,3,5,4,12,Loyal
26143,209,2,123.97999999999999,2,2,3,7,Potential
26144,269,3,27.77,2,4,1,7,Potential
26145,206,2,78.97999999999999,3,2,2,7,Potential
26146,48,1,69.99,5,1,2,8,Potential
26147,38,2,78.97999999999999,5,2,2,9,Potential
26148,79,4,1917.46,4,4,4,12,Loyal
26149,117,2,78.97999999999999,4,2,2,8,Potential
26150,62,4,1992.46,5,4,4,13,Champions
26151,218,1,69.99,2,1,2,5,At Risk
26152,83,3,1938.47,4,4,4,12,Loyal
26153,150,3,1957.47,3,4,4,11,Loyal
26154,130,3,1938.47,4,4,4,12,Loyal
26155,126,3,128.97,4,4,3,11,Loyal
26156,165,2,78.97999999999999,3,2,2,7,Potential
26157,124,1,69.99,4,1,2,7,Potential
26158,272,2,94.47999999999999,2,2,3,7,Potential
26159,137,1,69.99,3,1,2,6,At Risk
26160,70,3,1938.47,5,4,4,13,Champions
26161,147,2,1903.48,3,2,4,9,Potential
26162,153,2,1903.48,3,2,4,9,Potential
26163,311,2,123.97999999999999,1,2,3,6,At Risk
26164,208,1,69.99,2,1,2,5,At Risk
26165,90,3,1957.47,4,4,4,12,Loyal
26166,36,3,128.97,5,4,3,12,Loyal
26167,153,2,1903.48,3,2,4,9,Potential
26168,72,2,31.279999999999998,5,2,1,8,Potential
26169,71,3,36.269999999999996,5,4,1,10,Loyal
26170,24,1,28.99,5,1,1,7,Recent Customer
26171,238,2,27.279999999999998,2,2,1,5,At Risk
26172,5,2,27.279999999999998,5,2,1,8,Recent Customer
26173,274,1,4.99,2,1,1,4,At Risk
26174,752,1,2071.4196,1,1,4,6,At Risk
26175,318,3,88.97,1,4,2,7,Potential
26176,119,1,4.99,4,1,1,6,At Risk
26177,144,2,29.479999999999997,3,2,1,6,At Risk
26178,109,4,101.95,4,4,3,11,Loyal
26179,309,2,38.980000000000004,1,2,1,4,At Risk
26180,137,1,4.99,3,1,1,5,At Risk
26181,293,3,32.269999999999996,1,4,1,6,At Risk
26182,90,2,6.28,4,2,1,7,Potential
26183,736,1,2071.4196,1,1,4,6,At Risk
26184,297,3,36.269999999999996,1,4,1,6,At Risk
26185,241,3,67.97,2,4,2,8,Potential
26186,70,2,38.980000000000004,5,2,1,8,Potential
26187,131,4,1932.46,4,4,4,12,Loyal
26188,132,3,1938.47,4,4,4,12,Loyal
26189,120,5,1926.45,4,5,4,13,Champions
26190,106,4,1932.46,4,4,4,12,Loyal
26191,107,3,1938.47,4,4,4,12,Loyal
26192,99,2,1903.48,4,2,4,10,Loyal
26193,27,3,35.23,5,4,1,10,Recent Customer
26194,54,5,66.94,5,5,2,12,Loyal
26195,361,2,27.279999999999998,1,2,1,4,At Risk
26196,160,2,29.979999999999997,3,2,1,6,At Risk
26197,19,3,64.97,5,4,2,11,Recent Customer
26198,149,2,27.279999999999998,3,2,1,6,At Risk
26199,363,1,24.99,1,1,1,3,At Risk
26200,209,3,2756.5425,2,4,4,10,Loyal
26201,175,5,4498.4596,3,5,5,13,Champions
26202,204,5,2749.3225,3,5,4,12,Loyal
26203,100,3,188.98,4,4,3,11,Loyal
26204,71,5,1967.45,5,5,4,14,Champions
26205,61,2,2451.2999999999997,5,2,4,11,Loyal
26206,37,2,2478.3399999999997,5,2,4,11,Loyal
26207,37,1,2443.35,5,1,4,10,Loyal
26208,218,3,48.970000000000006,2,4,2,8,Potential
26209,142,1,2384.07,3,1,4,8,Potential
26210,302,3,553.97,1,4,3,8,Potential
26211,294,3,565.47,1,4,3,8,Potential
26212,116,2,23.779999999999998,4,2,1,7,Potential
26213,77,2,62.980000000000004,4,2,2,8,Potential
26214,246,3,553.97,2,4,3,9,Potential
26215,34,2,13.98,5,2,1,8,Potential
26216,198,3,92.97,3,4,3,10,Loyal
26217,65,2,38.980000000000004,5,2,1,8,Potential
26218,292,2,6.28,1,2,1,4,At Risk
26219,257,3,570.47,2,4,3,9,Potential
26220,253,1,539.99,2,1,3,6,At Risk
26221,143,2,2419.06,3,2,4,9,Potential
26222,305,2,561.48,1,2,3,6,At Risk
26223,126,4,2407.04,4,4,4,12,Loyal
26224,331,2,777.34,1,2,3,6,At Risk
26225,333,1,742.35,1,1,3,5,At Risk
26226,204,1,4.99,3,1,1,5,At Risk
26227,93,2,1709.98,4,2,4,10,Loyal
26228,107,1,1700.99,4,1,4,9,Potential
26229,95,2,2419.06,4,2,4,10,Loyal
26230,112,3,2398.0499999999997,4,4,4,12,Loyal
26231,75,4,1764.96,4,4,4,12,Loyal
26232,281,1,4.99,2,1,1,4,At Risk
26233,359,3,48.970000000000006,1,4,2,7,Potential
26234,85,3,3292.9381999999996,4,4,5,13,Champions
26235,476,1,2181.5625,1,1,4,6,At Risk
26236,13,2,59.980000000000004,5,2,2,9,Recent Customer
26237,341,2,27.279999999999998,1,2,1,4,At Risk
26238,82,3,3298.9381999999996,4,4,5,13,Champions
26239,81,3,51.96,4,4,2,10,Loyal
26240,277,2,29.979999999999997,2,2,1,5,At Risk
26241,84,4,3320.2496,4,4,5,13,Champions
26242,283,3,67.93,2,4,2,8,Potential
26243,53,2,27.279999999999998,5,2,1,8,Potential
26244,153,2,49.48,3,2,2,7,Potential
26245,172,3,4490.479600000001,3,4,5,12,Loyal
26246,117,2,27.279999999999998,4,2,1,7,Potential
26247,163,3,4468.1582,3,4,5,12,Loyal
26248,207,3,68.97,2,4,2,8,Potential
26249,751,1,2071.4196,1,1,4,6,At Risk
26250,349,4,156.27,1,4,3,8,Potential
26251,48,3,68.97,5,4,2,11,Loyal
26252,70,5,3300.2182,5,5,5,15,Champions
26253,232,2,33.98,2,2,1,5,At Risk
26254,199,2,33.98,3,2,1,6,At Risk
26255,116,3,36.269999999999996,4,4,1,9,Potential
26256,112,4,93.46,4,4,3,11,Loyal
26257,148,5,82.95,3,5,2,10,Loyal
26258,115,3,36.269999999999996,4,4,1,9,Potential
26259,303,3,68.97,1,4,2,7,Potential
26260,254,4,93.46,2,4,3,9,Potential
26261,284,4,195.27,2,4,3,9,Potential
26262,226,3,68.97,2,4,2,8,Potential
26263,319,1,28.99,1,1,1,3,At Risk
26264,314,2,31.279999999999998,1,2,1,4,At Risk
26265,89,3,36.269999999999996,4,4,1,9,Potential
26266,251,4,93.46,2,4,3,9,Potential
26267,101,1,21.49,4,1,1,6,At Risk
26268,270,3,60.47,2,4,2,8,Potential
26269,159,2,13.98,3,2,1,6,At Risk
26270,188,1,4.99,3,1,1,5,At Risk
26271,191,2,23.779999999999998,3,2,1,6,At Risk
26272,357,3,60.47,1,4,2,7,Potential
26273,213,3,60.47,2,4,2,8,Potential
26274,250,1,21.49,2,1,1,4,At Risk
26275,203,2,27.279999999999998,3,2,1,6,At Risk
26276,72,5,3361.9181999999996,5,5,5,15,Champions
26277,60,3,3321.2596000000003,5,4,5,14,Champions
26278,360,2,29.979999999999997,1,2,1,4,At Risk
26279,431,1,2181.5625,1,1,4,6,At Risk
26280,41,3,3298.9381999999996,5,4,5,14,Champions
26281,45,5,3335.2396,5,5,5,15,Champions
26282,41,5,123.95000000000002,5,5,3,13,Champions
26283,43,4,3371.2496,5,4,5,14,Champions
26284,116,2,27.279999999999998,4,2,1,7,Potential
26285,52,5,3309.2396,5,5,5,15,Champions
26286,43,6,3308.1681999999996,5,5,5,15,Champions
26287,258,3,35.23,2,4,1,7,Potential
26288,16,2,27.279999999999998,5,2,1,8,Recent Customer
26289,218,2,29.979999999999997,2,2,1,5,At Risk
26290,46,3,3295.2596,5,4,5,14,Champions
26291,324,3,35.23,1,4,1,6,At Risk
26292,177,5,4456.138199999999,3,5,5,13,Champions
26293,156,5,4455.098199999999,3,5,5,13,Champions
26294,455,1,2443.35,1,1,4,6,At Risk
26295,57,3,3298.9381999999996,5,4,5,14,Champions
26296,36,5,3355.2396,5,5,5,15,Champions
26297,39,5,3286.9181999999996,5,5,5,15,Champions
26298,53,3,3340.2596000000003,5,4,5,14,Champions
26299,48,8,3396.8881999999994,5,5,5,15,Champions
26300,56,3,3298.9381999999996,5,4,5,14,Champions
26301,168,3,4484.479600000001,3,4,5,12,Loyal
26302,45,6,3357.4082,5,5,5,15,Champions
26303,32,3,3321.2596000000003,5,4,5,14,Champions
26304,41,2,3263.9482,5,2,4,11,Loyal
26305,44,3,3272.9381999999996,5,4,5,14,Champions
26306,368,3,2800.4381999999996,1,4,4,9,Potential
26307,382,3,2848.7596000000003,1,4,4,9,Potential
26308,371,3,2867.7596000000003,1,4,4,9,Potential
26309,374,3,2800.4382,1,4,4,9,Potential
26310,457,1,2181.5625,1,1,4,6,At Risk
26311,378,3,2822.7596,1,4,4,9,Potential
26312,388,5,2881.7396000000003,1,5,4,10,Loyal
26313,165,3,4487.1582,3,4,5,12,Loyal
26314,259,3,88.98,2,4,2,8,Potential
26315,342,4,2825.4282,1,4,4,9,Potential
26316,713,1,1000.4375,1,1,3,5,At Risk
26317,349,5,2862.7396000000003,1,5,4,10,Loyal
26318,166,2,13.98,3,2,1,6,At Risk
26319,161,5,4456.138199999999,3,5,5,13,Champions
26320,155,3,4464.479600000001,3,4,5,12,Loyal
26321,207,4,1554.4075,2,4,4,10,Loyal
26322,336,4,2912.2596000000003,1,4,4,9,Potential
26323,74,2,27.279999999999998,4,2,1,7,Potential
26324,163,3,4464.479600000001,3,4,5,12,Loyal
26325,158,5,4478.4596,3,5,5,13,Champions
26326,154,3,4442.1582,3,4,5,12,Loyal
26327,168,2,4433.1682,3,2,5,10,Loyal
26328,177,4,4518.1482,3,4,5,12,Loyal
26329,319,5,2860.4181999999996,1,5,4,10,Loyal
26330,328,3,2821.7196,1,4,4,9,Potential
26331,296,3,2800.4381999999996,1,4,4,9,Potential
26332,166,2,49.48,3,2,2,7,Potential
26333,268,3,32.269999999999996,2,4,1,7,Potential
26334,123,2,27.279999999999998,4,2,1,7,Potential
26335,292,4,89.46000000000001,1,4,2,7,Potential
26336,12,2,27.279999999999998,5,2,1,8,Recent Customer
26337,279,2,29.979999999999997,2,2,1,5,At Risk
26338,154,3,4468.1582,3,4,5,12,Loyal
26339,179,2,4455.489600000001,3,2,5,10,Loyal
26340,341,3,64.97,1,4,2,7,Potential
26341,230,1,24.99,2,1,1,4,At Risk
26342,178,4,4489.4696,3,4,5,12,Loyal
26343,284,3,2800.4381999999996,2,4,4,10,Loyal
26344,290,2,2791.4482,1,2,4,7,Potential
26345,174,2,49.48,3,2,2,7,Potential
26346,220,3,64.97,2,4,2,8,Potential
26347,99,1,24.99,4,1,1,6,At Risk
26348,355,3,89.97,1,4,2,7,Potential
26349,302,2,27.279999999999998,1,2,1,4,At Risk
26350,247,1,4.99,2,1,1,4,At Risk
26351,293,3,2800.4382,1,4,4,9,Potential
26352,120,3,1763.97,4,4,4,12,Loyal
26353,86,5,1773.95,4,5,4,13,Champions
26354,66,2,1750.98,5,2,4,11,Loyal
26355,56,2,62.980000000000004,5,2,2,9,Potential
26356,251,2,574.98,2,2,3,7,Potential
26357,276,2,777.34,2,2,3,7,Potential
26358,259,2,23.779999999999998,2,2,1,5,At Risk
26359,254,4,600.46,2,4,3,9,Potential
26360,254,1,539.99,2,1,3,6,At Risk
26361,2,2,53.980000000000004,5,2,2,9,Recent Customer
26362,105,4,2420.34,4,4,4,12,Loyal
26363,72,3,1744.97,5,4,4,13,Champions
26364,173,2,38.980000000000004,3,2,1,6,At Risk
26365,335,2,62.980000000000004,1,2,2,5,At Risk
26366,85,3,49.97,4,4,2,10,Loyal
26367,220,2,78.48,2,2,2,6,At Risk
26368,112,1,53.99,4,1,2,7,Potential
26369,3,1,53.99,5,1,2,8,Recent Customer
26370,159,2,23.779999999999998,3,2,1,6,At Risk
26371,5,2,33.98,5,2,1,8,Recent Customer
26372,261,2,548.98,2,2,3,7,Potential
26373,174,4,1565.9075,3,4,4,11,Loyal
26374,9,2,123.97999999999999,5,2,3,10,Recent Customer
26375,71,5,1971.45,5,5,4,14,Champions
26376,103,6,121.93,4,5,3,12,Loyal
26377,59,2,39.980000000000004,5,2,1,8,Potential
26378,100,3,60.47,4,4,2,10,Loyal
26379,196,4,1783.96,3,4,4,11,Loyal
26380,184,2,33.98,3,2,1,6,At Risk
26381,374,4,2520.8299999999995,1,4,4,9,Potential
26382,368,1,2443.35,1,1,4,6,At Risk
26383,178,2,33.98,3,2,1,6,At Risk
26384,136,2,33.98,3,2,1,6,At Risk
26385,65,2,23.779999999999998,5,2,1,8,Potential
26386,159,3,1775.47,3,4,4,11,Loyal
26387,72,1,4.99,5,1,1,7,Potential
26388,52,2,2354.9799999999996,5,2,4,11,Loyal
26389,277,3,36.269999999999996,2,4,1,7,Potential
26390,178,2,1725.98,3,2,4,9,Potential
26391,247,3,68.97,2,4,2,8,Potential
26392,295,3,60.47,1,4,2,7,Potential
26393,230,1,21.49,2,1,1,4,At Risk
26394,114,2,33.98,4,2,1,7,Potential
26395,352,2,25.479999999999997,1,2,1,4,At Risk
26396,13,4,118.96000000000001,5,4,3,12,Recent Customer
26397,82,2,39.980000000000004,4,2,1,7,Potential
26398,152,5,1758.95,3,5,4,12,Loyal
26399,336,4,2543.44,1,4,4,9,Potential
26400,328,3,132.98,1,4,3,8,Potential
26401,351,2,38.980000000000004,1,2,1,4,At Risk
26402,226,1,28.99,2,1,1,4,At Risk
26403,145,3,41.93,3,4,2,9,Potential
26404,38,3,1775.47,5,4,4,13,Champions
26405,139,3,36.269999999999996,3,4,1,8,Potential
26406,43,4,2334.4599999999996,5,4,4,13,Champions
26407,333,3,126.28,1,4,3,8,Potential
26408,154,2,38.980000000000004,3,2,1,6,At Risk
26409,321,2,67.49,1,2,2,5,At Risk
26410,202,1,28.99,3,1,1,5,At Risk
26411,334,2,58.980000000000004,1,2,2,5,At Risk
26412,99,5,55.91,4,5,2,11,Loyal
26413,99,3,58.47,4,4,2,10,Loyal
26414,357,3,58.47,1,4,2,7,Potential
26415,10,3,68.97,5,4,2,11,Recent Customer
26416,204,3,88.97,3,4,2,9,Potential
26417,240,2,6.28,2,2,1,5,At Risk
26418,206,3,36.269999999999996,3,4,1,8,Potential
26419,219,2,33.98,2,2,1,5,At Risk
26420,356,1,2443.35,1,1,4,6,At Risk
26421,98,3,60.47,4,4,2,10,Loyal
26422,70,5,1980.96,5,5,4,14,Champions
26423,81,4,2001.97,4,4,4,12,Loyal
26424,332,3,79.47,1,4,2,7,Potential
26425,152,1,69.99,3,1,2,6,At Risk
26426,55,1,69.99,5,1,2,8,Potential
26427,70,2,123.97999999999999,5,2,3,10,Loyal
26428,135,1,69.99,3,1,2,6,At Risk
26429,89,3,1938.47,4,4,4,12,Loyal
26430,129,1,69.99,4,1,2,7,Potential
26431,45,2,23.779999999999998,5,2,1,8,Potential
26432,278,2,123.97999999999999,2,2,3,7,Potential
26433,92,2,1903.48,4,2,4,10,Loyal
26434,222,1,69.99,2,1,2,5,At Risk
26435,66,3,1957.47,5,4,4,13,Champions
26436,79,3,1957.47,4,4,4,12,Loyal
26437,62,3,1953.47,5,4,4,13,Champions
26438,84,3,1938.47,4,4,4,12,Loyal
26439,91,3,1938.47,4,4,4,12,Loyal
26440,70,3,1957.47,5,4,4,13,Champions
26441,38,2,78.97999999999999,5,2,2,9,Potential
26442,90,5,1919.75,4,5,4,13,Champions
26443,73,3,1938.47,5,4,4,13,Champions
26444,90,5,1938.71,4,5,4,13,Champions
26445,65,3,1938.47,5,4,4,13,Champions
26446,5,2,78.97999999999999,5,2,2,9,Recent Customer
26447,34,3,1938.47,5,4,4,13,Champions
26448,156,1,21.49,3,1,1,5,At Risk
26449,308,1,4.99,1,1,1,3,At Risk
26450,106,2,30.479999999999997,4,2,1,7,Potential
26451,198,2,27.279999999999998,3,2,1,6,At Risk
26452,293,2,59.980000000000004,1,2,2,5,At Risk
26453,113,5,53.95,4,5,2,11,Loyal
26454,186,2,27.279999999999998,3,2,1,6,At Risk
26455,246,2,29.979999999999997,2,2,1,5,At Risk
26456,70,2,39.980000000000004,5,2,1,8,Potential
26457,324,4,89.46000000000001,1,4,2,7,Potential
26458,236,3,32.269999999999996,2,4,1,7,Potential
26459,156,3,64.97,3,4,2,9,Potential
26460,13,1,24.99,5,1,1,7,Recent Customer
26461,29,2,58.980000000000004,5,2,2,9,Recent Customer
26462,136,2,27.279999999999998,3,2,1,6,At Risk
26463,125,2,27.279999999999998,4,2,1,7,Potential
26464,93,2,59.980000000000004,4,2,2,8,Potential
26465,321,2,27.279999999999998,1,2,1,4,At Risk
26466,240,1,24.99,2,1,1,4,At Risk
26467,59,3,32.269999999999996,5,4,1,10,Loyal
26468,355,2,27.279999999999998,1,2,1,4,At Risk
26469,330,3,64.97,1,4,2,7,Potential
26470,320,3,35.23,1,4,1,6,At Risk
26471,154,1,24.99,3,1,1,5,At Risk
26472,315,4,114.96000000000001,1,4,3,8,Potential
26473,177,4,89.46000000000001,3,4,2,9,Potential
26474,188,2,13.98,3,2,1,6,At Risk
26475,226,2,30.479999999999997,2,2,1,5,At Risk
26476,175,2,30.479999999999997,3,2,1,6,At Risk
26477,113,2,49.48,4,2,2,8,Potential
26478,196,2,49.48,3,2,2,7,Potential
26479,114,3,32.269999999999996,4,4,1,9,Potential
26480,350,2,23.779999999999998,1,2,1,4,At Risk
26481,650,1,2071.4196,1,1,4,6,At Risk
26482,619,1,1000.4375,1,1,3,5,At Risk
26483,191,2,25.479999999999997,3,2,1,6,At Risk
26484,288,2,2813.7696,2,2,4,8,Potential
26485,288,2,2813.7696,2,2,4,8,Potential
26486,287,3,2800.4382,2,4,4,10,Loyal
26487,177,5,4456.138199999999,3,5,5,13,Champions
26488,340,1,4.99,1,1,1,3,At Risk
26489,361,1,24.99,1,1,1,3,At Risk
26490,175,3,4468.1582,3,4,5,12,Loyal
26491,160,5,4469.4382000000005,3,5,5,13,Champions
26492,281,2,29.979999999999997,2,2,1,5,At Risk
26493,346,3,64.97,1,4,2,7,Potential
26494,116,2,27.279999999999998,4,2,1,7,Potential
26495,136,2,58.980000000000004,3,2,2,7,Potential
26496,613,1,1000.4375,1,1,3,5,At Risk
26497,121,3,64.97,4,4,2,10,Loyal
26498,225,4,89.46000000000001,2,4,2,8,Potential
26499,272,3,2848.7596000000003,2,4,4,10,Loyal
26500,144,1,24.99,3,1,1,5,At Risk
26501,117,2,49.48,4,2,2,8,Potential
26502,147,2,27.279999999999998,3,2,1,6,At Risk
26503,605,1,1000.4375,1,1,3,5,At Risk
26504,594,1,1000.4375,1,1,3,5,At Risk
26505,359,2,59.980000000000004,1,2,2,5,At Risk
26506,340,3,64.97,1,4,2,7,Potential
26507,241,2,27.279999999999998,2,2,1,5,At Risk
26508,264,2,49.48,2,2,2,6,At Risk
26509,248,3,2800.4382,2,4,4,10,Loyal
26510,245,2,2813.7696,2,2,4,8,Potential
26511,154,3,4464.479600000001,3,4,5,12,Loyal
26512,602,1,1000.4375,1,1,3,5,At Risk
26513,220,3,2848.7596000000003,2,4,4,10,Loyal
26514,226,2,29.979999999999997,2,2,1,5,At Risk
26515,161,4,89.46000000000001,3,4,2,9,Potential
26516,200,3,32.269999999999996,3,4,1,8,Potential
26517,314,1,24.99,1,1,1,3,At Risk
26518,110,3,32.269999999999996,4,4,1,9,Potential
26519,156,2,29.979999999999997,3,2,1,6,At Risk
26520,240,5,2827.7182,2,5,4,11,Loyal
26521,234,3,2821.7196,2,4,4,10,Loyal
26522,176,1,24.99,3,1,1,5,At Risk
26523,103,2,49.48,4,2,2,8,Potential
26524,41,2,27.279999999999998,5,2,1,8,Potential
26525,135,2,49.48,3,2,2,7,Potential
26526,97,3,37.93,4,4,1,9,Potential
26527,185,3,29.26,3,4,1,8,Potential
26528,31,4,128.47,5,4,3,12,Loyal
26529,172,3,1549.4175,3,4,4,11,Loyal
26530,162,3,4468.1582,3,4,5,12,Loyal
26531,251,2,27.279999999999998,2,2,1,5,At Risk
26532,144,4,4469.4696,3,4,5,12,Loyal
26533,167,5,1629.4075,3,5,4,12,Loyal
26534,152,3,4490.479600000001,3,4,5,12,Loyal
26535,142,3,64.97,3,4,2,9,Potential
26536,124,4,4514.9696,4,4,5,13,Champions
26537,128,3,4468.1582,4,4,5,13,Champions
26538,128,3,4464.479600000001,4,4,5,13,Champions
26539,140,5,4469.4382000000005,3,5,5,13,Champions
26540,146,3,4468.1582,3,4,5,12,Loyal
26541,255,1,24.99,2,1,1,4,At Risk
26542,291,2,27.279999999999998,1,2,1,4,At Risk
26543,348,3,14.23,1,4,1,6,At Risk
26544,266,1,21.49,2,1,1,4,At Risk
26545,239,3,2822.7596,2,4,4,10,Loyal
26546,221,4,2847.7496,2,4,4,10,Loyal
26547,57,4,1407.96,5,4,4,13,Champions
26548,41,2,1322.98,5,2,4,11,Loyal
26549,55,5,1361.45,5,5,4,14,Champions
26550,179,3,93.48,3,4,3,10,Loyal
26551,350,1,28.99,1,1,1,3,At Risk
26552,222,4,47.96,2,4,2,8,Potential
26553,46,3,68.97,5,4,2,11,Loyal
26554,89,3,68.97,4,4,2,10,Loyal
26555,167,2,27.279999999999998,3,2,1,6,At Risk
26556,256,3,36.269999999999996,2,4,1,7,Potential
26557,263,4,44.22,2,4,2,8,Potential
26558,204,2,6.28,3,2,1,6,At Risk
26559,259,2,38.980000000000004,2,2,1,5,At Risk
26560,59,6,1396.44,5,5,4,14,Champions
26561,45,4,1336.96,5,4,4,13,Champions
26562,106,5,1925.41,4,5,4,13,Champions
26563,101,3,1957.47,4,4,4,12,Loyal
26564,1,3,49.97,5,4,2,11,Recent Customer
26565,29,2,23.779999999999998,5,2,1,8,Recent Customer
26566,117,5,2016.95,4,5,4,13,Champions
26567,59,3,1957.47,5,4,4,13,Champions
26568,36,3,1957.47,5,4,4,13,Champions
26569,48,3,1938.47,5,4,4,13,Champions
26570,47,3,1957.47,5,4,4,13,Champions
26571,54,3,1938.47,5,4,4,13,Champions
26572,455,1,1000.4375,1,1,3,5,At Risk
26573,359,3,68.97,1,4,2,7,Potential
26574,80,1,28.99,4,1,1,6,At Risk
26575,227,6,2890.4082,2,5,4,11,Loyal
26576,243,1,28.99,2,1,1,4,At Risk
26577,242,3,68.97,2,4,2,8,Potential
26578,93,3,58.47,4,4,2,10,Loyal
26579,242,5,2840.4182,2,5,4,11,Loyal
26580,26,3,68.97,5,4,2,11,Recent Customer
26581,220,3,2822.7596,2,4,4,10,Loyal
26582,434,1,1000.4375,1,1,3,5,At Risk
26583,198,3,36.269999999999996,3,4,1,8,Potential
26584,365,2,33.98,1,2,1,4,At Risk
26585,42,2,1903.48,5,2,4,11,Loyal
26586,197,1,28.99,3,1,1,5,At Risk
26587,40,4,1920.42,5,4,4,13,Champions
26588,49,3,1938.47,5,4,4,13,Champions
26589,56,4,1966.46,5,4,4,13,Champions
26590,104,1,69.99,4,1,2,7,Potential
26591,59,3,1957.47,5,4,4,13,Champions
26592,248,2,78.97999999999999,2,2,2,6,At Risk
26593,42,2,27.279999999999998,5,2,1,8,Potential
26594,236,2,29.979999999999997,2,2,1,5,At Risk
26595,24,1,24.99,5,1,1,7,Recent Customer
26596,234,3,36.269999999999996,2,4,1,7,Potential
26597,20,3,68.97,5,4,2,11,Recent Customer
26598,359,2,33.98,1,2,1,4,At Risk
26599,352,1,28.99,1,1,1,3,At Risk
26600,220,3,2800.4381999999996,2,4,4,10,Loyal
26601,242,5,2862.7396000000003,2,5,4,11,Loyal
26602,151,3,4468.1582,3,4,5,12,Loyal
26603,133,3,4487.1582,4,4,5,13,Champions
26604,135,3,4442.1582,3,4,5,12,Loyal
26605,4,2,27.279999999999998,5,2,1,8,Recent Customer
26606,217,6,2890.4082,2,5,4,11,Loyal
26607,241,2,2813.7696,2,2,4,8,Potential
26608,220,5,2881.7396000000003,2,5,4,11,Loyal
26609,137,3,4509.479600000001,3,4,5,12,Loyal
26610,153,3,4509.479600000001,3,4,5,12,Loyal
26611,136,3,4490.479600000001,3,4,5,12,Loyal
26612,101,3,58.47,4,4,2,10,Loyal
26613,10,4,138.96,5,4,3,12,Recent Customer
26614,231,2,2791.4482,2,2,4,8,Potential
26615,448,1,1000.4375,1,1,3,5,At Risk
26616,199,3,2800.4381999999996,3,4,4,11,Loyal
26617,198,5,2881.7396000000003,3,5,4,12,Loyal
26618,184,3,2826.4382,3,4,4,11,Loyal
26619,165,3,2972.7696,3,4,4,11,Loyal
26620,1098,1,699.0982,1,1,3,5,At Risk
26621,120,1,28.99,4,1,1,6,At Risk
26622,180,3,2820.4382,3,4,4,11,Loyal
26623,175,3,2841.4381999999996,3,4,4,11,Loyal
26624,157,3,2826.4382,3,4,4,11,Loyal
26625,168,4,2827.7496,3,4,4,11,Loyal
26626,127,6,2891.7296,4,5,4,13,Champions
26627,138,2,2791.4482,3,2,4,9,Potential
26628,262,3,36.269999999999996,2,4,1,7,Potential
26629,1078,1,699.0982,1,1,3,5,At Risk
26630,1014,1,699.0982,1,1,3,5,At Risk
26631,131,2,2813.7696,4,2,4,10,Loyal
26632,133,3,2848.7596000000003,4,4,4,12,Loyal
26633,95,6,2883.9082,4,5,4,13,Champions
26634,72,7,2896.7196000000004,5,5,4,14,Champions
26635,89,5,2840.4182,4,5,4,13,Champions
26636,187,3,36.269999999999996,3,4,1,8,Potential
26637,27,3,58.47,5,4,2,11,Recent Customer
26638,149,4,4518.1482,3,4,5,12,Loyal
26639,178,2,49.48,3,2,2,7,Potential
26640,166,5,1288.0582,3,5,4,12,Loyal
26641,131,3,4464.479600000001,4,4,5,13,Champions
26642,153,3,4490.479600000001,3,4,5,12,Loyal
26643,978,1,699.0982,1,1,3,5,At Risk
26644,43,4,2805.4282,5,4,4,13,Champions
26645,52,3,2800.4381999999996,5,4,4,13,Champions
26646,48,3,2972.7696,5,4,4,13,Champions
26647,55,4,2889.9382,5,4,4,13,Champions
26648,85,2,27.279999999999998,4,2,1,7,Potential
26649,123,2,4433.1682,4,2,5,11,Loyal
26650,129,2,4455.489600000001,4,2,5,11,Loyal
26651,58,3,1957.47,5,4,4,13,Champions
26652,44,3,1938.47,5,4,4,13,Champions
26653,59,3,1938.47,5,4,4,13,Champions
26654,379,4,1346.76,1,4,4,9,Potential
26655,388,2,1322.98,1,2,4,7,Potential
26656,373,5,1345.95,1,5,4,10,Loyal
26657,379,3,1357.97,1,4,4,9,Potential
26658,383,5,1390.95,1,5,4,10,Loyal
26659,18,1,69.99,5,1,2,8,Recent Customer
26660,122,3,1957.47,4,4,4,12,Loyal
26661,102,3,1912.47,4,4,4,12,Loyal
26662,94,3,1938.47,4,4,4,12,Loyal
26663,95,6,1976.94,4,5,4,13,Champions
26664,308,2,123.97999999999999,1,2,3,6,At Risk
26665,249,2,78.97999999999999,2,2,2,6,At Risk
26666,389,4,1336.96,1,4,4,9,Potential
26667,353,5,1390.95,1,5,4,10,Loyal
26668,300,2,119.97999999999999,1,2,3,6,At Risk
26669,259,2,123.97999999999999,2,2,3,7,Potential
26670,238,1,69.99,2,1,2,5,At Risk
26671,116,1,69.99,4,1,2,7,Potential
26672,95,2,123.97999999999999,4,2,3,9,Potential
26673,348,5,1505.76,1,5,4,10,Loyal
26674,195,3,68.97,3,4,2,9,Potential
26675,194,3,68.97,3,4,2,9,Potential
26676,33,4,2805.4282,5,4,4,13,Champions
26677,132,2,29.979999999999997,4,2,1,7,Potential
26678,180,1,4.99,3,1,1,5,At Risk
26679,198,2,29.979999999999997,3,2,1,6,At Risk
26680,274,3,32.269999999999996,2,4,1,7,Potential
26681,54,2,2813.7696,5,2,4,11,Loyal
26682,166,3,64.47,3,4,2,9,Potential
26683,134,5,1270.8182000000002,3,5,4,12,Loyal
26684,145,3,4468.1582,3,4,5,12,Loyal
26685,109,1,24.99,4,1,1,6,At Risk
26686,101,2,39.980000000000004,4,2,1,7,Potential
26687,211,1,24.99,2,1,1,4,At Risk
26688,305,3,64.97,1,4,2,7,Potential
26689,177,4,96.92,3,4,3,10,Loyal
26690,248,4,132.47,2,4,3,9,Potential
26691,344,1,28.99,1,1,1,3,At Risk
26692,114,5,1266.8582000000001,4,5,4,13,Champions
26693,332,2,7.28,1,2,1,4,At Risk
26694,150,5,4456.138199999999,3,5,5,13,Champions
26695,131,5,4524.4596,4,5,5,14,Champions
26696,276,3,68.97,2,4,2,8,Potential
26697,272,1,28.99,2,1,1,4,At Risk
26698,142,3,4442.1582,3,4,5,12,Loyal
26699,274,3,64.47,2,4,2,8,Potential
26700,278,2,7.28,2,2,1,5,At Risk
26701,302,2,39.980000000000004,1,2,1,4,At Risk
26702,220,3,68.97,2,4,2,8,Potential
26703,136,3,4468.1582,3,4,5,12,Loyal
26704,78,2,33.98,4,2,1,7,Potential
26705,123,2,4455.489600000001,4,2,5,11,Loyal
26706,322,2,7.28,1,2,1,4,At Risk
26707,194,2,33.98,3,2,1,6,At Risk
26708,141,5,4504.4596,3,5,5,13,Champions
26709,111,3,68.97,4,4,2,10,Loyal
26710,562,1,2071.4196,1,1,4,6,At Risk
26711,567,1,2049.0982,1,1,4,6,At Risk
26712,182,3,42.97,3,4,2,9,Potential
26713,238,3,58.47,2,4,2,8,Potential
26714,256,3,36.269999999999996,2,4,1,7,Potential
26715,112,3,68.97,4,4,2,10,Loyal
26716,62,3,68.97,5,4,2,11,Loyal
26717,571,1,2071.4196,1,1,4,6,At Risk
26718,142,5,4478.4596,3,5,5,13,Champions
26719,196,5,127.95,3,5,3,11,Loyal
26720,174,3,68.97,3,4,2,9,Potential
26721,168,3,58.47,3,4,2,9,Potential
26722,333,2,33.98,1,2,1,4,At Risk
26723,124,4,4467.1482,4,4,5,13,Champions
26724,559,1,2049.0982,1,1,4,6,At Risk
26725,560,1,2049.0982,1,1,4,6,At Risk
26726,558,1,2071.4196,1,1,4,6,At Risk
26727,152,5,4482.1382,3,5,5,13,Champions
26728,151,5,4455.098199999999,3,5,5,13,Champions
26729,129,3,4442.1582,4,4,5,13,Champions
26730,114,1,4.99,4,1,1,6,At Risk
26731,548,1,2049.0982,1,1,4,6,At Risk
26732,131,3,88.97,4,4,2,10,Loyal
26733,99,4,93.46,4,4,3,11,Loyal
26734,566,1,2049.0982,1,1,4,6,At Risk
26735,564,1,2071.4196,1,1,4,6,At Risk
26736,348,2,25.479999999999997,1,2,1,4,At Risk
26737,243,3,68.97,2,4,2,8,Potential
26738,60,2,33.98,5,2,1,8,Potential
26739,331,3,61.970000000000006,1,4,2,7,Potential
26740,114,3,1938.47,4,4,4,12,Loyal
26741,170,1,69.99,3,1,2,6,At Risk
26742,119,1,69.99,4,1,2,7,Potential
26743,343,5,1371.95,1,5,4,10,Loyal
26744,97,3,1938.47,4,4,4,12,Loyal
26745,117,4,1932.46,4,4,4,12,Loyal
26746,112,5,2001.45,4,5,4,13,Champions
26747,108,3,1938.47,4,4,4,12,Loyal
26748,343,3,1357.97,1,4,4,9,Potential
26749,365,2,1322.98,1,2,4,7,Potential
26750,106,3,1938.47,4,4,4,12,Loyal
26751,107,2,1903.48,4,2,4,10,Loyal
26752,115,4,1917.46,4,5,4,13,Champions
26753,79,3,1957.47,4,4,4,12,Loyal
26754,70,3,1938.47,5,4,4,13,Champions
26755,46,2,123.97999999999999,5,2,3,10,Loyal
26756,129,2,78.97999999999999,4,2,2,8,Potential
26757,313,3,1344.47,1,4,4,9,Potential
26758,324,2,1322.98,1,2,4,7,Potential
26759,197,2,123.97999999999999,3,2,3,8,Potential
26760,321,2,1322.98,1,2,4,7,Potential
26761,69,3,1938.47,5,4,4,13,Champions
26762,274,2,133.49,2,2,3,7,Potential
26763,86,3,1957.47,4,4,4,12,Loyal
26764,78,3,1938.47,4,4,4,12,Loyal
26765,322,2,78.97999999999999,1,2,2,5,At Risk
26766,77,2,78.97999999999999,4,2,2,8,Potential
26767,310,3,1331.97,1,4,4,9,Potential
26768,314,5,1371.95,1,5,4,10,Loyal
26769,149,2,37.29,3,2,1,6,At Risk
26770,118,1,69.99,4,1,2,7,Potential
26771,320,1,69.99,1,1,2,4,At Risk
26772,28,2,123.97999999999999,5,2,3,10,Recent Customer
26773,318,1,69.99,1,1,2,4,At Risk
26774,318,3,1331.97,1,4,4,9,Potential
26775,37,3,88.98,5,4,2,11,Loyal
26776,252,2,25.479999999999997,2,2,1,5,At Risk
26777,218,3,68.97,2,4,2,8,Potential
26778,113,2,33.98,4,2,1,7,Potential
26779,156,2,25.479999999999997,3,2,1,6,At Risk
26780,119,3,79.47,4,4,2,10,Loyal
26781,15,4,110.46000000000001,5,5,3,13,Recent Customer
26782,943,1,699.0982,1,1,3,5,At Risk
26783,26,3,88.97,5,4,2,11,Recent Customer
26784,317,3,88.97,1,4,2,7,Potential
26785,257,3,74.98,2,4,2,8,Potential
26786,570,1,2071.4196,1,1,4,6,At Risk
26787,10,3,60.47,5,4,2,11,Recent Customer
26788,359,3,36.269999999999996,1,4,1,6,At Risk
26789,907,1,699.0982,1,1,3,5,At Risk
26790,100,3,27.77,4,4,1,9,Potential
26791,162,2,25.479999999999997,3,2,1,6,At Risk
26792,304,3,184.48,1,4,3,8,Potential
26793,72,3,88.97,5,4,2,11,Loyal
26794,199,4,44.22,3,5,2,10,Loyal
26795,80,4,1992.46,4,5,4,13,Champions
26796,78,3,1957.47,4,4,4,12,Loyal
26797,80,3,1957.47,4,4,4,12,Loyal
26798,177,1,28.99,3,1,1,5,At Risk
26799,76,1,28.99,4,1,1,6,At Risk
26800,188,3,68.97,3,4,2,9,Potential
26801,568,1,2049.0982,1,1,4,6,At Risk
26802,212,1,4.99,2,1,1,4,At Risk
26803,186,3,88.97,3,4,2,9,Potential
26804,219,4,44.22,2,5,2,9,Potential
26805,570,1,2071.4196,1,1,4,6,At Risk
26806,167,1,4.99,3,1,1,5,At Risk
26807,358,3,68.97,1,4,2,7,Potential
26808,56,2,33.98,5,2,1,8,Potential
26809,265,4,118.96000000000001,2,5,3,10,Loyal
26810,14,3,67.93,5,4,2,11,Recent Customer
26811,567,1,2071.4196,1,1,4,6,At Risk
26812,206,3,58.47,3,4,2,9,Potential
26813,86,3,58.47,4,4,2,10,Loyal
26814,565,1,2049.0982,1,1,4,6,At Risk
26815,546,1,2049.0982,1,1,4,6,At Risk
26816,75,2,1735.98,4,2,4,10,Loyal
26817,240,3,553.97,2,4,3,9,Potential
26818,114,4,2407.04,4,5,4,13,Champions
26819,45,4,69.46000000000001,5,5,2,12,Loyal
26820,26,1,3.99,5,1,1,7,Recent Customer
26821,238,3,27.77,2,4,1,7,Potential
26822,66,5,2442.0299999999997,5,5,4,14,Champions
26823,47,2,2419.06,5,2,4,11,Loyal
26824,255,4,567.76,2,5,3,10,Loyal
26825,367,3,1228.83,1,4,4,9,Potential
26826,395,4,1237.82,1,5,4,10,Loyal
26827,92,2,1750.98,4,2,4,10,Loyal
26828,86,4,1732.26,4,5,4,13,Champions
26829,36,3,1728.27,5,4,4,13,Champions
26830,246,3,553.97,2,4,3,9,Potential
26831,381,2,1264.84,1,2,4,7,Potential
26832,1,3,80.47,5,4,2,11,Recent Customer
26833,226,2,6.28,2,2,1,5,At Risk
26834,182,2,6.28,3,2,1,6,At Risk
26835,81,3,68.97,4,4,2,10,Loyal
26836,17,2,38.980000000000004,5,2,1,8,Recent Customer
26837,261,2,548.98,2,2,3,7,Potential
26838,346,3,36.269999999999996,1,4,1,6,At Risk
26839,256,4,77.96000000000001,2,5,2,9,Potential
26840,101,2,33.98,4,2,1,7,Potential
26841,318,4,77.96000000000001,1,5,2,8,Potential
26842,274,1,539.99,2,1,3,6,At Risk
26843,107,3,184.48,4,4,3,11,Loyal
26844,13,2,12.98,5,2,1,8,Recent Customer
26845,181,3,27.77,3,4,1,8,Potential
26846,48,2,28.479999999999997,5,2,1,8,Potential
26847,101,3,60.47,4,4,2,10,Loyal
26848,224,4,607.96,2,5,3,10,Loyal
26849,270,2,38.980000000000004,2,2,1,5,At Risk
26850,236,2,53.980000000000004,2,2,2,6,At Risk
26851,108,2,23.779999999999998,4,2,1,7,Potential
26852,361,4,114.46000000000001,1,5,3,9,Potential
26853,266,3,786.33,2,4,3,9,Potential
26854,86,3,1714.97,4,4,4,12,Loyal
26855,88,1,1700.99,4,1,4,9,Potential
26856,260,4,810.32,2,5,3,10,Loyal
26857,232,1,21.49,2,1,1,4,At Risk
26858,223,3,553.97,2,4,3,9,Potential
26859,195,2,33.98,3,2,1,6,At Risk
26860,239,1,539.99,2,1,3,6,At Risk
26861,359,3,36.269999999999996,1,4,1,6,At Risk
26862,378,2,1249.84,1,2,4,7,Potential
26863,24,1,3.99,5,1,1,7,Recent Customer
26864,396,2,1268.84,1,2,4,7,Potential
26865,344,2,123.99,1,2,3,6,At Risk
26866,220,4,615.46,2,5,3,10,Loyal
26867,57,3,1728.27,5,4,4,13,Champions
26868,232,1,539.99,2,1,3,6,At Risk
26869,217,3,553.97,2,4,3,9,Potential
26870,238,2,548.98,2,2,3,7,Potential
26871,154,3,88.97,3,4,2,9,Potential
26872,165,2,23.779999999999998,3,2,1,6,At Risk
26873,347,2,1249.84,1,2,4,7,Potential
26874,273,2,23.779999999999998,2,2,1,5,At Risk
26875,75,3,60.47,4,4,2,10,Loyal
26876,231,4,588.96,2,5,3,10,Loyal
26877,54,2,38.980000000000004,5,2,1,8,Potential
26878,265,1,21.49,2,1,1,4,At Risk
26879,105,2,75.48,4,2,2,8,Potential
26880,159,2,23.779999999999998,3,2,1,6,At Risk
26881,193,3,42.97,3,4,2,9,Potential
26882,279,4,91.26,2,5,2,9,Potential
26883,65,3,68.97,5,4,2,11,Loyal
26884,338,3,1273.83,1,4,4,9,Potential
26885,235,2,574.98,2,2,3,7,Potential
26886,222,3,553.97,2,4,3,9,Potential
26887,226,2,6.28,2,2,1,5,At Risk
26888,45,2,38.980000000000004,5,2,1,8,Potential
26889,290,2,30.479999999999997,1,2,1,4,At Risk
26890,220,4,588.96,2,5,3,10,Loyal
26891,162,2,39.980000000000004,3,2,1,6,At Risk
26892,189,3,553.97,3,4,3,10,Loyal
26893,189,2,59.980000000000004,3,2,2,7,Potential
26894,305,2,23.779999999999998,1,2,1,4,At Risk
26895,216,3,553.97,2,4,3,9,Potential
26896,317,2,12.98,1,2,1,4,At Risk
26897,313,2,38.980000000000004,1,2,1,4,At Risk
26898,332,5,173.95000000000002,1,5,3,9,Potential
26899,340,2,23.779999999999998,1,2,1,4,At Risk
26900,127,3,47.97,4,4,2,10,Loyal
26901,69,1,3.99,5,1,1,7,Potential
26902,266,2,777.34,2,2,3,7,Potential
26903,249,4,800.82,2,5,3,10,Loyal
26904,355,1,28.99,1,1,1,3,At Risk
26905,250,2,6.28,2,2,1,5,At Risk
26906,111,2,67.49,4,2,2,8,Potential
26907,67,4,108.46,5,5,3,13,Champions
26908,101,3,36.269999999999996,4,4,1,9,Potential
26909,334,4,77.96000000000001,1,5,2,8,Potential
26910,216,4,588.96,2,5,3,10,Loyal
26911,341,1,3.99,1,1,1,3,At Risk
26912,203,3,27.77,3,4,1,8,Potential
26913,214,4,607.96,2,5,3,10,Loyal
26914,223,4,588.96,2,5,3,10,Loyal
26915,211,2,58.980000000000004,2,2,2,6,At Risk
26916,32,2,1322.98,5,2,4,11,Loyal
26917,38,5,1339.25,5,5,4,14,Champions
26918,51,6,1399.94,5,5,4,14,Champions
26919,47,5,1350.75,5,5,4,14,Champions
26920,42,4,1336.96,5,5,4,14,Champions
26921,51,4,1336.96,5,5,4,14,Champions
26922,57,2,1322.98,5,2,4,11,Loyal
26923,44,2,1322.98,5,2,4,11,Loyal
26924,39,5,1350.75,5,5,4,14,Champions
26925,74,3,36.269999999999996,4,4,1,9,Potential
26926,57,1,28.99,5,1,1,7,Potential
26927,282,3,36.269999999999996,2,4,1,7,Potential
26928,239,5,597.95,2,5,3,10,Loyal
26929,156,4,588.96,3,5,3,11,Loyal
26930,315,4,1263.82,1,5,4,10,Loyal
26931,234,2,561.48,2,2,3,7,Potential
26932,228,2,574.98,2,2,3,7,Potential
26933,303,2,1223.84,1,2,4,7,Potential
26934,232,3,553.97,2,4,3,9,Potential
26935,163,1,28.99,3,1,1,5,At Risk
26936,251,2,1249.84,2,2,4,8,Potential
26937,214,4,619.46,2,5,3,10,Loyal
26938,237,4,722.77,2,5,3,10,Loyal
26939,248,2,777.34,2,2,3,7,Potential
26940,249,3,1273.83,2,4,4,10,Loyal
26941,224,2,777.34,2,2,3,7,Potential
26942,219,4,588.96,2,5,3,10,Loyal
26943,106,3,68.97,4,4,2,10,Loyal
26944,232,3,553.97,2,4,3,9,Potential
26945,244,2,777.34,2,2,3,7,Potential
26946,239,1,1214.85,2,1,4,7,Potential
26947,240,3,624.97,2,4,3,9,Potential
26948,234,3,1293.33,2,4,4,10,Loyal
26949,187,3,565.47,3,4,3,10,Loyal
26950,218,2,777.34,2,2,3,7,Potential
26951,26,3,60.47,5,4,2,11,Recent Customer
26952,229,2,751.34,2,2,3,7,Potential
26953,232,3,786.33,2,4,3,9,Potential
26954,225,2,1223.84,2,2,4,8,Potential
26955,181,3,565.47,3,4,3,10,Loyal
26956,208,4,607.96,2,5,3,10,Loyal
26957,49,3,1759.97,5,4,4,13,Champions
26958,37,4,1732.26,5,5,4,14,Champions
26959,133,3,563.77,4,4,3,11,Loyal
26960,196,2,574.98,3,2,3,8,Potential
26961,219,2,1268.84,2,2,4,8,Potential
26962,194,3,553.97,3,4,3,10,Loyal
26963,198,4,1237.82,3,5,4,12,Loyal
26964,239,2,751.34,2,2,3,7,Potential
26965,214,3,776.33,2,4,3,9,Potential
26966,186,4,588.96,3,5,3,11,Loyal
26967,329,4,1336.96,1,5,4,10,Loyal
26968,135,2,78.97999999999999,3,2,2,7,Potential
26969,195,2,23.779999999999998,3,2,1,6,At Risk
26970,163,2,38.980000000000004,3,2,1,6,At Risk
26971,136,2,6.28,3,2,1,6,At Risk
26972,308,3,83.97,1,4,2,7,Potential
26973,262,2,38.980000000000004,2,2,1,5,At Risk
26974,192,5,1292.81,3,5,4,12,Loyal
26975,206,4,765.32,3,5,3,11,Loyal
26976,193,4,791.32,3,5,3,11,Loyal
26977,184,4,1283.82,3,5,4,12,Loyal
26978,139,3,553.97,3,4,3,10,Loyal
26979,148,4,588.96,3,5,3,11,Loyal
26980,31,2,23.779999999999998,5,2,1,8,Potential
26981,313,1,21.49,1,1,1,3,At Risk
26982,178,1,28.99,3,1,1,5,At Risk
26983,33,3,1744.97,5,4,4,13,Champions
26984,53,4,1764.96,5,5,4,14,Champions
26985,351,3,1164.47,1,4,4,9,Potential
26986,322,2,1155.48,1,2,3,6,At Risk
26987,313,2,1155.48,1,2,3,6,At Risk
26988,264,3,1179.47,2,4,4,10,Loyal
26989,361,2,25.479999999999997,1,2,1,4,At Risk
26990,288,2,23.779999999999998,2,2,1,5,At Risk
26991,206,2,1264.84,3,2,4,9,Potential
26992,190,3,583.97,3,4,3,10,Loyal
26993,55,2,38.980000000000004,5,2,1,8,Potential
26994,389,3,1134.47,1,4,3,8,Potential
26995,386,2,1145.48,1,2,3,6,At Risk
26996,108,3,15.23,4,4,1,9,Potential
26997,250,3,1149.47,2,4,3,9,Potential
26998,163,3,75.47,3,4,2,9,Potential
26999,77,2,57.980000000000004,4,2,2,8,Potential
27000,332,2,30.479999999999997,1,2,1,4,At Risk
27001,318,2,30.479999999999997,1,2,1,4,At Risk
27002,353,2,38.980000000000004,1,2,1,4,At Risk
27003,148,1,21.49,3,1,1,5,At Risk
27004,176,2,1264.84,3,2,4,9,Potential
27005,183,2,777.34,3,2,3,8,Potential
27006,210,2,750.3000000000001,2,2,3,7,Potential
27007,195,4,113.96000000000001,3,5,3,11,Loyal
27008,136,5,616.95,3,5,3,11,Loyal
27009,117,2,574.98,4,2,3,9,Potential
27010,17,3,41.93,5,4,2,11,Recent Customer
27011,33,3,36.269999999999996,5,4,1,10,Loyal
27012,118,3,36.269999999999996,4,4,1,9,Potential
27013,49,3,36.269999999999996,5,4,1,10,Loyal
27014,113,3,1274.0782,4,4,4,12,Loyal
27015,86,3,68.97,4,4,2,10,Loyal
27016,328,3,41.93,1,4,2,7,Potential
27017,125,5,4502.138199999999,4,5,5,14,Champions
27018,169,2,33.98,3,2,1,6,At Risk
27019,138,1,4.99,3,1,1,5,At Risk
27020,544,1,2071.4196,1,1,4,6,At Risk
27021,524,1,2071.4196,1,1,4,6,At Risk
27022,274,1,4.99,2,1,1,4,At Risk
27023,291,3,60.47,1,4,2,7,Potential
27024,47,2,7.28,5,2,1,8,Potential
27025,318,2,23.779999999999998,1,2,1,4,At Risk
27026,790,1,699.0982,1,1,3,5,At Risk
27027,724,1,782.99,1,1,3,5,At Risk
27028,284,2,59.980000000000004,2,2,2,6,At Risk
27029,17,3,31.729999999999997,5,4,1,10,Recent Customer
27030,220,1,21.49,2,1,1,4,At Risk
27031,83,1,4.99,4,1,1,6,At Risk
27032,11,2,7.28,5,2,1,8,Recent Customer
27033,247,2,29.479999999999997,2,2,1,5,At Risk
27034,146,1,4.99,3,1,1,5,At Risk
27035,188,2,7.28,3,2,1,6,At Risk
27036,334,2,7.28,1,2,1,4,At Risk
27037,322,2,12.940000000000001,1,2,1,4,At Risk
27038,81,2,7.28,4,2,1,7,Potential
27039,153,1,4.99,3,1,1,5,At Risk
27040,361,2,7.28,1,2,1,4,At Risk
27041,97,2,7.28,4,2,1,7,Potential
27042,49,2,68.49,5,2,2,9,Potential
27043,715,1,782.99,1,1,3,5,At Risk
27044,520,1,2049.0982,1,1,4,6,At Risk
27045,530,1,2049.0982,1,1,4,6,At Risk
27046,288,3,36.269999999999996,2,4,1,7,Potential
27047,528,1,2049.0982,1,1,4,6,At Risk
27048,77,3,36.269999999999996,4,4,1,9,Potential
27049,271,1,4.99,2,1,1,4,At Risk
27050,536,1,2071.4196,1,1,4,6,At Risk
27051,527,1,2049.0982,1,1,4,6,At Risk
27052,181,3,36.269999999999996,3,4,1,8,Potential
27053,685,1,782.99,1,1,3,5,At Risk
27054,547,1,2071.4196,1,1,4,6,At Risk
27055,315,2,33.98,1,2,1,4,At Risk
27056,539,1,2071.4196,1,1,4,6,At Risk
27057,19,1,28.99,5,1,1,7,Recent Customer
27058,542,1,2049.0982,1,1,4,6,At Risk
27059,338,4,118.96000000000001,1,5,3,9,Potential
27060,675,1,782.99,1,1,3,5,At Risk
27061,183,1,4.99,3,1,1,5,At Risk
27062,673,1,782.99,1,1,3,5,At Risk
27063,533,1,2071.4196,1,1,4,6,At Risk
27064,547,1,2071.4196,1,1,4,6,At Risk
27065,212,3,68.97,2,4,2,8,Potential
27066,364,2,33.98,1,2,1,4,At Risk
27067,527,1,2049.0982,1,1,4,6,At Risk
27068,531,1,2049.0982,1,1,4,6,At Risk
27069,529,1,2049.0982,1,1,4,6,At Risk
27070,40,3,68.97,5,4,2,11,Loyal
27071,693,1,782.99,1,1,3,5,At Risk
27072,272,2,31.279999999999998,2,2,1,5,At Risk
27073,141,2,4433.1682,3,2,5,10,Loyal
27074,146,2,4433.1682,3,2,5,10,Loyal
27075,95,5,1371.95,4,5,4,13,Champions
27076,529,1,2071.4196,1,1,4,6,At Risk
27077,536,1,2071.4196,1,1,4,6,At Risk
27078,543,1,2071.4196,1,1,4,6,At Risk
27079,508,1,2071.4196,1,1,4,6,At Risk
27080,507,1,2071.4196,1,1,4,6,At Risk
27081,506,1,2049.0982,1,1,4,6,At Risk
27082,647,1,782.99,1,1,3,5,At Risk
27083,508,1,2049.0982,1,1,4,6,At Risk
27084,670,1,782.99,1,1,3,5,At Risk
27085,613,1,782.99,1,1,3,5,At Risk
27086,500,1,2049.0982,1,1,4,6,At Risk
27087,518,1,2071.4196,1,1,4,6,At Risk
27088,512,1,2071.4196,1,1,4,6,At Risk
27089,489,1,2049.0982,1,1,4,6,At Risk
27090,492,1,2049.0982,1,1,4,6,At Risk
27091,494,1,2071.4196,1,1,4,6,At Risk
27092,143,5,4519.4596,3,5,5,13,Champions
27093,147,3,4509.479600000001,3,4,5,12,Loyal
27094,495,1,2071.4196,1,1,4,6,At Risk
27095,502,1,2049.0982,1,1,4,6,At Risk
27096,124,3,4490.479600000001,4,4,5,13,Champions
27097,149,3,4464.479600000001,3,4,5,12,Loyal
27098,164,3,68.97,3,4,2,9,Potential
27099,613,1,782.99,1,1,3,5,At Risk
27100,299,2,7.28,1,2,1,4,At Risk
27101,613,1,782.99,1,1,3,5,At Risk
27102,612,1,782.99,1,1,3,5,At Risk
27103,131,3,4468.1582,4,4,5,13,Champions
27104,112,3,4468.1582,4,4,5,13,Champions
27105,106,4,4447.1482,4,5,5,14,Champions
27106,117,2,4455.489600000001,4,2,5,11,Loyal
27107,99,2,4455.489600000001,4,2,5,11,Loyal
27108,505,1,2071.4196,1,1,4,6,At Risk
27109,321,3,88.97,1,4,2,7,Potential
27110,76,1,4.99,4,1,1,6,At Risk
27111,235,2,7.28,2,2,1,5,At Risk
27112,217,4,114.46,2,5,3,10,Loyal
27113,141,4,77.96000000000001,3,5,2,10,Loyal
27114,122,3,4464.479600000001,4,4,5,13,Champions
27115,87,3,58.47,4,4,2,10,Loyal
27116,96,3,4464.479600000001,4,4,5,13,Champions
27117,97,3,4490.479600000001,4,4,5,13,Champions
27118,210,2,777.34,2,2,3,7,Potential
27119,146,3,1228.83,3,4,4,11,Loyal
27120,149,2,1264.84,3,2,4,9,Potential
27121,199,1,539.99,3,1,3,7,Potential
27122,170,3,786.33,3,4,3,10,Loyal
27123,157,2,777.34,3,2,3,8,Potential
27124,129,4,811.32,4,5,3,12,Loyal
27125,165,4,607.96,3,5,3,11,Loyal
27126,337,2,1155.48,1,2,3,6,At Risk
27127,245,1,1120.49,2,1,3,6,At Risk
27128,341,2,1155.48,1,2,3,6,At Risk
27129,270,3,1134.47,2,4,3,9,Potential
27130,95,1,539.99,4,1,3,8,Potential
27131,100,2,603.49,4,2,3,9,Potential
27132,158,4,571.72,3,5,3,11,Loyal
27133,136,2,777.34,3,2,3,8,Potential
27134,151,2,777.34,3,2,3,8,Potential
27135,205,3,42.97,3,4,2,9,Potential
27136,126,2,1223.84,4,2,4,10,Loyal
27137,166,4,617.47,3,5,3,11,Loyal
27138,130,2,777.34,4,2,3,9,Potential
27139,95,4,1282.82,4,5,4,13,Champions
27140,165,5,575.71,3,5,3,11,Loyal
27141,170,2,574.98,3,2,3,8,Potential
27142,127,4,791.32,4,5,3,12,Loyal
27143,319,4,1169.46,1,5,4,10,Loyal
27144,142,2,39.99,3,2,2,7,Potential
27145,172,1,35.0,3,1,1,5,At Risk
27146,238,3,74.98,2,4,2,8,Potential
27147,85,2,123.97999999999999,4,2,3,9,Potential
27148,213,2,78.97999999999999,2,2,2,6,At Risk
27149,115,3,42.28,4,4,2,10,Loyal
27150,260,4,201.28,2,5,3,10,Loyal
27151,113,2,6.28,4,2,1,7,Potential
27152,304,2,38.980000000000004,1,2,1,4,At Risk
27153,309,3,42.97,1,4,2,7,Potential
27154,101,3,1228.83,4,4,4,12,Loyal
27155,320,3,68.97,1,4,2,7,Potential
27156,251,2,6.28,2,2,1,5,At Risk
27157,232,3,60.47,2,4,2,8,Potential
27158,124,2,6.28,4,2,1,7,Potential
27159,152,4,791.32,3,5,3,11,Loyal
27160,113,3,31.729999999999997,4,4,1,9,Potential
27161,62,4,1236.78,5,5,4,14,Champions
27162,79,1,539.99,4,1,3,8,Potential
27163,271,2,7.28,2,2,1,5,At Risk
27164,262,1,3.99,2,1,1,4,At Risk
27165,170,1,3.99,3,1,1,5,At Risk
27166,104,3,827.33,4,4,3,11,Loyal
27167,261,4,1203.46,2,5,4,11,Loyal
27168,103,2,67.49,4,2,2,8,Potential
27169,57,1,1214.85,5,1,4,10,Loyal
27170,110,3,756.33,4,4,3,11,Loyal
27171,171,4,588.96,3,5,3,11,Loyal
27172,95,2,23.779999999999998,4,2,1,7,Potential
27173,328,3,60.47,1,4,2,7,Potential
27174,141,2,7.28,3,2,1,6,At Risk
27175,74,3,565.47,4,4,3,11,Loyal
27176,345,1,21.49,1,1,1,3,At Risk
27177,57,2,28.479999999999997,5,2,1,8,Potential
27178,40,2,25.479999999999997,5,2,1,8,Potential
27179,160,2,548.98,3,2,3,8,Potential
27180,61,2,1268.84,5,2,4,11,Loyal
27181,216,2,1155.48,2,2,3,7,Potential
27182,219,2,1174.48,2,2,4,8,Potential
27183,240,3,1147.77,2,4,3,9,Potential
27184,362,3,89.97,1,4,2,7,Potential
27185,82,4,588.96,4,5,3,12,Loyal
27186,81,4,600.46,4,5,3,12,Loyal
27187,44,2,7.28,5,2,1,8,Potential
27188,114,1,4.99,4,1,1,6,At Risk
27189,141,3,58.47,3,4,2,9,Potential
27190,25,3,36.269999999999996,5,4,1,10,Recent Customer
27191,10,2,29.479999999999997,5,2,1,8,Recent Customer
27192,350,2,33.98,1,2,1,4,At Risk
27193,487,1,2049.0982,1,1,4,6,At Risk
27194,272,4,77.96000000000001,2,5,2,9,Potential
27195,108,2,4455.489600000001,4,2,5,11,Loyal
27196,315,2,68.49,1,2,2,5,At Risk
27197,248,3,36.269999999999996,2,4,1,7,Potential
27198,196,5,147.95000000000002,3,5,3,11,Loyal
27199,100,3,4468.1582,4,4,5,13,Champions
27200,74,3,36.269999999999996,4,4,1,9,Potential
27201,96,4,4492.6482,4,5,5,14,Champions
27202,326,4,96.92,1,5,3,9,Potential
27203,104,3,18.97,4,4,1,9,Potential
27204,186,1,4.99,3,1,1,5,At Risk
27205,463,1,2049.0982,1,1,4,6,At Risk
27206,473,1,2071.4196,1,1,4,6,At Risk
27207,329,1,4.99,1,1,1,3,At Risk
27208,35,2,39.980000000000004,5,2,1,8,Potential
27209,183,2,13.98,3,2,1,6,At Risk
27210,290,2,7.28,1,2,1,4,At Risk
27211,478,1,2071.4196,1,1,4,6,At Risk
27212,474,1,2071.4196,1,1,4,6,At Risk
27213,109,2,7.28,4,2,1,7,Potential
27214,273,3,187.98,2,4,3,9,Potential
27215,100,3,64.47,4,4,2,10,Loyal
27216,6,3,37.97,5,4,1,10,Recent Customer
27217,245,2,28.979999999999997,2,2,1,5,At Risk
27218,291,2,6.28,1,2,1,4,At Risk
27219,247,2,67.49,2,2,2,6,At Risk
27220,139,2,38.980000000000004,3,2,1,6,At Risk
27221,275,1,3.99,2,1,1,4,At Risk
27222,348,2,11.940000000000001,1,2,1,4,At Risk
27223,309,2,6.28,1,2,1,4,At Risk
27224,302,2,6.28,1,2,1,4,At Risk
27225,142,2,28.479999999999997,3,2,1,6,At Risk
27226,481,1,2049.0982,1,1,4,6,At Risk
27227,464,1,2071.4196,1,1,4,6,At Risk
27228,477,1,2071.4196,1,1,4,6,At Risk
27229,341,4,93.46,1,5,3,9,Potential
27230,195,2,13.98,3,2,1,6,At Risk
27231,482,1,2049.0982,1,1,4,6,At Risk
27232,476,1,2049.0982,1,1,4,6,At Risk
27233,271,3,58.47,2,4,2,8,Potential
27234,475,1,2071.4196,1,1,4,6,At Risk
27235,465,1,2049.0982,1,1,4,6,At Risk
27236,81,2,33.98,4,2,1,7,Potential
27237,275,1,28.99,2,1,1,4,At Risk
27238,76,3,68.97,4,4,2,10,Loyal
27239,470,1,2071.4196,1,1,4,6,At Risk
27240,478,1,2049.0982,1,1,4,6,At Risk
27241,242,1,28.99,2,1,1,4,At Risk
27242,584,1,782.99,1,1,3,5,At Risk
27243,287,2,54.980000000000004,2,2,2,6,At Risk
27244,34,3,36.269999999999996,5,4,1,10,Loyal
27245,90,2,33.98,4,2,1,7,Potential
27246,260,1,28.99,2,1,1,4,At Risk
27247,256,3,68.97,2,4,2,8,Potential
27248,171,3,36.269999999999996,3,4,1,8,Potential
27249,340,1,28.99,1,1,1,3,At Risk
27250,119,6,4587.9596,4,5,5,14,Champions
27251,484,1,2049.0982,1,1,4,6,At Risk
27252,581,1,782.99,1,1,3,5,At Risk
27253,581,1,782.99,1,1,3,5,At Risk
27254,466,1,2049.0982,1,1,4,6,At Risk
27255,476,1,2049.0982,1,1,4,6,At Risk
27256,465,1,2071.4196,1,1,4,6,At Risk
27257,459,1,2071.4196,1,1,4,6,At Risk
27258,453,1,2071.4196,1,1,4,6,At Risk
27259,590,1,782.99,1,1,3,5,At Risk
27260,454,1,2049.0982,1,1,4,6,At Risk
27261,437,1,2049.0982,1,1,4,6,At Risk
27262,433,1,2049.0982,1,1,4,6,At Risk
27263,455,1,2049.0982,1,1,4,6,At Risk
27264,439,1,2071.4196,1,1,4,6,At Risk
27265,605,1,782.99,1,1,3,5,At Risk
27266,453,1,2071.4196,1,1,4,6,At Risk
27267,533,1,782.99,1,1,3,5,At Risk
27268,451,1,2049.0982,1,1,4,6,At Risk
27269,445,1,2049.0982,1,1,4,6,At Risk
27270,496,1,782.99,1,1,3,5,At Risk
27271,432,1,2071.4196,1,1,4,6,At Risk
27272,447,1,2049.0982,1,1,4,6,At Risk
27273,101,3,4490.479600000001,4,4,5,13,Champions
27274,106,3,4468.1582,4,4,5,13,Champions
27275,428,1,2049.0982,1,1,4,6,At Risk
27276,433,1,2049.0982,1,1,4,6,At Risk
27277,430,1,2071.4196,1,1,4,6,At Risk
27278,78,1,28.99,4,1,1,6,At Risk
27279,120,3,4490.479600000001,4,4,5,13,Champions
27280,121,4,4447.1482,4,5,5,14,Champions
27281,105,4,4540.4696,4,5,5,14,Champions
27282,113,1,69.99,4,1,2,7,Potential
27283,354,2,119.97999999999999,1,2,3,6,At Risk
27284,250,4,122.96000000000001,2,5,3,10,Loyal
27285,499,1,782.99,1,1,3,5,At Risk
27286,435,1,2071.4196,1,1,4,6,At Risk
27287,97,3,4484.479600000001,4,4,5,13,Champions
27288,95,3,4442.1582,4,4,5,13,Champions
27289,457,1,2071.4196,1,1,4,6,At Risk
27290,187,1,28.99,3,1,1,5,At Risk
27291,96,2,4455.489600000001,4,2,5,11,Loyal
27292,455,1,2049.0982,1,1,4,6,At Risk
27293,344,3,88.97,1,4,2,7,Potential
27294,117,4,4540.4696,4,5,5,14,Champions
27295,114,3,4442.1582,4,4,5,13,Champions
27296,117,4,4518.4696,4,5,5,14,Champions
27297,493,1,782.99,1,1,3,5,At Risk
27298,494,1,782.99,1,1,3,5,At Risk
27299,275,2,1322.98,2,2,4,8,Potential
27300,317,2,7.28,1,2,1,4,At Risk
27301,97,3,68.97,4,4,2,10,Loyal
27302,47,3,36.269999999999996,5,4,1,10,Loyal
27303,191,1,28.99,3,1,1,5,At Risk
27304,121,3,42.97,4,4,2,10,Loyal
27305,45,3,1714.97,5,4,4,13,Champions
27306,166,1,28.99,3,1,1,5,At Risk
27307,195,3,68.97,3,4,2,9,Potential
27308,297,2,6.28,1,2,1,4,At Risk
27309,334,3,2457.3299999999995,1,4,4,9,Potential
27310,103,3,68.97,4,4,2,10,Loyal
27311,195,2,33.98,3,2,1,6,At Risk
27312,112,2,33.98,4,2,1,7,Potential
27313,269,2,33.98,2,2,1,5,At Risk
27314,196,3,68.97,3,4,2,9,Potential
27315,23,3,68.97,5,4,2,11,Recent Customer
27316,332,1,2443.35,1,1,4,6,At Risk
27317,98,2,6.28,4,2,1,7,Potential
27318,25,3,42.97,5,4,2,11,Recent Customer
27319,35,3,1775.47,5,4,4,13,Champions
27320,73,2,33.98,5,2,1,8,Potential
27321,340,1,28.99,1,1,1,3,At Risk
27322,302,3,36.269999999999996,1,4,1,6,At Risk
27323,360,3,83.97,1,4,2,7,Potential
27324,51,3,2364.9699999999993,5,4,4,13,Champions
27325,322,4,201.27,1,5,3,9,Potential
27326,196,3,83.97,3,4,2,9,Potential
27327,249,2,33.98,2,2,1,5,At Risk
27328,8,3,68.97,5,4,2,11,Recent Customer
27329,228,2,39.980000000000004,2,2,1,5,At Risk
27330,33,3,42.97,5,4,2,11,Loyal
27331,361,1,3.99,1,1,1,3,At Risk
27332,140,2,7.28,3,2,1,6,At Risk
27333,95,1,28.99,4,1,1,6,At Risk
27334,150,1,4.99,3,1,1,5,At Risk
27335,42,2,39.980000000000004,5,2,1,8,Potential
27336,292,3,36.269999999999996,1,4,1,6,At Risk
27337,154,2,11.940000000000001,3,2,1,6,At Risk
27338,304,4,1339.92,1,5,4,10,Loyal
27339,301,4,1336.96,1,5,4,10,Loyal
27340,275,5,1350.75,2,5,4,11,Loyal
27341,259,2,1322.98,2,2,4,8,Potential
27342,258,4,1348.46,2,5,4,11,Loyal
27343,207,3,132.97,2,4,3,9,Potential
27344,253,1,69.99,2,1,2,5,At Risk
27345,94,1,69.99,4,1,2,7,Potential
27346,270,5,1390.95,2,5,4,11,Loyal
27347,229,2,78.97999999999999,2,2,2,6,At Risk
27348,225,4,1382.46,2,5,4,11,Loyal
27349,19,2,123.97999999999999,5,2,3,10,Recent Customer
27350,303,1,69.99,1,1,2,4,At Risk
27351,238,2,123.97999999999999,2,2,3,7,Potential
27352,244,3,1357.97,2,4,4,10,Loyal
27353,234,5,1371.95,2,5,4,11,Loyal
27354,220,2,1322.98,2,2,4,8,Potential
27355,234,5,1383.45,2,5,4,11,Loyal
27356,237,4,1336.96,2,5,4,11,Loyal
27357,135,1,69.99,3,1,2,6,At Risk
27358,277,2,78.97999999999999,2,2,2,6,At Risk
27359,214,3,1344.47,2,4,4,10,Loyal
27360,290,1,69.99,1,1,2,4,At Risk
27361,132,1,69.99,4,1,2,7,Potential
27362,239,5,1407.45,2,5,4,11,Loyal
27363,204,3,132.97,3,4,3,10,Loyal
27364,334,2,78.97999999999999,1,2,2,5,At Risk
27365,224,5,1371.95,2,5,4,11,Loyal
27366,234,2,1322.98,2,2,4,8,Potential
27367,174,1,69.99,3,1,2,6,At Risk
27368,329,3,132.97,1,4,3,8,Potential
27369,254,2,78.97999999999999,2,2,2,6,At Risk
27370,236,2,1322.98,2,2,4,8,Potential
27371,233,5,1350.75,2,5,4,11,Loyal
27372,30,2,38.980000000000004,5,2,1,8,Recent Customer
27373,250,2,38.980000000000004,2,2,1,5,At Risk
27374,74,2,6.28,4,2,1,7,Potential
27375,315,2,6.28,1,2,1,4,At Risk
27376,77,2,6.28,4,2,1,7,Potential
27377,26,3,128.97,5,4,3,12,Recent Customer
27378,107,2,78.97999999999999,4,2,2,8,Potential
27379,177,4,152.47,3,5,3,11,Loyal
27380,249,1,69.99,2,1,2,5,At Risk
27381,72,3,68.97,5,4,2,11,Loyal
27382,291,3,36.269999999999996,1,4,1,6,At Risk
27383,6,3,68.97,5,4,2,11,Recent Customer
27384,237,2,78.97999999999999,2,2,2,6,At Risk
27385,135,3,68.97,3,4,2,9,Potential
27386,181,3,36.269999999999996,3,4,1,8,Potential
27387,308,2,33.98,1,2,1,4,At Risk
27388,292,3,83.97,1,4,2,7,Potential
27389,329,1,28.99,1,1,1,3,At Risk
27390,52,4,47.96,5,5,2,12,Loyal
27391,198,2,33.98,3,2,1,6,At Risk
27392,2,2,23.779999999999998,5,2,1,8,Recent Customer
27393,323,2,123.97999999999999,1,2,3,6,At Risk
27394,147,2,30.479999999999997,3,2,1,6,At Risk
27395,118,3,75.47,4,4,2,10,Loyal
27396,167,3,88.98,3,4,2,9,Potential
27397,67,3,33.43,5,4,1,10,Loyal
27398,122,3,27.77,4,4,1,9,Potential
27399,280,4,84.46000000000001,2,5,2,9,Potential
27400,360,1,69.99,1,1,2,4,At Risk
27401,274,1,69.99,2,1,2,5,At Risk
27402,100,3,128.97,4,4,3,11,Loyal
27403,74,3,132.97,4,4,3,11,Loyal
27404,493,1,782.99,1,1,3,5,At Risk
27405,456,1,2071.4196,1,1,4,6,At Risk
27406,114,3,1357.97,4,4,4,12,Loyal
27407,102,3,4490.479600000001,4,4,5,13,Champions
27408,148,4,77.96000000000001,3,5,2,10,Loyal
27409,224,3,60.47,2,4,2,8,Potential
27410,255,2,23.779999999999998,2,2,1,5,At Risk
27411,239,2,23.779999999999998,2,2,1,5,At Risk
27412,96,3,68.97,4,4,2,10,Loyal
27413,244,3,103.48,2,4,3,9,Potential
27414,195,1,4.99,3,1,1,5,At Risk
27415,362,1,69.99,1,1,2,4,At Risk
27416,432,1,2049.0982,1,1,4,6,At Risk
27417,100,1,21.49,4,1,1,6,At Risk
27418,109,3,4490.479600000001,4,4,5,13,Champions
27419,235,1,69.99,2,1,2,5,At Risk
27420,354,1,69.99,1,1,2,4,At Risk
27421,450,1,2049.0982,1,1,4,6,At Risk
27422,116,3,60.47,4,4,2,10,Loyal
27423,440,1,2071.4196,1,1,4,6,At Risk
27424,435,1,2049.0982,1,1,4,6,At Risk
27425,457,1,2049.0982,1,1,4,6,At Risk
27426,178,2,23.779999999999998,3,2,1,6,At Risk
27427,102,3,4490.479600000001,4,4,5,13,Champions
27428,214,2,94.47999999999999,2,2,3,7,Potential
27429,463,1,782.99,1,1,3,5,At Risk
27430,189,3,33.43,3,4,1,8,Potential
27431,430,1,2049.0982,1,1,4,6,At Risk
27432,78,3,27.77,4,4,1,9,Potential
27433,185,3,27.77,3,4,1,8,Potential
27434,6,3,36.269999999999996,5,4,1,10,Recent Customer
27435,265,3,88.97,2,4,2,8,Potential
27436,74,2,94.47999999999999,4,2,3,9,Potential
27437,302,2,78.97999999999999,1,2,2,5,At Risk
27438,253,3,27.77,2,4,1,7,Potential
27439,109,3,4462.1582,4,4,5,13,Champions
27440,106,4,4447.1482,4,5,5,14,Champions
27441,357,2,78.97999999999999,1,2,2,5,At Risk
27442,246,3,27.77,2,4,1,7,Potential
27443,277,2,23.779999999999998,2,2,1,5,At Risk
27444,99,2,31.279999999999998,4,2,1,7,Potential
27445,95,2,33.98,4,2,1,7,Potential
27446,105,3,4468.1582,4,4,5,13,Champions
27447,113,3,4490.479600000001,4,4,5,13,Champions
27448,436,1,2071.4196,1,1,4,6,At Risk
27449,116,5,4482.1382,4,5,5,14,Champions
27450,109,4,4514.9696,4,5,5,14,Champions
27451,182,3,37.43,3,4,1,8,Potential
27452,98,4,4544.4696,4,5,5,14,Champions
27453,120,3,4468.1582,4,4,5,13,Champions
27454,229,2,7.28,2,2,1,5,At Risk
27455,96,5,4532.9696,4,5,5,14,Champions
27456,106,3,58.47,4,4,2,10,Loyal
27457,153,3,58.47,3,4,2,9,Potential
27458,211,3,68.97,2,4,2,8,Potential
27459,102,6,4552.128199999999,4,5,5,14,Champions
27460,96,3,4490.479600000001,4,4,5,13,Champions
27461,203,4,110.46000000000001,3,5,3,11,Loyal
27462,85,4,35.72,4,5,1,10,Loyal
27463,324,2,23.779999999999998,1,2,1,4,At Risk
27464,133,2,6.28,4,2,1,7,Potential
27465,234,2,11.940000000000001,2,2,1,5,At Risk
27466,234,3,66.97,2,4,2,8,Potential
27467,405,1,2049.0982,1,1,4,6,At Risk
27468,409,1,2071.4196,1,1,4,6,At Risk
27469,36,3,1331.97,5,4,4,13,Champions
27470,45,5,1371.95,5,5,4,14,Champions
27471,34,3,1386.48,5,4,4,13,Champions
27472,60,5,1345.95,5,5,4,14,Champions
27473,32,4,1398.46,5,5,4,14,Champions
27474,198,3,60.47,3,4,2,9,Potential
27475,34,3,33.43,5,4,1,10,Loyal
27476,66,2,25.479999999999997,5,2,1,8,Potential
27477,213,2,23.779999999999998,2,2,1,5,At Risk
27478,295,3,27.77,1,4,1,6,At Risk
27479,307,2,23.779999999999998,1,2,1,4,At Risk
27480,6,4,118.96000000000001,5,5,3,13,Recent Customer
27481,174,3,58.47,3,4,2,9,Potential
27482,329,2,38.980000000000004,1,2,1,4,At Risk
27483,45,4,1382.46,5,5,4,14,Champions
27484,49,2,1322.98,5,2,4,11,Loyal
27485,61,5,1354.71,5,5,4,14,Champions
27486,53,5,1371.95,5,5,4,14,Champions
27487,45,2,1322.98,5,2,4,11,Loyal
27488,45,2,1322.98,5,2,4,11,Loyal
27489,36,5,1383.45,5,5,4,14,Champions
27490,45,3,1331.97,5,4,4,13,Champions
27491,201,2,38.980000000000004,3,2,1,6,At Risk
27492,59,5,1344.91,5,5,4,14,Champions
27493,49,4,1353.46,5,5,4,14,Champions
27494,92,5,1952.45,4,5,4,13,Champions
27495,133,1,35.0,4,1,1,6,At Risk
27496,275,3,42.28,2,4,2,8,Potential
27497,230,2,37.29,2,2,1,5,At Risk
27498,226,5,1350.75,2,5,4,11,Loyal
27499,233,3,1331.97,2,4,4,10,Loyal
27500,211,5,1371.95,2,5,4,11,Loyal
27501,202,4,578.46,3,5,3,11,Loyal
27502,364,1,69.99,1,1,2,4,At Risk
27503,179,1,21.49,3,1,1,5,At Risk
27504,418,1,2071.4196,1,1,4,6,At Risk
27505,154,2,25.479999999999997,3,2,1,6,At Risk
27506,198,3,33.43,3,4,1,8,Potential
27507,22,3,27.77,5,4,1,10,Recent Customer
27508,411,1,2071.4196,1,1,4,6,At Risk
27509,315,3,60.47,1,4,2,7,Potential
27510,94,3,31.729999999999997,4,4,1,9,Potential
27511,188,2,548.98,3,2,3,8,Potential
27512,211,1,539.99,2,1,3,6,At Risk
27513,208,3,563.77,2,4,3,9,Potential
27514,191,1,539.99,3,1,3,7,Potential
27515,212,1,539.99,2,1,3,6,At Risk
27516,27,2,123.97999999999999,5,2,3,10,Recent Customer
27517,183,1,539.99,3,1,3,7,Potential
27518,268,2,123.97999999999999,2,2,3,7,Potential
27519,60,2,78.97999999999999,5,2,2,9,Potential
27520,256,2,78.97999999999999,2,2,2,6,At Risk
27521,115,3,4462.1582,4,4,5,13,Champions
27522,180,1,69.99,3,1,2,6,At Risk
27523,406,1,2049.0982,1,1,4,6,At Risk
27524,402,1,2049.0982,1,1,4,6,At Risk
27525,327,3,182.78,1,4,3,8,Potential
27526,313,2,23.779999999999998,1,2,1,4,At Risk
27527,101,4,4514.9696,4,5,5,14,Champions
27528,141,3,88.97,3,4,2,9,Potential
27529,160,3,58.47,3,4,2,9,Potential
27530,311,4,47.96,1,5,2,8,Potential
27531,413,1,2071.4196,1,1,4,6,At Risk
27532,31,2,23.779999999999998,5,2,1,8,Potential
27533,288,2,25.479999999999997,2,2,1,5,At Risk
27534,418,1,2071.4196,1,1,4,6,At Risk
27535,420,1,2049.0982,1,1,4,6,At Risk
27536,430,1,782.99,1,1,3,5,At Risk
27537,119,4,4469.4696,4,5,5,14,Champions
27538,9,3,83.97,5,4,2,11,Recent Customer
27539,66,3,4468.1582,5,4,5,14,Champions
27540,88,5,4504.4596,4,5,5,14,Champions
27541,92,3,4490.479600000001,4,4,5,13,Champions
27542,62,5,4532.9696,5,5,5,15,Champions
27543,77,3,4468.1582,4,4,5,13,Champions
27544,406,1,2071.4196,1,1,4,6,At Risk
27545,430,1,782.99,1,1,3,5,At Risk
27546,404,1,2049.0982,1,1,4,6,At Risk
27547,422,1,2071.4196,1,1,4,6,At Risk
27548,37,3,27.77,5,4,1,10,Loyal
27549,427,1,2071.4196,1,1,4,6,At Risk
27550,428,1,782.99,1,1,3,5,At Risk
27551,419,1,2049.0982,1,1,4,6,At Risk
27552,418,1,2071.4196,1,1,4,6,At Risk
27553,426,1,2049.0982,1,1,4,6,At Risk
27554,409,1,2071.4196,1,1,4,6,At Risk
27555,415,1,2049.0982,1,1,4,6,At Risk
27556,399,1,2049.0982,1,1,4,6,At Risk
27557,453,1,782.99,1,1,3,5,At Risk
27558,419,1,2049.0982,1,1,4,6,At Risk
27559,401,1,2049.0982,1,1,4,6,At Risk
27560,433,1,782.99,1,1,3,5,At Risk
27561,337,4,84.96000000000001,1,5,2,8,Potential
27562,5,2,94.47999999999999,5,2,3,10,Recent Customer
27563,215,4,84.96000000000001,2,5,2,9,Potential
27564,248,3,60.47,2,4,2,8,Potential
27565,336,3,33.43,1,4,1,6,At Risk
27566,224,3,27.77,2,4,1,7,Potential
27567,80,1,21.49,4,1,1,6,At Risk
27568,84,3,4490.479600000001,4,4,5,13,Champions
27569,62,3,4464.479600000001,5,4,5,14,Champions
27570,82,4,4518.4696,4,5,5,14,Champions
27571,71,3,4484.479600000001,5,4,5,14,Champions
27572,70,3,4490.479600000001,5,4,5,14,Champions
27573,79,3,4490.479600000001,4,4,5,13,Champions
27574,83,5,4456.138199999999,4,5,5,14,Champions
27575,425,1,2071.4196,1,1,4,6,At Risk
27576,414,1,2071.4196,1,1,4,6,At Risk
27577,1119,1,3578.27,1,1,5,7,Potential
27578,1111,1,3578.27,1,1,5,7,Potential
27579,103,3,68.97,4,4,2,10,Loyal
27580,115,2,39.980000000000004,4,2,1,7,Potential
27581,172,1,539.99,3,1,3,7,Potential
27582,174,4,561.9200000000001,3,5,3,11,Loyal
27583,174,3,553.97,3,4,3,10,Loyal
27584,161,3,599.47,3,4,3,10,Loyal
27585,168,4,562.96,3,5,3,11,Loyal
27586,74,1,1120.49,4,1,3,8,Potential
27587,66,2,1145.48,5,2,3,10,Loyal
27588,67,3,15.23,5,4,1,10,Loyal
27589,59,3,1183.47,5,4,4,13,Champions
27590,37,4,1189.46,5,5,4,14,Champions
27591,39,1,4.99,5,1,1,7,Potential
27592,172,1,4.99,3,1,1,5,At Risk
27593,136,2,13.98,3,2,1,6,At Risk
27594,323,2,39.980000000000004,1,2,1,4,At Risk
27595,42,3,64.47,5,4,2,11,Loyal
27596,284,3,64.47,2,4,2,8,Potential
27597,123,5,564.21,4,5,3,12,Loyal
27598,150,4,556.26,3,5,3,11,Loyal
27599,140,2,603.49,3,2,3,8,Potential
27600,104,2,23.779999999999998,4,2,1,7,Potential
27601,1123,1,3578.27,1,1,5,7,Potential
27602,408,1,782.99,1,1,3,5,At Risk
27603,207,4,93.46,2,5,3,10,Loyal
27604,1118,1,3578.27,1,1,5,7,Potential
27605,1099,1,3578.27,1,1,5,7,Potential
27606,71,3,5997.33,5,4,5,14,Champions
27607,314,2,7.28,1,2,1,4,At Risk
27608,86,2,33.98,4,2,1,7,Potential
27609,211,3,36.269999999999996,2,4,1,7,Potential
27610,256,3,42.97,2,4,2,8,Potential
27611,1099,1,3578.27,1,1,5,7,Potential
27612,1122,1,3578.27,1,1,5,7,Potential
27613,421,1,782.99,1,1,3,5,At Risk
27614,1109,1,3578.27,1,1,5,7,Potential
27615,82,5,5998.610000000001,4,5,5,14,Champions
27616,81,5,5998.610000000001,4,5,5,14,Champions
27617,63,4,5976.32,5,5,5,15,Champions
27618,179,3,68.97,3,4,2,9,Potential
27619,202,2,33.98,3,2,1,6,At Risk
27620,129,3,88.97,4,4,2,10,Loyal
27621,70,3,5971.33,5,4,5,14,Champions
27622,149,1,28.99,3,1,1,5,At Risk
27623,84,5,5984.27,4,5,5,14,Champions
27624,362,1,28.99,1,1,1,3,At Risk
27625,81,3,5971.33,4,4,5,13,Champions
27626,68,2,33.98,5,2,1,8,Potential
27627,171,3,36.269999999999996,3,4,1,8,Potential
27628,177,1,4.99,3,1,1,5,At Risk
27629,30,3,36.269999999999996,5,4,1,10,Recent Customer
27630,255,3,42.97,2,4,2,8,Potential
27631,318,2,33.98,1,2,1,4,At Risk
27632,122,2,39.980000000000004,4,2,1,7,Potential
27633,201,4,22.26,3,5,1,9,Potential
27634,75,4,567.76,4,5,3,12,Loyal
27635,45,4,93.46,5,5,3,13,Champions
27636,64,5,6011.3099999999995,5,5,5,15,Champions
27637,209,3,68.97,2,4,2,8,Potential
27638,241,3,36.269999999999996,2,4,1,7,Potential
27639,185,1,21.49,3,1,1,5,At Risk
27640,2,3,60.47,5,4,2,11,Recent Customer
27641,92,2,5962.34,4,2,5,11,Loyal
27642,130,2,30.479999999999997,4,2,1,7,Potential
27643,109,2,54.980000000000004,4,2,2,8,Potential
27644,133,2,23.779999999999998,4,2,1,7,Potential
27645,71,5,6051.3099999999995,5,5,5,15,Champions
27646,70,3,5997.33,5,4,5,14,Champions
27647,18,1,21.49,5,1,1,7,Recent Customer
27648,201,2,23.779999999999998,3,2,1,6,At Risk
27649,1109,1,3578.27,1,1,5,7,Potential
27650,130,2,23.779999999999998,4,2,1,7,Potential
27651,71,4,6021.82,5,5,5,15,Champions
27652,177,3,75.47,3,4,2,9,Potential
27653,256,3,128.97,2,4,3,9,Potential
27654,307,1,21.49,1,1,1,3,At Risk
27655,110,1,21.49,4,1,1,6,At Risk
27656,177,1,69.99,3,1,2,6,At Risk
27657,62,4,84.96000000000001,5,5,2,12,Loyal
27658,301,3,27.77,1,4,1,6,At Risk
27659,366,2,75.48,1,2,2,5,At Risk
27660,36,1,21.49,5,1,1,7,Potential
27661,339,2,23.779999999999998,1,2,1,4,At Risk
27662,88,3,5997.33,4,4,5,13,Champions
27663,74,4,6047.32,4,5,5,14,Champions
27664,289,3,60.47,1,4,2,7,Potential
27665,246,1,21.49,2,1,1,4,At Risk
27666,1119,1,3578.27,1,1,5,7,Potential
27667,62,3,5997.33,5,4,5,14,Champions
27668,79,6,6006.5599999999995,4,5,5,14,Champions
27669,84,3,5997.33,4,4,5,13,Champions
27670,87,4,5976.32,4,5,5,14,Champions
27671,77,3,5997.33,4,4,5,13,Champions
27672,888,1,3578.27,1,1,5,7,Potential
27673,1097,1,3578.27,1,1,5,7,Potential
27674,162,2,23.779999999999998,3,2,1,6,At Risk
27675,229,3,27.77,2,4,1,7,Potential
27676,16,3,34.47,5,4,1,10,Recent Customer
27677,191,3,84.47,3,4,2,9,Potential
27678,1077,1,3578.27,1,1,5,7,Potential
27679,184,3,31.729999999999997,3,4,1,8,Potential
27680,297,4,35.72,1,5,1,7,Potential
27681,1079,1,3578.27,1,1,5,7,Potential
27682,65,2,23.779999999999998,5,2,1,8,Potential
27683,150,2,38.980000000000004,3,2,1,6,At Risk
27684,148,3,60.47,3,4,2,9,Potential
27685,47,3,74.98,5,4,2,11,Loyal
27686,1,3,74.98,5,4,2,11,Recent Customer
27687,38,3,1183.47,5,4,4,13,Champions
27688,366,3,166.28,1,4,3,8,Potential
27689,138,1,539.99,3,1,3,7,Potential
27690,133,2,574.98,4,2,3,9,Potential
27691,146,2,603.49,3,2,3,8,Potential
27692,150,2,603.49,3,2,3,8,Potential
27693,141,1,539.99,3,1,3,7,Potential
27694,42,4,1184.46,5,5,4,14,Champions
27695,60,1,1120.49,5,1,3,9,Potential
27696,53,3,1183.47,5,4,4,13,Champions
27697,53,1,1120.49,5,1,3,9,Potential
27698,52,3,1179.97,5,4,4,13,Champions
27699,41,2,1155.48,5,2,3,10,Loyal
27700,263,2,39.980000000000004,2,2,1,5,At Risk
27701,40,2,1155.48,5,2,3,10,Loyal
27702,54,2,1155.48,5,2,3,10,Loyal
27703,221,1,4.99,2,1,1,4,At Risk
27704,326,3,42.28,1,4,2,7,Potential
27705,58,2,39.980000000000004,5,2,1,8,Potential
27706,143,3,553.97,3,4,3,10,Loyal
27707,136,2,561.48,3,2,3,8,Potential
27708,151,3,64.47,3,4,2,9,Potential
27709,149,3,628.97,3,4,3,10,Loyal
27710,111,3,563.77,4,4,3,11,Loyal
27711,121,4,617.47,4,5,3,12,Loyal
27712,34,2,1174.48,5,2,4,11,Loyal
27713,52,4,1158.96,5,5,4,14,Champions
27714,48,2,1155.48,5,2,3,10,Loyal
27715,53,3,1147.77,5,4,3,12,Loyal
27716,214,2,7.28,2,2,1,5,At Risk
27717,56,2,12.940000000000001,5,2,1,8,Potential
27718,232,2,58.980000000000004,2,2,2,6,At Risk
27719,116,3,599.47,4,4,3,11,Loyal
27720,333,2,39.980000000000004,1,2,1,4,At Risk
27721,98,3,166.28,4,4,3,11,Loyal
27722,113,5,564.21,4,5,3,12,Loyal
27723,40,2,1155.48,5,2,3,10,Loyal
27724,125,1,69.99,4,1,2,7,Potential
27725,97,2,119.97999999999999,4,2,3,9,Potential
27726,1090,1,3578.27,1,1,5,7,Potential
27727,313,2,6.28,1,2,1,4,At Risk
27728,67,2,67.49,5,2,2,9,Potential
27729,352,2,12.98,1,2,1,4,At Risk
27730,268,1,3.99,2,1,1,4,At Risk
27731,48,1,69.99,5,1,2,8,Potential
27732,81,2,30.479999999999997,4,2,1,7,Potential
27733,48,3,157.29,5,4,3,12,Loyal
27734,238,2,119.97999999999999,2,2,3,7,Potential
27735,5,4,84.96000000000001,5,5,2,12,Recent Customer
27736,59,3,60.47,5,4,2,11,Loyal
27737,252,2,23.779999999999998,2,2,1,5,At Risk
27738,131,2,78.97999999999999,4,2,2,8,Potential
27739,259,1,69.99,2,1,2,5,At Risk
27740,318,2,25.479999999999997,1,2,1,4,At Risk
27741,8,2,23.779999999999998,5,2,1,8,Recent Customer
27742,87,1,21.49,4,1,1,6,At Risk
27743,51,2,1155.48,5,2,3,10,Loyal
27744,373,5,643.95,1,5,3,9,Potential
27745,388,4,617.47,1,5,3,9,Potential
27746,336,4,628.97,1,5,3,9,Potential
27747,59,4,84.96000000000001,5,5,2,12,Loyal
27748,119,2,23.779999999999998,4,2,1,7,Potential
27749,168,1,21.49,3,1,1,5,At Risk
27750,135,2,23.779999999999998,3,2,1,6,At Risk
27751,245,2,75.48,2,2,2,6,At Risk
27752,894,1,3578.27,1,1,5,7,Potential
27753,314,2,25.479999999999997,1,2,1,4,At Risk
27754,160,2,23.779999999999998,3,2,1,6,At Risk
27755,268,3,60.47,2,4,2,8,Potential
27756,196,1,69.99,3,1,2,6,At Risk
27757,310,3,132.97,1,4,3,8,Potential
27758,310,1,69.99,1,1,2,4,At Risk
27759,1077,1,3578.27,1,1,5,7,Potential
27760,244,4,1169.46,2,5,4,11,Loyal
27761,232,2,1155.48,2,2,3,7,Potential
27762,84,2,574.98,4,2,3,9,Potential
27763,116,4,785.32,4,5,3,12,Loyal
27764,107,3,776.33,4,4,3,11,Loyal
27765,374,1,742.35,1,1,3,5,At Risk
27766,391,3,827.33,1,4,3,8,Potential
27767,397,3,776.33,1,4,3,8,Potential
27768,104,1,742.35,4,1,3,8,Potential
27769,98,3,776.33,4,4,3,11,Loyal
27770,341,2,751.34,1,2,3,6,At Risk
27771,116,2,777.34,4,2,3,9,Potential
27772,328,3,123.48,1,4,3,8,Potential
27773,70,2,777.34,5,2,3,10,Loyal
27774,343,2,771.34,1,2,3,6,At Risk
27775,219,1,1120.49,2,1,3,6,At Risk
27776,77,2,751.34,4,2,3,9,Potential
27777,343,4,778.62,1,5,3,9,Potential
27778,181,1,539.99,3,1,3,7,Potential
27779,75,2,39.980000000000004,4,2,1,7,Potential
27780,76,2,777.34,4,2,3,9,Potential
27781,155,2,574.98,3,2,3,8,Potential
27782,338,3,47.97,1,4,2,7,Potential
27783,302,3,165.28,1,4,3,8,Potential
27784,70,2,751.34,5,2,3,10,Loyal
27785,189,2,38.980000000000004,3,2,1,6,At Risk
27786,146,2,574.98,3,2,3,8,Potential
27787,338,4,69.46000000000001,1,5,2,8,Potential
27788,324,2,6.28,1,2,1,4,At Risk
27789,152,3,553.97,3,4,3,10,Loyal
27790,146,4,562.96,3,5,3,11,Loyal
27791,333,2,777.34,1,2,3,6,At Risk
27792,325,2,751.34,1,2,3,6,At Risk
27793,24,2,54.980000000000004,5,2,2,9,Recent Customer
27794,332,2,25.479999999999997,1,2,1,4,At Risk
27795,210,2,1174.48,2,2,4,8,Potential
27796,179,3,1134.47,3,4,3,10,Loyal
27797,244,1,1120.49,2,1,3,6,At Risk
27798,200,2,1174.48,3,2,4,9,Potential
27799,376,2,1174.48,1,2,4,7,Potential
27800,361,1,1120.49,1,1,3,5,At Risk
27801,335,2,777.34,1,2,3,6,At Risk
27802,134,2,561.48,3,2,3,8,Potential
27803,261,2,39.980000000000004,2,2,1,5,At Risk
27804,126,2,53.980000000000004,4,2,2,8,Potential
27805,79,3,48.970000000000006,4,4,2,10,Loyal
27806,344,1,3.99,1,1,1,3,At Risk
27807,346,1,4.99,1,1,1,3,At Risk
27808,77,5,866.3100000000001,4,5,3,12,Loyal
27809,195,3,1164.47,3,4,4,11,Loyal
27810,46,4,578.46,5,5,3,13,Champions
27811,193,2,1155.48,3,2,3,8,Potential
27812,164,2,39.980000000000004,3,2,1,6,At Risk
27813,164,2,23.779999999999998,3,2,1,6,At Risk
27814,319,3,182.78,1,4,3,8,Potential
27815,348,4,110.46000000000001,1,5,3,9,Potential
27816,250,3,48.970000000000006,2,4,2,8,Potential
27817,43,3,563.77,5,4,3,12,Loyal
27818,33,4,607.96,5,5,3,13,Champions
27819,380,2,2419.06,1,2,4,7,Potential
27820,396,2,2419.06,1,2,4,7,Potential
27821,351,3,2428.05,1,4,4,9,Potential
27822,189,3,34.47,3,4,1,8,Potential
27823,208,3,1164.47,2,4,4,10,Loyal
27824,89,3,786.33,4,4,3,11,Loyal
27825,279,2,901.35,2,2,3,7,Potential
27826,283,2,23.779999999999998,2,2,1,5,At Risk
27827,83,2,25.479999999999997,4,2,1,7,Potential
27828,312,3,27.77,1,4,1,6,At Risk
27829,57,2,39.980000000000004,5,2,1,8,Potential
27830,82,3,60.47,4,4,2,10,Loyal
27831,6,3,27.77,5,4,1,10,Recent Customer
27832,171,1,21.49,3,1,1,5,At Risk
27833,72,1,21.49,5,1,1,7,Potential
27834,204,2,13.98,3,2,1,6,At Risk
27835,340,4,43.46,1,5,2,8,Potential
27836,318,1,4.99,1,1,1,3,At Risk
27837,348,3,60.47,1,4,2,7,Potential
27838,66,2,30.479999999999997,5,2,1,8,Potential
27839,322,2,2419.06,1,2,4,7,Potential
27840,244,3,48.970000000000006,2,4,2,8,Potential
27841,316,3,60.47,1,4,2,7,Potential
27842,215,2,23.779999999999998,2,2,1,5,At Risk
27843,204,3,27.77,3,4,1,8,Potential
27844,225,3,89.97,2,4,2,8,Potential
27845,88,2,751.34,4,2,3,9,Potential
27846,57,4,791.32,5,5,3,13,Champions
27847,225,2,23.779999999999998,2,2,1,5,At Risk
27848,93,3,27.77,4,4,1,9,Potential
27849,83,2,39.980000000000004,4,2,1,7,Potential
27850,308,4,72.96000000000001,1,5,2,8,Potential
27851,296,2,39.980000000000004,1,2,1,4,At Risk
27852,140,2,574.98,3,2,3,8,Potential
27853,129,3,18.97,4,4,1,9,Potential
27854,58,2,750.3000000000001,5,2,3,10,Loyal
27855,88,2,23.779999999999998,4,2,1,7,Potential
27856,125,4,578.46,4,5,3,12,Loyal
27857,321,2,39.980000000000004,1,2,1,4,At Risk
27858,193,3,75.47,3,4,2,9,Potential
27859,292,2,777.34,1,2,3,6,At Risk
27860,39,3,615.47,5,4,3,12,Loyal
27861,40,1,539.99,5,1,3,9,Potential
27862,39,2,548.98,5,2,3,10,Loyal
27863,42,3,565.47,5,4,3,12,Loyal
27864,241,3,2447.05,2,4,4,10,Loyal
27865,236,2,2419.06,2,2,4,8,Potential
27866,207,3,2398.0499999999997,2,4,4,10,Loyal
27867,175,3,2443.55,3,4,4,11,Loyal
27868,122,2,2419.06,4,2,4,10,Loyal
27869,98,3,2462.55,4,4,4,12,Loyal
27870,78,2,2419.06,4,2,4,10,Loyal
27871,37,1,2384.07,5,1,4,10,Loyal
27872,43,2,2393.06,5,2,4,11,Loyal
27873,397,2,1249.84,1,2,4,7,Potential
27874,324,5,1288.31,1,5,4,10,Loyal
27875,324,2,1268.84,1,2,4,7,Potential
27876,216,1,1214.85,2,1,4,7,Potential
27877,202,3,1228.83,3,4,4,11,Loyal
27878,179,4,1283.82,3,5,4,12,Loyal
27879,171,3,1313.34,3,4,4,11,Loyal
27880,293,2,2393.06,1,2,4,7,Potential
27881,44,2,777.34,5,2,3,10,Loyal
27882,292,4,791.32,1,5,3,9,Potential
27883,282,4,778.62,2,5,3,10,Loyal
27884,289,3,756.33,1,4,3,8,Potential
27885,123,2,603.49,4,2,3,9,Potential
27886,84,2,39.980000000000004,4,2,1,7,Potential
27887,269,3,39.47,2,4,1,7,Potential
27888,43,3,22.93,5,4,1,10,Loyal
27889,96,3,71.58000000000001,4,4,2,10,Loyal
27890,139,2,561.48,3,2,3,8,Potential
27891,138,5,597.95,3,5,3,11,Loyal
27892,119,4,649.46,4,5,3,12,Loyal
27893,121,2,34.89,4,2,1,7,Potential
27894,103,2,548.98,4,2,3,9,Potential
27895,45,4,811.32,5,5,3,13,Champions
27896,94,1,539.99,4,1,3,8,Potential
27897,249,2,750.3000000000001,2,2,3,7,Potential
27898,47,2,751.34,5,2,3,10,Loyal
27899,51,2,777.34,5,2,3,10,Loyal
27900,256,2,777.34,2,2,3,7,Potential
27901,285,4,2433.04,2,5,4,11,Loyal
27902,183,2,1174.48,3,2,4,9,Potential
27903,307,3,38.88,1,4,1,6,At Risk
27904,339,5,156.76,1,5,3,9,Potential
27905,225,1,21.49,2,1,1,4,At Risk
27906,100,1,539.99,4,1,3,8,Potential
27907,97,4,578.46,4,5,3,12,Loyal
27908,246,3,786.33,2,4,3,9,Potential
27909,111,2,548.98,4,2,3,9,Potential
27910,350,2,574.98,1,2,3,6,At Risk
27911,23,2,25.479999999999997,5,2,1,8,Recent Customer
27912,41,3,60.47,5,4,2,11,Loyal
27913,171,1,4.99,3,1,1,5,At Risk
27914,292,2,39.980000000000004,1,2,1,4,At Risk
27915,106,2,39.980000000000004,4,2,1,7,Potential
27916,38,2,39.980000000000004,5,2,1,8,Potential
27917,1076,1,3578.27,1,1,5,7,Potential
27918,64,5,5998.610000000001,5,5,5,15,Champions
27919,90,3,6016.33,4,4,5,13,Champions
27920,83,3,5997.33,4,4,5,13,Champions
27921,163,2,7.28,3,2,1,6,At Risk
27922,102,3,60.47,4,4,2,10,Loyal
27923,98,1,28.99,4,1,1,6,At Risk
27924,306,3,2525.94,1,4,4,9,Potential
27925,77,2,38.980000000000004,4,2,1,7,Potential
27926,318,1,4.99,1,1,1,3,At Risk
27927,36,1,3.99,5,1,1,7,Potential
27928,155,1,1120.49,3,1,3,7,Potential
27929,312,1,3.99,1,1,1,3,At Risk
27930,303,3,36.269999999999996,1,4,1,6,At Risk
27931,68,2,7.28,5,2,1,8,Potential
27932,173,3,123.48,3,4,3,10,Loyal
27933,70,2,12.940000000000001,5,2,1,8,Potential
27934,47,1,4.99,5,1,1,7,Potential
27935,156,4,113.96000000000001,3,5,3,11,Loyal
27936,226,1,24.99,2,1,1,4,At Risk
27937,317,5,2641.23,1,5,4,10,Loyal
27938,201,2,38.980000000000004,3,2,1,6,At Risk
27939,294,3,92.97,1,4,3,8,Potential
27940,263,2,38.980000000000004,2,2,1,5,At Risk
27941,219,3,15.23,2,4,1,7,Potential
27942,364,2,29.479999999999997,1,2,1,4,At Risk
27943,285,1,2443.35,2,1,4,7,Potential
27944,246,6,2578.91,2,5,4,11,Loyal
27945,278,2,12.98,2,2,1,5,At Risk
27946,71,4,1143.46,5,5,3,13,Champions
27947,93,1,4.99,4,1,1,6,At Risk
27948,244,3,2457.3299999999995,2,4,4,10,Loyal
27949,390,3,553.97,1,4,3,8,Potential
27950,84,1,4.99,4,1,1,6,At Risk
27951,46,3,2334.9699999999993,5,4,4,13,Champions
27952,216,3,2479.94,2,4,4,10,Loyal
27953,351,2,548.98,1,2,3,6,At Risk
27954,161,2,39.980000000000004,3,2,1,6,At Risk
27955,223,2,38.980000000000004,2,2,1,5,At Risk
27956,342,3,553.97,1,4,3,8,Potential
27957,304,2,6.28,1,2,1,4,At Risk
27958,44,2,38.980000000000004,5,2,1,8,Potential
27959,181,2,54.980000000000004,3,2,2,7,Potential
27960,284,2,7.28,2,2,1,5,At Risk
27961,312,2,29.479999999999997,1,2,1,4,At Risk
27962,183,2,7.28,3,2,1,6,At Risk
27963,48,2,7.28,5,2,1,8,Potential
27964,270,2,6.28,2,2,1,5,At Risk
27965,326,3,565.47,1,4,3,8,Potential
27966,311,2,39.980000000000004,1,2,1,4,At Risk
27967,286,3,553.97,2,4,3,9,Potential
27968,361,2,39.980000000000004,1,2,1,4,At Risk
27969,65,3,599.47,5,4,3,12,Loyal
27970,300,3,64.47,1,4,2,7,Potential
27971,91,2,58.980000000000004,4,2,2,8,Potential
27972,67,3,67.93,5,4,2,11,Loyal
27973,66,1,539.99,5,1,3,9,Potential
27974,74,3,553.97,4,4,3,11,Loyal
27975,140,3,83.47,3,4,2,9,Potential
27976,135,2,58.980000000000004,3,2,2,7,Potential
27977,81,3,553.97,4,4,3,11,Loyal
27978,359,2,29.479999999999997,1,2,1,4,At Risk
27979,180,1,4.99,3,1,1,5,At Risk
27980,258,2,29.479999999999997,2,2,1,5,At Risk
27981,363,2,39.980000000000004,1,2,1,4,At Risk
27982,88,2,603.49,4,2,3,9,Potential
27983,90,1,539.99,4,1,3,8,Potential
27984,62,2,561.48,5,2,3,10,Loyal
27985,73,1,539.99,5,1,3,9,Potential
27986,51,3,553.97,5,4,3,12,Loyal
27987,56,3,553.97,5,4,3,12,Loyal
27988,102,2,7.28,4,2,1,7,Potential
27989,22,1,3.99,5,1,1,7,Recent Customer
27990,168,2,38.980000000000004,3,2,1,6,At Risk
27991,136,1,2.29,3,1,1,5,At Risk
27992,71,1,2.29,5,1,1,7,Potential
27993,269,1,2.29,2,1,1,4,At Risk
27994,159,2,7.28,3,2,1,6,At Risk
27995,333,1,4.99,1,1,1,3,At Risk
27996,354,3,67.93,1,4,2,7,Potential
27997,89,1,4.99,4,1,1,6,At Risk
27998,141,3,144.46999999999997,3,4,3,10,Loyal
27999,80,4,102.96000000000001,4,5,3,12,Loyal
28000,144,2,94.47999999999999,3,2,3,8,Potential
28001,108,2,39.980000000000004,4,2,1,7,Potential
28002,303,2,39.980000000000004,1,2,1,4,At Risk
28003,343,1,4.99,1,1,1,3,At Risk
28004,289,2,7.28,1,2,1,4,At Risk
28005,308,2,7.28,1,2,1,4,At Risk
28006,234,2,7.28,2,2,1,5,At Risk
28007,167,2,39.980000000000004,3,2,1,6,At Risk
28008,189,2,7.28,3,2,1,6,At Risk
28009,202,2,7.28,3,2,1,6,At Risk
28010,171,3,64.47,3,4,2,9,Potential
28011,280,2,7.28,2,2,1,5,At Risk
28012,159,2,7.28,3,2,1,6,At Risk
28013,900,1,3578.27,1,1,5,7,Potential
28014,1090,1,3578.27,1,1,5,7,Potential
28015,247,2,29.479999999999997,2,2,1,5,At Risk
28016,111,1,2.29,4,1,1,6,At Risk
28017,1083,1,3578.27,1,1,5,7,Potential
28018,1095,1,3578.27,1,1,5,7,Potential
28019,39,2,7.28,5,2,1,8,Potential
28020,266,2,39.980000000000004,2,2,1,5,At Risk
28021,204,2,78.97999999999999,3,2,2,7,Potential
28022,1079,1,3578.27,1,1,5,7,Potential
28023,26,2,39.980000000000004,5,2,1,8,Recent Customer
28024,12,5,194.72,5,5,3,13,Recent Customer
28025,8,1,69.99,5,1,2,8,Recent Customer
28026,63,2,7.28,5,2,1,8,Potential
28027,83,2,119.97999999999999,4,2,3,9,Potential
28028,296,3,64.47,1,4,2,7,Potential
28029,158,2,39.980000000000004,3,2,1,6,At Risk
28030,70,3,5971.33,5,4,5,14,Champions
28031,71,4,6047.32,5,5,5,15,Champions
28032,342,3,75.47,1,4,2,7,Potential
28033,91,2,25.479999999999997,4,2,1,7,Potential
28034,56,1,69.99,5,1,2,8,Potential
28035,275,1,69.99,2,1,2,5,At Risk
28036,910,1,3578.27,1,1,5,7,Potential
28037,46,3,34.47,5,4,1,10,Loyal
28038,69,5,5985.31,5,5,5,15,Champions
28039,1085,1,3578.27,1,1,5,7,Potential
28040,1086,1,3578.27,1,1,5,7,Potential
28041,1067,1,3578.27,1,1,5,7,Potential
28042,1082,1,3578.27,1,1,5,7,Potential
28043,280,2,39.980000000000004,2,2,1,5,At Risk
28044,1078,1,3578.27,1,1,5,7,Potential
28045,144,2,119.97999999999999,3,2,3,8,Potential
28046,47,1,69.99,5,1,2,8,Potential
28047,1079,1,3578.27,1,1,5,7,Potential
28048,90,3,84.47,4,4,2,10,Loyal
28049,350,3,27.77,1,4,1,6,At Risk
28050,111,1,21.49,4,1,1,6,At Risk
28051,885,1,3578.27,1,1,5,7,Potential
28052,86,3,67.93,4,4,2,10,Loyal
28053,289,3,68.97,1,4,2,7,Potential
28054,305,2,25.479999999999997,1,2,1,4,At Risk
28055,227,2,75.48,2,2,2,6,At Risk
28056,63,2,30.479999999999997,5,2,1,8,Potential
28057,310,1,21.49,1,1,1,3,At Risk
28058,57,1,21.49,5,1,1,7,Potential
28059,190,4,82.47,3,5,2,10,Loyal
28060,174,2,39.980000000000004,3,2,1,6,At Risk
28061,89,4,6006.32,4,5,5,14,Champions
28062,63,2,5962.34,5,2,5,12,Loyal
28063,89,5,6026.31,4,5,5,14,Champions
28064,84,2,5962.34,4,2,5,11,Loyal
28065,75,3,5997.33,4,4,5,13,Champions
28066,66,3,5997.33,5,4,5,14,Champions
28067,72,3,5997.33,5,4,5,14,Champions
28068,64,4,6021.82,5,5,5,15,Champions
28069,63,3,553.97,5,4,3,12,Loyal
28070,51,3,5997.33,5,4,5,14,Champions
28071,50,3,5971.33,5,4,5,14,Champions
28072,92,2,548.98,4,2,3,9,Potential
28073,250,2,7.28,2,2,1,5,At Risk
28074,104,2,12.940000000000001,4,2,1,7,Potential
28075,67,4,88.42,5,5,2,12,Loyal
28076,36,3,5997.33,5,4,5,14,Champions
28077,239,1,21.49,2,1,1,4,At Risk
28078,44,5,6011.3099999999995,5,5,5,15,Champions
28079,60,2,39.980000000000004,5,2,1,8,Potential
28080,335,2,39.980000000000004,1,2,1,4,At Risk
28081,46,2,25.479999999999997,5,2,1,8,Potential
28082,333,3,60.47,1,4,2,7,Potential
28083,35,2,5962.34,5,2,5,12,Loyal
28084,145,3,60.47,3,4,2,9,Potential
28085,241,1,4.99,2,1,1,4,At Risk
28086,296,3,166.28,1,4,3,8,Potential
28087,245,2,7.28,2,2,1,5,At Risk
28088,1060,1,3578.27,1,1,5,7,Potential
28089,139,3,15.23,3,4,1,8,Potential
28090,303,2,39.980000000000004,1,2,1,4,At Risk
28091,65,2,1249.84,5,2,4,11,Loyal
28092,902,1,3578.27,1,1,5,7,Potential
28093,131,1,2.29,4,1,1,6,At Risk
28094,342,1,2.29,1,1,1,3,At Risk
28095,216,1,2.29,2,1,1,4,At Risk
28096,1051,1,3578.27,1,1,5,7,Potential
28097,1057,1,3578.27,1,1,5,7,Potential
28098,79,2,1249.84,4,2,4,10,Loyal
28099,34,4,6021.82,5,5,5,15,Champions
28100,170,3,49.97,3,4,2,9,Potential
28101,353,2,78.97999999999999,1,2,2,5,At Risk
28102,33,3,1299.83,5,4,4,13,Champions
28103,48,1,1214.85,5,1,4,10,Loyal
28104,61,2,7.28,5,2,1,8,Potential
28105,141,2,7.28,3,2,1,6,At Risk
28106,289,2,12.940000000000001,1,2,1,4,At Risk
28107,349,4,810.32,1,5,3,9,Potential
28108,328,2,751.34,1,2,3,6,At Risk
28109,323,4,778.62,1,5,3,9,Potential
28110,323,5,845.3100000000001,1,5,3,9,Potential
28111,308,5,865.3100000000001,1,5,3,9,Potential
28112,1059,1,3578.27,1,1,5,7,Potential
28113,286,2,901.35,2,2,3,7,Potential
28114,338,3,570.47,1,4,3,8,Potential
28115,326,4,562.96,1,5,3,9,Potential
28116,281,4,617.47,2,5,3,10,Loyal
28117,296,3,565.47,1,4,3,8,Potential
28118,38,4,588.96,5,5,3,13,Champions
28119,50,2,574.98,5,2,3,10,Loyal
28120,54,1,539.99,5,1,3,9,Potential
28121,84,2,119.97999999999999,4,2,3,9,Potential
28122,249,2,39.980000000000004,2,2,1,5,At Risk
28123,123,1,4.99,4,1,1,6,At Risk
28124,62,4,21.259999999999998,5,5,1,11,Loyal
28125,47,1,4.99,5,1,1,7,Potential
28126,295,2,13.98,1,2,1,4,At Risk
28127,297,1,4.99,1,1,1,3,At Risk
28128,59,2,12.940000000000001,5,2,1,8,Potential
28129,900,1,3578.27,1,1,5,7,Potential
28130,899,1,3578.27,1,1,5,7,Potential
28131,51,5,6011.3099999999995,5,5,5,15,Champions
28132,55,2,548.98,5,2,3,10,Loyal
28133,60,2,574.98,5,2,3,10,Loyal
28134,52,2,574.98,5,2,3,10,Loyal
28135,58,2,548.98,5,2,3,10,Loyal
28136,392,1,2384.07,1,1,4,6,At Risk
28137,108,2,7.28,4,2,1,7,Potential
28138,4,2,7.28,5,2,1,8,Recent Customer
28139,150,3,127.28,3,4,3,10,Loyal
28140,32,2,39.980000000000004,5,2,1,8,Potential
28141,341,2,94.47999999999999,1,2,3,6,At Risk
28142,1040,1,3578.27,1,1,5,7,Potential
28143,317,2,13.98,1,2,1,4,At Risk
28144,196,3,15.23,3,4,1,8,Potential
28145,1064,1,3578.27,1,1,5,7,Potential
28146,206,3,60.47,3,4,2,9,Potential
28147,1036,1,3578.27,1,1,5,7,Potential
28148,1047,1,3578.27,1,1,5,7,Potential
28149,1050,1,3578.27,1,1,5,7,Potential
28150,1051,1,3578.27,1,1,5,7,Potential
28151,215,1,4.99,2,1,1,4,At Risk
28152,40,4,6025.32,5,5,5,15,Champions
28153,87,3,570.47,4,4,3,11,Loyal
28154,53,3,5971.33,5,4,5,14,Champions
28155,56,2,5962.34,5,2,5,12,Loyal
28156,53,3,5997.33,5,4,5,14,Champions
28157,141,2,7.28,3,2,1,6,At Risk
28158,36,3,5997.33,5,4,5,14,Champions
28159,36,5,5978.610000000001,5,5,5,15,Champions
28160,64,2,574.98,5,2,3,10,Loyal
28161,902,1,3578.27,1,1,5,7,Potential
28162,1049,1,3578.27,1,1,5,7,Potential
28163,1043,1,3578.27,1,1,5,7,Potential
28164,1052,1,3578.27,1,1,5,7,Potential
28165,901,1,3578.27,1,1,5,7,Potential
28166,1046,1,3578.27,1,1,5,7,Potential
28167,1041,1,3578.27,1,1,5,7,Potential
28168,1062,1,3578.27,1,1,5,7,Potential
28169,899,1,3578.27,1,1,5,7,Potential
28170,1048,1,3578.27,1,1,5,7,Potential
28171,1039,1,3578.27,1,1,5,7,Potential
28172,1063,1,3578.27,1,1,5,7,Potential
28173,887,1,3578.27,1,1,5,7,Potential
28174,14,2,39.980000000000004,5,2,1,8,Recent Customer
28175,339,2,7.28,1,2,1,4,At Risk
28176,900,1,3578.27,1,1,5,7,Potential
28177,891,1,3578.27,1,1,5,7,Potential
28178,907,1,3578.27,1,1,5,7,Potential
28179,1059,1,3578.27,1,1,5,7,Potential
28180,1047,1,3578.27,1,1,5,7,Potential
28181,1062,1,3578.27,1,1,5,7,Potential
28182,1061,1,3578.27,1,1,5,7,Potential
28183,1059,1,3578.27,1,1,5,7,Potential
28184,1044,1,3578.27,1,1,5,7,Potential
28185,1060,1,3578.27,1,1,5,7,Potential
28186,1061,1,3578.27,1,1,5,7,Potential
28187,200,2,39.980000000000004,3,2,1,6,At Risk
28188,56,2,29.479999999999997,5,2,1,8,Potential
28189,39,4,567.76,5,5,3,13,Champions
28190,56,3,5997.33,5,4,5,14,Champions
28191,58,3,5997.33,5,4,5,14,Champions
28192,100,2,30.479999999999997,4,2,1,7,Potential
28193,39,3,6016.33,5,4,5,14,Champions
28194,40,6,6114.8099999999995,5,5,5,15,Champions
28195,55,2,574.98,5,2,3,10,Loyal
28196,42,5,5985.31,5,5,5,15,Champions
28197,902,1,3578.27,1,1,5,7,Potential
28198,901,1,3578.27,1,1,5,7,Potential
28199,1033,1,3578.27,1,1,5,7,Potential
28200,1029,1,3578.27,1,1,5,7,Potential
28201,375,2,2419.06,1,2,4,7,Potential
28202,395,2,2419.06,1,2,4,7,Potential
28203,389,1,2384.07,1,1,4,6,At Risk
28204,394,2,2419.06,1,2,4,7,Potential
28205,278,2,603.49,2,2,3,7,Potential
28206,370,3,2398.0499999999997,1,4,4,9,Potential
28207,389,4,2461.5499999999997,1,5,4,10,Loyal
28208,340,3,2398.0499999999997,1,4,4,9,Potential
28209,287,2,574.98,2,2,3,7,Potential
28210,289,2,564.48,1,2,3,6,At Risk
28211,293,1,539.99,1,1,3,5,At Risk
28212,285,4,619.46,2,5,3,10,Loyal
28213,171,2,39.980000000000004,3,2,1,6,At Risk
28214,121,2,59.980000000000004,4,2,2,8,Potential
28215,300,4,589.96,1,5,3,9,Potential
28216,333,2,7.28,1,2,1,4,At Risk
28217,338,5,2408.29,1,5,4,10,Loyal
28218,143,3,18.97,3,4,1,8,Potential
28219,66,2,39.980000000000004,5,2,1,8,Potential
28220,74,2,13.98,4,2,1,7,Potential
28221,1020,1,3578.27,1,1,5,7,Potential
28222,1035,1,3578.27,1,1,5,7,Potential
28223,1019,1,3578.27,1,1,5,7,Potential
28224,46,3,6016.33,5,4,5,14,Champions
28225,208,3,60.47,2,4,2,8,Potential
28226,362,3,60.47,1,4,2,7,Potential
28227,155,3,60.47,3,4,2,9,Potential
28228,147,1,21.49,3,1,1,5,At Risk
28229,161,3,27.77,3,4,1,8,Potential
28230,251,2,25.479999999999997,2,2,1,5,At Risk
28231,172,2,23.779999999999998,3,2,1,6,At Risk
28232,209,3,143.78,2,4,3,9,Potential
28233,258,1,21.49,2,1,1,4,At Risk
28234,39,4,5976.32,5,5,5,15,Champions
28235,319,2,30.479999999999997,1,2,1,4,At Risk
28236,187,3,60.47,3,4,2,9,Potential
28237,365,3,33.43,1,4,1,6,At Risk
28238,31,1,21.49,5,1,1,7,Potential
28239,334,2,7.28,1,2,1,4,At Risk
28240,38,5,5998.610000000001,5,5,5,15,Champions
28241,329,4,130.46,1,5,3,9,Potential
28242,169,2,7.28,3,2,1,6,At Risk
28243,38,4,6060.83,5,5,5,15,Champions
28244,47,5,6026.31,5,5,5,15,Champions
28245,27,2,7.28,5,2,1,8,Recent Customer
28246,37,4,5976.32,5,5,5,15,Champions
28247,45,2,5962.34,5,2,5,12,Loyal
28248,342,1,4.99,1,1,1,3,At Risk
28249,107,4,27.96,4,5,1,10,Loyal
28250,57,3,6016.33,5,4,5,14,Champions
28251,229,1,4.99,2,1,1,4,At Risk
28252,102,1,4.99,4,1,1,6,At Risk
28253,211,2,13.98,2,2,1,5,At Risk
28254,222,3,166.28,2,4,3,9,Potential
28255,46,5,6051.3099999999995,5,5,5,15,Champions
28256,247,2,29.479999999999997,2,2,1,5,At Risk
28257,55,4,5976.32,5,5,5,15,Champions
28258,28,2,7.28,5,2,1,8,Recent Customer
28259,38,6,6118.610000000001,5,5,5,15,Champions
28260,215,2,7.28,2,2,1,5,At Risk
28261,93,4,27.92,4,5,1,10,Loyal
28262,8,2,7.28,5,2,1,8,Recent Customer
28263,71,2,39.980000000000004,5,2,1,8,Potential
28264,49,3,5997.33,5,4,5,14,Champions
28265,62,2,39.980000000000004,5,2,1,8,Potential
28266,302,1,4.99,1,1,1,3,At Risk
28267,335,3,64.47,1,4,2,7,Potential
28268,46,3,5997.33,5,4,5,14,Champions
28269,325,2,13.98,1,2,1,4,At Risk
28270,1015,1,3578.27,1,1,5,7,Potential
28271,1028,1,3578.27,1,1,5,7,Potential
28272,78,4,111.95000000000002,4,5,3,12,Loyal
28273,38,2,5962.34,5,2,5,12,Loyal
28274,364,1,4.99,1,1,1,3,At Risk
28275,45,2,39.980000000000004,5,2,1,8,Potential
28276,139,3,64.47,3,4,2,9,Potential
28277,8,1,4.99,5,1,1,7,Recent Customer
28278,268,2,39.980000000000004,2,2,1,5,At Risk
28279,264,2,7.28,2,2,1,5,At Risk
28280,156,1,4.99,3,1,1,5,At Risk
28281,277,2,7.28,2,2,1,5,At Risk
28282,203,1,4.99,3,1,1,5,At Risk
28283,39,2,39.980000000000004,5,2,1,8,Potential
28284,41,3,563.77,5,4,3,12,Loyal
28285,42,3,5997.33,5,4,5,14,Champions
28286,279,1,4.99,2,1,1,4,At Risk
28287,281,3,103.48,2,4,3,9,Potential
28288,33,6,6039.3,5,5,5,15,Champions
28289,44,2,54.980000000000004,5,2,2,9,Potential
28290,262,3,64.47,2,4,2,8,Potential
28291,137,2,39.980000000000004,3,2,1,6,At Risk
28292,275,3,61.96,2,4,2,8,Potential
28293,1009,1,3578.27,1,1,5,7,Potential
28294,1009,1,3578.27,1,1,5,7,Potential
28295,1009,1,3578.27,1,1,5,7,Potential
28296,48,3,5997.33,5,4,5,14,Champions
28297,54,3,5971.33,5,4,5,14,Champions
28298,388,3,4828.11,1,4,5,10,Loyal
28299,1020,1,3578.27,1,1,5,7,Potential
28300,293,1,2.29,1,1,1,3,At Risk
28301,356,2,161.29,1,2,3,6,At Risk
28302,329,2,78.97999999999999,1,2,2,5,At Risk
28303,195,3,74.98,3,4,2,9,Potential
28304,328,3,91.97,1,4,2,7,Potential
28305,113,2,29.479999999999997,4,2,1,7,Potential
28306,183,1,4.99,3,1,1,5,At Risk
28307,269,2,561.48,2,2,3,7,Potential
28308,271,4,588.96,2,5,3,10,Loyal
28309,343,2,2419.06,1,2,4,7,Potential
28310,83,1,4.99,4,1,1,6,At Risk
28311,366,2,2393.06,1,2,4,7,Potential
28312,261,2,574.98,2,2,3,7,Potential
28313,254,6,647.94,2,5,3,10,Loyal
28314,263,3,553.97,2,4,3,9,Potential
28315,234,3,556.9300000000001,2,4,3,9,Potential
28316,242,1,539.99,2,1,3,6,At Risk
28317,238,1,539.99,2,1,3,6,At Risk
28318,217,2,574.98,2,2,3,7,Potential
28319,222,3,556.9300000000001,2,4,3,9,Potential
28320,230,1,539.99,2,1,3,6,At Risk
28321,217,3,599.47,2,4,3,9,Potential
28322,300,2,29.479999999999997,1,2,1,4,At Risk
28323,349,1,2384.07,1,1,4,6,At Risk
28324,220,2,548.98,2,2,3,7,Potential
28325,244,2,574.98,2,2,3,7,Potential
28326,350,4,2442.54,1,5,4,10,Loyal
28327,348,4,2407.04,1,5,4,10,Loyal
28328,58,1,4.99,5,1,1,7,Potential
28329,141,2,6.28,3,2,1,6,At Risk
28330,313,2,10.24,1,2,1,4,At Risk
28331,328,1,53.99,1,1,2,4,At Risk
28332,236,2,94.47999999999999,2,2,3,7,Potential
28333,357,1,53.99,1,1,2,4,At Risk
28334,144,1,53.99,3,1,2,6,At Risk
28335,114,2,62.980000000000004,4,2,2,8,Potential
28336,162,4,138.97,3,5,3,11,Loyal
28337,52,2,59.980000000000004,5,2,2,9,Potential
28338,238,3,47.97,2,4,2,8,Potential
28339,1023,1,3578.27,1,1,5,7,Potential
28340,1018,1,3578.27,1,1,5,7,Potential
28341,155,3,128.97,3,4,3,10,Loyal
28342,207,1,69.99,2,1,2,5,At Risk
28343,228,1,53.99,2,1,2,5,At Risk
28344,299,1,53.99,1,1,2,4,At Risk
28345,233,1,4.99,2,1,1,4,At Risk
28346,11,2,94.47999999999999,5,2,3,10,Recent Customer
28347,262,4,73.96000000000001,2,5,2,9,Potential
28348,129,2,68.49,4,2,2,8,Potential
28349,100,2,39.980000000000004,4,2,1,7,Potential
28350,164,2,13.98,3,2,1,6,At Risk
28351,194,2,574.98,3,2,3,8,Potential
28352,205,4,562.96,3,5,3,11,Loyal
28353,185,2,548.98,3,2,3,8,Potential
28354,887,1,3578.27,1,1,5,7,Potential
28355,1018,1,3578.27,1,1,5,7,Potential
28356,134,2,59.980000000000004,3,2,2,7,Potential
28357,42,2,133.49,5,2,3,10,Loyal
28358,108,1,4.99,4,1,1,6,At Risk
28359,206,2,78.97999999999999,3,2,2,7,Potential
28360,242,2,7.28,2,2,1,5,At Risk
28361,110,2,13.98,4,2,1,7,Potential
28362,1016,1,3578.27,1,1,5,7,Potential
28363,907,1,3578.27,1,1,5,7,Potential
28364,172,2,1170.48,3,2,4,9,Potential
28365,278,4,2433.04,2,5,4,11,Loyal
28366,109,4,578.46,4,5,3,12,Loyal
28367,111,4,600.46,4,5,3,12,Loyal
28368,32,4,791.32,5,5,3,13,Champions
28369,263,2,777.34,2,2,3,7,Potential
28370,114,5,638.95,4,5,3,12,Loyal
28371,110,1,539.99,4,1,3,8,Potential
28372,94,4,607.96,4,5,3,12,Loyal
28373,177,3,38.88,3,4,1,8,Potential
28374,327,3,68.97,1,4,2,7,Potential
28375,87,4,567.76,4,5,3,12,Loyal
28376,187,3,1134.47,3,4,3,10,Loyal
28377,267,4,2433.04,2,5,4,11,Loyal
28378,39,3,38.88,5,4,1,10,Loyal
28379,294,3,61.08,1,4,2,7,Potential
28380,89,2,34.89,4,2,1,7,Potential
28381,137,4,92.96000000000001,3,5,3,11,Loyal
28382,227,3,786.33,2,4,3,9,Potential
28383,235,1,742.35,2,1,3,6,At Risk
28384,175,2,67.59,3,2,2,7,Potential
28385,40,3,71.58000000000001,5,4,2,11,Loyal
28386,87,4,600.46,4,5,3,12,Loyal
28387,72,3,583.97,5,4,3,12,Loyal
28388,225,2,751.34,2,2,3,7,Potential
28389,1127,1,3399.99,1,1,5,7,Potential
28390,1101,1,3374.99,1,1,5,7,Potential
28391,348,1,32.6,1,1,1,3,At Risk
28392,359,2,23.779999999999998,1,2,1,4,At Risk
28393,181,4,4539.459999999999,3,5,5,13,Champions
28394,162,3,4555.469999999999,3,4,5,12,Loyal
28395,141,4,4554.46,3,5,5,13,Champions
28396,163,2,1155.48,3,2,3,8,Potential
28397,266,2,2419.06,2,2,4,8,Potential
28398,204,3,71.58000000000001,3,4,2,9,Potential
28399,92,3,553.97,4,4,3,11,Loyal
28400,235,2,777.34,2,2,3,7,Potential
28401,1045,1,3374.99,1,1,5,7,Potential
28402,351,3,71.58000000000001,1,4,2,7,Potential
28403,247,2,2419.06,2,2,4,8,Potential
28404,110,5,56.95,4,5,2,11,Loyal
28405,175,2,1155.48,3,2,3,8,Potential
28406,5,3,100.09,5,4,3,12,Recent Customer
28407,991,1,3374.99,1,1,5,7,Potential
28408,268,2,23.779999999999998,2,2,1,5,At Risk
28409,358,1,28.99,1,1,1,3,At Risk
28410,343,3,60.47,1,4,2,7,Potential
28411,338,5,134.95,1,5,3,9,Potential
28412,340,3,45.58,1,4,2,7,Potential
28413,132,2,23.779999999999998,4,2,1,7,Potential
28414,984,1,3399.99,1,1,5,7,Potential
28415,257,3,2428.05,2,4,4,10,Loyal
28416,244,5,2442.0299999999997,2,5,4,11,Loyal
28417,239,4,2426.0,2,5,4,11,Loyal
28418,129,4,4539.459999999999,4,5,5,14,Champions
28419,136,4,4564.459999999999,3,5,5,13,Champions
28420,108,4,4534.46,4,5,5,14,Champions
28421,231,3,776.33,2,4,3,9,Potential
28422,43,2,34.89,5,2,1,8,Potential
28423,318,2,33.98,1,2,1,4,At Risk
28424,77,2,564.48,4,2,3,9,Potential
28425,89,4,588.96,4,5,3,12,Loyal
28426,110,3,60.47,4,4,2,10,Loyal
28427,79,1,539.99,4,1,3,8,Potential
28428,70,2,603.49,5,2,3,10,Loyal
28429,248,2,34.89,2,2,1,5,At Risk
28430,177,3,42.97,3,4,2,9,Potential
28431,161,4,197.88,3,5,3,11,Loyal
28432,92,1,28.99,4,1,1,6,At Risk
28433,38,1,32.6,5,1,1,7,Potential
28434,230,2,751.34,2,2,3,7,Potential
28435,9,3,42.97,5,4,2,11,Recent Customer
28436,90,4,617.47,4,5,3,12,Loyal
28437,60,4,567.76,5,5,3,13,Champions
28438,56,2,574.98,5,2,3,10,Loyal
28439,13,3,60.47,5,4,2,11,Recent Customer
28440,159,3,38.88,3,4,1,8,Potential
28441,132,2,36.59,4,2,1,7,Potential
28442,308,1,69.99,1,1,2,4,At Risk
28443,910,1,3374.99,1,1,5,7,Potential
28444,315,2,123.97999999999999,1,2,3,6,At Risk
28445,80,2,33.98,4,2,1,7,Potential
28446,214,3,2398.0499999999997,2,4,4,10,Loyal
28447,245,1,69.99,2,1,2,5,At Risk
28448,118,1,21.49,4,1,1,6,At Risk
28449,908,1,3374.99,1,1,5,7,Potential
28450,351,3,68.97,1,4,2,7,Potential
28451,85,2,30.479999999999997,4,2,1,7,Potential
28452,289,1,69.99,1,1,2,4,At Risk
28453,179,3,36.269999999999996,3,4,1,8,Potential
28454,215,3,88.97,2,4,2,8,Potential
28455,262,3,42.97,2,4,2,8,Potential
28456,359,1,69.99,1,1,2,4,At Risk
28457,29,1,69.99,5,1,2,8,Recent Customer
28458,874,1,3374.99,1,1,5,7,Potential
28459,183,1,21.49,3,1,1,5,At Risk
28460,320,2,119.97999999999999,1,2,3,6,At Risk
28461,72,2,33.98,5,2,1,8,Potential
28462,309,1,69.99,1,1,2,4,At Risk
28463,144,1,21.49,3,1,1,5,At Risk
28464,47,1,69.99,5,1,2,8,Potential
28465,325,3,68.97,1,4,2,7,Potential
28466,21,2,119.97999999999999,5,2,3,10,Recent Customer
28467,114,3,36.269999999999996,4,4,1,9,Potential
28468,262,3,60.47,2,4,2,8,Potential
28469,95,3,60.47,4,4,2,10,Loyal
28470,878,1,3399.99,1,1,5,7,Potential
28471,861,1,3374.99,1,1,5,7,Potential
28472,218,2,750.3000000000001,2,2,3,7,Potential
28473,134,1,21.49,3,1,1,5,At Risk
28474,54,3,565.47,5,4,3,12,Loyal
28475,310,2,123.97999999999999,1,2,3,6,At Risk
28476,86,2,119.97999999999999,4,2,3,9,Potential
28477,56,2,548.98,5,2,3,10,Loyal
28478,872,1,3374.99,1,1,5,7,Potential
28479,283,3,831.33,2,4,3,9,Potential
28480,261,1,742.35,2,1,3,6,At Risk
28481,254,4,778.62,2,5,3,10,Loyal
28482,262,2,777.34,2,2,3,7,Potential
28483,252,4,765.32,2,5,3,10,Loyal
28484,246,4,778.62,2,5,3,10,Loyal
28485,260,2,751.34,2,2,3,7,Potential
28486,235,3,776.33,2,4,3,9,Potential
28487,216,3,805.33,2,4,3,9,Potential
28488,226,1,742.35,2,1,3,6,At Risk
28489,183,3,786.33,3,4,3,10,Loyal
28490,206,4,778.62,3,5,3,11,Loyal
28491,802,1,3374.99,1,1,5,7,Potential
28492,812,1,3374.99,1,1,5,7,Potential
28493,183,6,814.8000000000001,3,5,3,11,Loyal
28494,194,2,751.34,3,2,3,8,Potential
28495,267,2,119.97999999999999,2,2,3,7,Potential
28496,172,1,69.99,3,1,2,6,At Risk
28497,206,3,776.33,3,4,3,10,Loyal
28498,346,2,78.97999999999999,1,2,2,5,At Risk
28499,204,4,778.62,3,5,3,11,Loyal
28500,200,2,777.34,3,2,3,8,Potential
28501,157,3,786.33,3,4,3,10,Loyal
28502,182,2,777.34,3,2,3,8,Potential
28503,49,4,578.46,5,5,3,13,Champions
28504,774,1,3374.99,1,1,5,7,Potential
28505,160,3,827.33,3,4,3,10,Loyal
28506,93,4,3213.5681999999997,4,5,4,13,Champions
28507,162,2,777.34,3,2,3,8,Potential
28508,49,2,574.98,5,2,3,10,Loyal
28509,168,2,777.34,3,2,3,8,Potential
28510,745,1,2071.4196,1,1,4,6,At Risk
28511,39,4,562.96,5,5,3,13,Champions
28512,708,1,2049.0982,1,1,4,6,At Risk
28513,154,4,811.32,3,5,3,11,Loyal
28514,277,2,78.97999999999999,2,2,2,6,At Risk
28515,41,3,565.47,5,4,3,12,Loyal
28516,59,3,563.77,5,4,3,12,Loyal
28517,32,4,578.46,5,5,3,13,Champions
28518,182,2,750.3000000000001,3,2,3,8,Potential
28519,708,1,2049.0982,1,1,4,6,At Risk
28520,77,3,3226.8996,4,4,4,12,Loyal
28521,147,3,1164.47,3,4,4,11,Loyal
28522,126,4,1197.97,4,5,4,13,Champions
28523,227,4,2433.04,2,5,4,11,Loyal
28524,222,3,2398.0499999999997,2,4,4,10,Loyal
28525,37,2,574.98,5,2,3,10,Loyal
28526,39,3,60.47,5,4,2,11,Loyal
28527,39,3,563.77,5,4,3,12,Loyal
28528,128,2,751.34,4,2,3,9,Potential
28529,703,1,2049.0982,1,1,4,6,At Risk
28530,61,4,588.96,5,5,3,13,Champions
28531,149,2,751.34,3,2,3,8,Potential
28532,728,1,2071.4196,1,1,4,6,At Risk
28533,360,1,4.99,1,1,1,3,At Risk
28534,196,2,603.49,3,2,3,8,Potential
28535,358,4,2433.04,1,5,4,10,Loyal
28536,340,2,13.98,1,2,1,4,At Risk
28537,232,2,39.980000000000004,2,2,1,5,At Risk
28538,158,3,36.269999999999996,3,4,1,8,Potential
28539,292,2,119.97999999999999,1,2,3,6,At Risk
28540,712,1,2049.0982,1,1,4,6,At Risk
28541,726,1,2049.0982,1,1,4,6,At Risk
28542,345,2,78.97999999999999,1,2,2,5,At Risk
28543,305,4,108.46,1,5,3,9,Potential
28544,101,2,33.98,4,2,1,7,Potential
28545,220,3,132.97,2,4,3,9,Potential
28546,214,2,119.97999999999999,2,2,3,7,Potential
28547,721,1,2049.0982,1,1,4,6,At Risk
28548,150,2,751.34,3,2,3,8,Potential
28549,204,3,2418.05,3,4,4,11,Loyal
28550,79,2,123.97999999999999,4,2,3,9,Potential
28551,272,1,69.99,2,1,2,5,At Risk
28552,74,1,21.49,4,1,1,6,At Risk
28553,91,3,3216.8995999999997,4,4,4,12,Loyal
28554,122,2,1155.48,4,2,3,9,Potential
28555,122,3,1134.47,4,4,3,11,Loyal
28556,97,2,1155.48,4,2,3,9,Potential
28557,202,2,2419.06,3,2,4,9,Potential
28558,60,3,68.97,5,4,2,11,Loyal
28559,690,1,2049.0982,1,1,4,6,At Risk
28560,697,1,2071.4196,1,1,4,6,At Risk
28561,67,2,23.779999999999998,5,2,1,8,Potential
28562,82,4,3219.1895999999997,4,5,4,13,Champions
28563,113,4,1197.97,4,5,4,13,Champions
28564,62,2,1174.48,5,2,4,11,Loyal
28565,36,3,58.47,5,4,2,11,Loyal
28566,5,3,58.47,5,4,2,11,Recent Customer
28567,90,1,69.99,4,1,2,7,Potential
28568,67,2,1145.48,5,2,3,10,Loyal
28569,78,3,3204.5782,4,4,4,12,Loyal
28570,209,2,67.49,2,2,2,6,At Risk
28571,40,2,29.479999999999997,5,2,1,8,Potential
28572,266,3,31.27,2,4,1,7,Potential
28573,1014,1,3578.27,1,1,5,7,Potential
28574,887,1,3578.27,1,1,5,7,Potential
28575,143,1,69.99,3,1,2,6,At Risk
28576,92,2,39.980000000000004,4,2,1,7,Potential
28577,190,2,7.28,3,2,1,6,At Risk
28578,14,2,39.980000000000004,5,2,1,8,Recent Customer
28579,57,2,7.28,5,2,1,8,Potential
28580,234,2,4793.12,2,2,5,9,Potential
28581,58,2,119.97999999999999,5,2,3,10,Loyal
28582,123,1,34.99,4,1,1,6,At Risk
28583,1016,1,3578.27,1,1,5,7,Potential
28584,1019,1,3578.27,1,1,5,7,Potential
28585,163,1,34.99,3,1,1,5,At Risk
28586,1017,1,3578.27,1,1,5,7,Potential
28587,1024,1,3578.27,1,1,5,7,Potential
28588,1022,1,3578.27,1,1,5,7,Potential
28589,294,1,69.99,1,1,2,4,At Risk
28590,316,2,59.480000000000004,1,2,2,5,At Risk
28591,186,1,34.99,3,1,1,5,At Risk
28592,46,1,34.99,5,1,1,7,Potential
28593,47,1,34.99,5,1,1,7,Potential
28594,169,1,49.99,3,1,2,6,At Risk
28595,295,1,49.99,1,1,2,4,At Risk
28596,46,1,7.95,5,1,1,7,Potential
28597,286,1,7.95,2,1,1,4,At Risk
28598,1033,1,3578.27,1,1,5,7,Potential
28599,276,1,7.95,2,1,1,4,At Risk
28600,305,2,119.97999999999999,1,2,3,6,At Risk
28601,301,1,7.95,1,1,1,3,At Risk
28602,104,3,144.46999999999997,4,4,3,11,Loyal
28603,148,1,7.95,3,1,1,5,At Risk
28604,358,1,7.95,1,1,1,3,At Risk
28605,160,1,7.95,3,1,1,5,At Risk
28606,324,1,7.95,1,1,1,3,At Risk
28607,365,1,7.95,1,1,1,3,At Risk
28608,78,2,78.97999999999999,4,2,2,8,Potential
28609,105,3,63.97,4,4,2,10,Loyal
28610,110,1,8.99,4,1,1,6,At Risk
28611,319,1,8.99,1,1,1,3,At Risk
28612,230,1,8.99,2,1,1,4,At Risk
28613,65,1,8.99,5,1,1,7,Potential
28614,259,1,8.99,2,1,1,4,At Risk
28615,271,1,8.99,2,1,1,4,At Risk
28616,57,1,120.0,5,1,3,9,Potential
28617,43,3,178.98,5,4,3,12,Loyal
28618,981,1,3578.27,1,1,5,7,Potential
28619,991,1,3578.27,1,1,5,7,Potential
28620,902,1,3578.27,1,1,5,7,Potential
28621,989,1,3578.27,1,1,5,7,Potential
28622,167,4,88.46000000000001,3,5,2,10,Loyal
28623,313,2,27.279999999999998,1,2,1,4,At Risk
28624,896,1,3578.27,1,1,5,7,Potential
28625,978,1,3578.27,1,1,5,7,Potential
28626,887,1,3578.27,1,1,5,7,Potential
28627,1001,1,3578.27,1,1,5,7,Potential
28628,997,1,3578.27,1,1,5,7,Potential
28629,994,1,3578.27,1,1,5,7,Potential
28630,911,1,3578.27,1,1,5,7,Potential
28631,353,3,144.46999999999997,1,4,3,8,Potential
28632,270,2,74.98,2,2,2,6,At Risk
28633,277,3,187.98,2,4,3,9,Potential
28634,6,5,126.95,5,5,3,13,Recent Customer
28635,988,1,3578.27,1,1,5,7,Potential
28636,34,3,78.97,5,4,2,11,Loyal
28637,127,3,31.27,4,4,1,9,Potential
28638,297,3,37.97,1,4,1,6,At Risk
28639,217,4,190.27,2,5,3,10,Loyal
28640,190,1,69.99,3,1,2,6,At Risk
28641,143,3,83.97,3,4,2,9,Potential
28642,230,2,27.279999999999998,2,2,1,5,At Risk
28643,986,1,3578.27,1,1,5,7,Potential
28644,993,1,3578.27,1,1,5,7,Potential
28645,1000,1,3578.27,1,1,5,7,Potential
28646,893,1,3578.27,1,1,5,7,Potential
28647,893,1,3578.27,1,1,5,7,Potential
28648,912,1,3578.27,1,1,5,7,Potential
28649,981,1,3578.27,1,1,5,7,Potential
28650,997,1,3578.27,1,1,5,7,Potential
28651,993,1,3578.27,1,1,5,7,Potential
28652,873,1,3578.27,1,1,5,7,Potential
28653,1003,1,3578.27,1,1,5,7,Potential
28654,997,1,3578.27,1,1,5,7,Potential
28655,997,1,3578.27,1,1,5,7,Potential
28656,884,1,3578.27,1,1,5,7,Potential
28657,979,1,3578.27,1,1,5,7,Potential
28658,995,1,3578.27,1,1,5,7,Potential
28659,736,1,2443.35,1,1,4,6,At Risk
28660,1004,1,3578.27,1,1,5,7,Potential
28661,976,1,3578.27,1,1,5,7,Potential
28662,204,4,4827.1,3,5,5,13,Champions
28663,757,1,2443.35,1,1,4,6,At Risk
28664,111,2,4793.12,4,2,5,11,Loyal
28665,66,4,4852.599999999999,5,5,5,15,Champions
28666,43,3,4822.11,5,4,5,14,Champions
28667,384,3,4370.61,1,4,5,10,Loyal
28668,312,2,78.97999999999999,1,2,2,5,At Risk
28669,737,1,2181.5625,1,1,4,6,At Risk
28670,984,1,3578.27,1,1,5,7,Potential
28671,376,2,4320.62,1,2,5,8,Potential
28672,384,3,4355.61,1,4,5,10,Loyal
28673,354,4,4380.099999999999,1,5,5,11,Loyal
28674,342,5,4430.09,1,5,5,11,Loyal
28675,997,1,3578.27,1,1,5,7,Potential
28676,984,1,3578.27,1,1,5,7,Potential
28677,17,3,48.970000000000006,5,4,2,11,Recent Customer
28678,352,4,4337.56,1,5,5,11,Loyal
28679,47,2,27.279999999999998,5,2,1,8,Potential
28680,97,3,31.27,4,4,1,9,Potential
28681,87,1,24.99,4,1,1,6,At Risk
28682,318,3,63.97,1,4,2,7,Potential
28683,687,1,2049.0982,1,1,4,6,At Risk
28684,149,2,777.34,3,2,3,8,Potential
28685,698,1,2049.0982,1,1,4,6,At Risk
28686,133,5,800.3100000000001,4,5,3,12,Loyal
28687,204,1,28.99,3,1,1,5,At Risk
28688,120,2,901.35,4,2,3,9,Potential
28689,650,1,2049.0982,1,1,4,6,At Risk
28690,641,1,2049.0982,1,1,4,6,At Risk
28691,118,2,777.34,4,2,3,9,Potential
28692,50,1,539.99,5,1,3,9,Potential
28693,46,2,574.98,5,2,3,10,Loyal
28694,379,2,2393.06,1,2,4,7,Potential
28695,199,2,2419.06,3,2,4,9,Potential
28696,175,3,2428.05,3,4,4,11,Loyal
28697,154,4,2452.04,3,5,4,12,Loyal
28698,115,4,765.32,4,5,3,12,Loyal
28699,121,2,777.34,4,2,3,9,Potential
28700,92,2,1170.48,4,2,4,10,Loyal
28701,91,2,1155.48,4,2,3,9,Potential
28702,72,5,1193.45,5,5,4,14,Champions
28703,142,2,2419.06,3,2,4,9,Potential
28704,153,2,2419.06,3,2,4,9,Potential
28705,119,2,777.34,4,2,3,9,Potential
28706,104,3,773.63,4,4,3,11,Loyal
28707,655,1,2071.4196,1,1,4,6,At Risk
28708,662,1,2071.4196,1,1,4,6,At Risk
28709,332,2,2419.06,1,2,4,7,Potential
28710,180,2,33.98,3,2,1,6,At Risk
28711,665,1,2071.4196,1,1,4,6,At Risk
28712,292,2,2393.06,1,2,4,7,Potential
28713,47,3,3204.5782,5,4,4,13,Champions
28714,338,4,2433.04,1,5,4,10,Loyal
28715,195,4,588.96,3,5,3,11,Loyal
28716,162,2,29.479999999999997,3,2,1,6,At Risk
28717,274,2,29.479999999999997,2,2,1,5,At Risk
28718,156,3,67.97,3,4,2,9,Potential
28719,359,1,2384.07,1,1,4,6,At Risk
28720,361,2,2419.06,1,2,4,7,Potential
28721,91,2,39.980000000000004,4,2,1,7,Potential
28722,189,2,119.97999999999999,3,2,3,8,Potential
28723,300,2,2419.06,1,2,4,7,Potential
28724,646,1,2049.0982,1,1,4,6,At Risk
28725,278,2,78.97999999999999,2,2,2,6,At Risk
28726,66,4,778.62,5,5,3,13,Champions
28727,611,1,2071.4196,1,1,4,6,At Risk
28728,591,1,2049.0982,1,1,4,6,At Risk
28729,297,4,2452.04,1,5,4,10,Loyal
28730,360,2,23.779999999999998,1,2,1,4,At Risk
28731,283,4,2452.04,2,5,4,11,Loyal
28732,129,2,2419.06,4,2,4,10,Loyal
28733,139,4,2407.04,3,5,4,12,Loyal
28734,122,2,2419.06,4,2,4,10,Loyal
28735,266,4,2420.34,2,5,4,11,Loyal
28736,580,1,2071.4196,1,1,4,6,At Risk
28737,350,1,69.99,1,1,2,4,At Risk
28738,156,3,60.47,3,4,2,9,Potential
28739,592,1,2049.0982,1,1,4,6,At Risk
28740,61,2,3191.9096,5,2,4,11,Loyal
28741,45,4,1169.46,5,5,4,14,Champions
28742,121,3,2428.05,4,4,4,12,Loyal
28743,114,2,78.97999999999999,4,2,2,8,Potential
28744,89,3,776.33,4,4,3,11,Loyal
28745,65,3,27.77,5,4,1,10,Loyal
28746,296,2,23.779999999999998,1,2,1,4,At Risk
28747,250,3,2398.0499999999997,2,4,4,10,Loyal
28748,198,2,23.779999999999998,3,2,1,6,At Risk
28749,586,1,2049.0982,1,1,4,6,At Risk
28750,37,4,3213.5681999999997,5,5,4,14,Champions
28751,39,5,3240.8796,5,5,4,14,Champions
28752,47,2,1155.48,5,2,3,10,Loyal
28753,337,2,23.779999999999998,1,2,1,4,At Risk
28754,182,3,68.97,3,4,2,9,Potential
28755,232,4,2407.04,2,5,4,11,Loyal
28756,57,5,3218.5582,5,5,4,14,Champions
28757,371,2,2611.4096,1,2,4,7,Potential
28758,389,4,2603.0681999999997,1,5,4,10,Loyal
28759,33,3,69.97,5,4,2,11,Loyal
28760,53,2,28.979999999999997,5,2,1,8,Potential
28761,1000,1,3578.27,1,1,5,7,Potential
28762,27,2,27.279999999999998,5,2,1,8,Recent Customer
28763,989,1,3578.27,1,1,5,7,Potential
28764,355,2,27.279999999999998,1,2,1,4,At Risk
28765,994,1,3578.27,1,1,5,7,Potential
28766,755,1,2443.35,1,1,4,6,At Risk
28767,248,1,69.99,2,1,2,5,At Risk
28768,89,1,4.99,4,1,1,6,At Risk
28769,351,3,4329.61,1,4,5,10,Loyal
28770,345,3,4355.61,1,4,5,10,Loyal
28771,34,1,69.99,5,1,2,8,Potential
28772,998,1,3578.27,1,1,5,7,Potential
28773,218,2,127.95,2,2,3,7,Potential
28774,998,1,3578.27,1,1,5,7,Potential
28775,990,1,3578.27,1,1,5,7,Potential
28776,198,1,2.29,3,1,1,5,At Risk
28777,66,1,53.99,5,1,2,8,Potential
28778,911,1,3578.27,1,1,5,7,Potential
28779,127,3,23.97,4,4,1,9,Potential
28780,230,1,7.95,2,1,1,4,At Risk
28781,177,1,2.29,3,1,1,5,At Risk
28782,7,1,53.99,5,1,2,8,Recent Customer
28783,276,1,34.99,2,1,1,4,At Risk
28784,39,2,43.980000000000004,5,2,2,9,Potential
28785,222,1,34.99,2,1,1,4,At Risk
28786,247,2,127.95,2,2,3,7,Potential
28787,125,2,13.98,4,2,1,7,Potential
28788,366,1,8.99,1,1,1,3,At Risk
28789,1,1,7.95,5,1,1,7,Recent Customer
28790,1001,1,3578.27,1,1,5,7,Potential
28791,337,3,31.27,1,4,1,6,At Risk
28792,999,1,3578.27,1,1,5,7,Potential
28793,342,1,24.99,1,1,1,3,At Risk
28794,1001,1,3578.27,1,1,5,7,Potential
28795,989,1,3578.27,1,1,5,7,Potential
28796,302,3,63.97,1,4,2,7,Potential
28797,986,1,3578.27,1,1,5,7,Potential
28798,705,1,2443.35,1,1,4,6,At Risk
28799,986,1,3578.27,1,1,5,7,Potential
28800,83,1,24.99,4,1,1,6,At Risk
28801,218,2,27.279999999999998,2,2,1,5,At Risk
28802,728,1,2443.35,1,1,4,6,At Risk
28803,277,2,27.279999999999998,2,2,1,5,At Risk
28804,970,1,3578.27,1,1,5,7,Potential
28805,949,1,3578.27,1,1,5,7,Potential
28806,314,3,63.97,1,4,2,7,Potential
28807,964,1,3578.27,1,1,5,7,Potential
28808,213,1,24.99,2,1,1,4,At Risk
28809,299,1,24.99,1,1,1,3,At Risk
28810,342,2,78.98,1,2,2,5,At Risk
28811,171,3,63.97,3,4,2,9,Potential
28812,168,1,24.99,3,1,1,5,At Risk
28813,322,3,37.97,1,4,1,6,At Risk
28814,64,3,31.27,5,4,1,10,Loyal
28815,72,3,31.27,5,4,1,10,Loyal
28816,161,2,27.279999999999998,3,2,1,6,At Risk
28817,342,1,69.99,1,1,2,4,At Risk
28818,717,1,2181.5625,1,1,4,6,At Risk
28819,726,1,2181.5625,1,1,4,6,At Risk
28820,953,1,3578.27,1,1,5,7,Potential
28821,963,1,3578.27,1,1,5,7,Potential
28822,944,1,3578.27,1,1,5,7,Potential
28823,952,1,3578.27,1,1,5,7,Potential
28824,952,1,3578.27,1,1,5,7,Potential
28825,969,1,3578.27,1,1,5,7,Potential
28826,946,1,3578.27,1,1,5,7,Potential
28827,972,1,3578.27,1,1,5,7,Potential
28828,319,3,4329.61,1,4,5,10,Loyal
28829,974,1,3578.27,1,1,5,7,Potential
28830,958,1,3578.27,1,1,5,7,Potential
28831,954,1,3578.27,1,1,5,7,Potential
28832,725,1,2181.5625,1,1,4,6,At Risk
28833,964,1,3578.27,1,1,5,7,Potential
28834,712,1,2443.35,1,1,4,6,At Risk
28835,955,1,3578.27,1,1,5,7,Potential
28836,714,1,2443.35,1,1,4,6,At Risk
28837,720,1,2181.5625,1,1,4,6,At Risk
28838,963,1,3578.27,1,1,5,7,Potential
28839,944,1,3578.27,1,1,5,7,Potential
28840,333,4,4399.099999999999,1,5,5,11,Loyal
28841,318,4,4334.599999999999,1,5,5,11,Loyal
28842,323,6,4393.58,1,5,5,11,Loyal
28843,955,1,3578.27,1,1,5,7,Potential
28844,312,4,4337.56,1,5,5,11,Loyal
28845,276,2,4320.62,2,2,5,9,Potential
28846,305,2,4320.62,1,2,5,8,Potential
28847,292,3,4355.61,1,4,5,10,Loyal
28848,718,1,2181.5625,1,1,4,6,At Risk
28849,957,1,3578.27,1,1,5,7,Potential
28850,726,1,2443.35,1,1,4,6,At Risk
28851,956,1,3578.27,1,1,5,7,Potential
28852,966,1,3578.27,1,1,5,7,Potential
28853,972,1,3578.27,1,1,5,7,Potential
28854,266,3,4355.61,2,4,5,11,Loyal
28855,198,4,103.46,3,5,3,11,Loyal
28856,962,1,3578.27,1,1,5,7,Potential
28857,969,1,3578.27,1,1,5,7,Potential
28858,236,2,12.940000000000001,2,2,1,5,At Risk
28859,245,3,4355.61,2,4,5,11,Loyal
28860,259,2,28.979999999999997,2,2,1,5,At Risk
28861,106,2,28.979999999999997,4,2,1,7,Potential
28862,338,1,24.99,1,1,1,3,At Risk
28863,24,3,63.97,5,4,2,11,Recent Customer
28864,126,2,28.979999999999997,4,2,1,7,Potential
28865,229,3,31.27,2,4,1,7,Potential
28866,276,4,117.96000000000001,2,5,3,10,Loyal
28867,216,3,63.97,2,4,2,8,Potential
28868,36,2,28.979999999999997,5,2,1,8,Potential
28869,270,3,4355.61,2,4,5,11,Loyal
28870,268,4,4334.599999999999,2,5,5,12,Loyal
28871,274,5,4414.59,2,5,5,12,Loyal
28872,324,2,59.980000000000004,1,2,2,5,At Risk
28873,8,2,39.980000000000004,5,2,1,8,Recent Customer
28874,252,1,4.99,2,1,1,4,At Risk
28875,48,2,39.980000000000004,5,2,1,8,Potential
28876,231,2,2475.95,2,2,4,8,Potential
28877,335,2,12.98,1,2,1,4,At Risk
28878,100,2,6.28,4,2,1,7,Potential
28879,200,4,102.96000000000001,3,5,3,11,Loyal
28880,296,4,637.96,1,5,3,9,Potential
28881,230,2,39.980000000000004,2,2,1,5,At Risk
28882,262,2,7.28,2,2,1,5,At Risk
28883,108,2,38.980000000000004,4,3,1,8,Potential
28884,42,2,11.940000000000001,5,3,1,9,Potential
28885,59,4,4470.8895999999995,5,5,5,15,Champions
28886,57,3,48.970000000000006,5,4,2,11,Loyal
28887,153,2,39.980000000000004,3,3,1,7,Potential
28888,42,2,39.980000000000004,5,3,1,9,Potential
28889,167,2,12.940000000000001,3,3,1,7,Potential
28890,207,3,109.97,2,4,3,9,Potential
28891,161,2,38.980000000000004,3,3,1,7,Potential
28892,168,1,21.49,3,1,1,5,At Risk
28893,269,3,15.23,2,4,1,7,Potential
28894,65,2,59.980000000000004,5,3,2,10,Loyal
28895,10,2,13.98,5,3,1,9,Recent Customer
28896,316,1,21.49,1,1,1,3,At Risk
28897,23,2,39.980000000000004,5,3,1,9,Recent Customer
28898,329,4,69.46000000000001,1,5,2,8,Potential
28899,35,3,60.47,5,4,2,11,Loyal
28900,245,2,29.479999999999997,2,3,1,6,At Risk
28901,192,1,2443.35,3,1,4,8,Potential
28902,185,4,2529.93,3,5,4,12,Loyal
28903,352,2,23.779999999999998,1,3,1,5,At Risk
28904,318,3,2848.5782,1,4,4,9,Potential
28905,279,2,13.98,2,3,1,6,At Risk
28906,107,1,4.99,4,1,1,6,At Risk
28907,129,2,23.779999999999998,4,3,1,8,Potential
28908,362,3,33.43,1,4,1,6,At Risk
28909,159,2,7.28,3,3,1,7,Potential
28910,132,3,48.970000000000006,4,4,2,10,Loyal
28911,178,1,4.99,3,1,1,5,At Risk
28912,119,2,54.980000000000004,4,3,2,9,Potential
28913,99,2,23.779999999999998,4,3,1,8,Potential
28914,264,3,27.77,2,4,1,7,Potential
28915,229,2,39.980000000000004,2,3,1,6,At Risk
28916,276,4,561.9200000000001,2,5,3,10,Loyal
28917,28,3,84.47,5,4,2,11,Recent Customer
28918,341,2,23.779999999999998,1,3,1,5,At Risk
28919,333,1,4.99,1,1,1,3,At Risk
28920,83,2,7.28,4,3,1,8,Potential
28921,313,3,184.48,1,4,3,8,Potential
28922,161,2,29.479999999999997,3,3,1,7,Potential
28923,320,2,2393.06,1,3,4,8,Potential
28924,38,1,4.99,5,1,1,7,Potential
28925,74,2,7.28,4,3,1,8,Potential
28926,77,2,7.28,4,3,1,8,Potential
28927,330,2,2419.06,1,3,4,8,Potential
28928,306,3,2473.05,1,4,4,9,Potential
28929,110,2,7.28,4,3,1,8,Potential
28930,50,3,15.23,5,4,1,10,Loyal
28931,226,3,166.28,2,4,3,9,Potential
28932,48,3,93.97,5,4,3,12,Loyal
28933,99,2,29.479999999999997,4,3,1,8,Potential
28934,165,3,64.47,3,4,2,9,Potential
28935,317,2,2419.06,1,3,4,8,Potential
28936,322,2,7.28,1,3,1,5,At Risk
28937,221,2,7.28,2,3,1,6,At Risk
28938,87,1,9.99,4,1,1,6,At Risk
28939,332,2,14.98,1,3,1,5,At Risk
28940,310,2,2393.06,1,3,4,8,Potential
28941,99,3,69.97,4,4,2,10,Loyal
28942,288,1,9.99,2,1,1,4,At Risk
28943,212,3,49.970000000000006,2,4,2,8,Potential
28944,161,3,23.97,3,4,1,8,Potential
28945,284,3,68.97,2,4,2,8,Potential
28946,29,3,23.97,5,4,1,10,Recent Customer
28947,235,2,14.98,2,3,1,6,At Risk
28948,334,2,2419.06,1,3,4,8,Potential
28949,320,3,2473.05,1,4,4,9,Potential
28950,288,2,44.980000000000004,2,3,2,7,Potential
28951,198,1,9.99,3,1,1,5,At Risk
28952,309,4,2473.04,1,5,4,10,Loyal
28953,312,3,2462.55,1,4,4,9,Potential
28954,285,2,2393.06,2,3,4,9,Potential
28955,32,2,14.98,5,3,1,9,Potential
28956,196,2,14.98,3,3,1,7,Potential
28957,275,2,2419.06,2,3,4,9,Potential
28958,57,2,14.98,5,3,1,9,Potential
28959,281,2,14.98,2,3,1,6,At Risk
28960,23,3,49.970000000000006,5,4,2,11,Recent Customer
28961,292,4,2478.04,1,5,4,10,Loyal
28962,284,5,2477.5299999999997,2,5,4,11,Loyal
28963,283,3,2398.0499999999997,2,4,4,10,Loyal
28964,280,1,69.99,2,1,2,5,At Risk
28965,85,3,63.97,4,4,2,10,Loyal
28966,960,1,3578.27,1,1,5,7,Potential
28967,343,1,8.99,1,1,1,3,At Risk
28968,164,1,2.29,3,1,1,5,At Risk
28969,262,2,62.980000000000004,2,3,2,7,Potential
28970,85,3,63.97,4,4,2,10,Loyal
28971,357,2,27.279999999999998,1,3,1,5,At Risk
28972,157,3,63.97,3,4,2,9,Potential
28973,93,1,24.99,4,1,1,6,At Risk
28974,116,1,24.99,4,1,1,6,At Risk
28975,84,3,37.97,4,4,1,9,Potential
28976,260,2,94.47999999999999,2,3,3,8,Potential
28977,244,2,74.98,2,3,2,7,Potential
28978,203,3,63.97,3,4,2,9,Potential
28979,311,3,37.97,1,4,1,6,At Risk
28980,253,3,36.93,2,4,1,7,Potential
28981,317,2,27.279999999999998,1,3,1,5,At Risk
28982,270,2,27.279999999999998,2,3,1,6,At Risk
28983,171,3,63.97,3,4,2,9,Potential
28984,190,2,28.979999999999997,3,3,1,7,Potential
28985,312,3,53.47,1,4,2,7,Potential
28986,181,2,78.97999999999999,3,3,2,8,Potential
28987,8,3,31.27,5,4,1,10,Recent Customer
28988,973,1,3578.27,1,1,5,7,Potential
28989,953,1,3578.27,1,1,5,7,Potential
28990,955,1,3578.27,1,1,5,7,Potential
28991,306,3,63.97,1,4,2,7,Potential
28992,194,2,78.97999999999999,3,3,2,8,Potential
28993,956,1,3578.27,1,1,5,7,Potential
28994,186,1,24.99,3,1,1,5,At Risk
28995,242,3,31.27,2,4,1,7,Potential
28996,166,2,78.97999999999999,3,3,2,8,Potential
28997,971,1,3578.27,1,1,5,7,Potential
28998,343,2,28.979999999999997,1,3,1,5,At Risk
28999,188,1,4.99,3,1,1,5,At Risk
29000,343,2,7.28,1,3,1,5,At Risk
29001,56,3,624.97,5,4,3,12,Loyal
29002,316,3,67.93,1,4,2,7,Potential
29003,143,1,4.99,3,1,1,5,At Risk
29004,247,2,4320.62,2,3,5,10,Loyal
29005,330,1,69.99,1,1,2,4,At Risk
29006,179,4,151.27,3,5,3,11,Loyal
29007,57,1,24.99,5,1,1,7,Potential
29008,951,1,3578.27,1,1,5,7,Potential
29009,199,2,28.979999999999997,3,3,1,7,Potential
29010,952,1,3578.27,1,1,5,7,Potential
29011,221,4,4334.599999999999,2,5,5,12,Loyal
29012,98,2,78.97999999999999,4,3,2,9,Potential
29013,708,1,2181.5625,1,1,4,6,At Risk
29014,359,3,63.97,1,4,2,7,Potential
29015,250,1,24.99,2,1,1,4,At Risk
29016,953,1,3578.27,1,1,5,7,Potential
29017,959,1,3578.27,1,1,5,7,Potential
29018,71,3,63.97,5,4,2,11,Loyal
29019,241,3,4355.61,2,4,5,11,Loyal
29020,216,2,13.98,2,3,1,6,At Risk
29021,180,1,69.99,3,1,2,6,At Risk
29022,121,3,63.97,4,4,2,10,Loyal
29023,109,3,35.23,4,4,1,9,Potential
29024,7,3,31.27,5,4,1,10,Recent Customer
29025,340,2,27.279999999999998,1,3,1,5,At Risk
29026,164,1,24.99,3,1,1,5,At Risk
29027,45,2,574.98,5,3,3,11,Loyal
29028,110,2,7.28,4,3,1,8,Potential
29029,68,2,29.479999999999997,5,3,1,9,Potential
29030,40,2,39.980000000000004,5,3,1,9,Potential
29031,80,3,64.47,4,4,2,10,Loyal
29032,232,5,4389.59,2,5,5,12,Loyal
29033,229,3,31.27,2,4,1,7,Potential
29034,228,4,190.27,2,5,3,10,Loyal
29035,44,2,28.979999999999997,5,3,1,9,Potential
29036,29,2,74.98,5,3,2,10,Recent Customer
29037,267,1,69.99,2,1,2,5,At Risk
29038,41,2,6.28,5,3,1,9,Potential
29039,92,1,4.99,4,1,1,6,At Risk
29040,357,2,39.980000000000004,1,3,1,5,At Risk
29041,35,5,628.45,5,5,3,13,Champions
29042,383,4,2420.34,1,5,4,10,Loyal
29043,378,3,2447.05,1,4,4,9,Potential
29044,239,2,4320.62,2,3,5,10,Loyal
29045,280,3,89.97,2,4,2,8,Potential
29046,196,3,31.27,3,4,1,8,Potential
29047,185,3,51.46,3,4,2,9,Potential
29048,222,3,4355.61,2,4,5,11,Loyal
29049,299,4,113.46000000000001,1,5,3,9,Potential
29050,50,3,63.47,5,4,2,11,Loyal
29051,148,1,3.99,3,1,1,5,At Risk
29052,303,2,38.980000000000004,1,3,1,5,At Risk
29053,259,2,38.980000000000004,2,3,1,6,At Risk
29054,227,2,751.34,2,3,3,8,Potential
29055,243,4,765.32,2,5,3,10,Loyal
29056,964,1,3578.27,1,1,5,7,Potential
29057,225,1,8.99,2,1,1,4,At Risk
29058,968,1,3578.27,1,1,5,7,Potential
29059,948,1,3578.27,1,1,5,7,Potential
29060,954,1,3578.27,1,1,5,7,Potential
29061,50,1,3.99,5,1,1,7,Potential
29062,226,1,742.35,2,1,3,6,At Risk
29063,236,3,801.83,2,4,3,9,Potential
29064,222,5,815.8100000000001,2,5,3,10,Loyal
29065,230,2,777.34,2,3,3,8,Potential
29066,196,1,539.99,3,1,3,7,Potential
29067,175,1,539.99,3,1,3,7,Potential
29068,240,2,751.34,2,3,3,8,Potential
29069,219,3,756.33,2,4,3,9,Potential
29070,945,1,3578.27,1,1,5,7,Potential
29071,258,1,69.99,2,1,2,5,At Risk
29072,36,3,128.97,5,4,3,12,Loyal
29073,274,2,38.980000000000004,2,3,1,6,At Risk
29074,235,2,67.49,2,3,2,7,Potential
29075,302,2,67.49,1,3,2,6,At Risk
29076,44,1,3.99,5,1,1,7,Potential
29077,83,3,63.97,4,4,2,10,Loyal
29078,164,3,63.97,3,4,2,9,Potential
29079,366,3,102.48,1,4,3,8,Potential
29080,188,2,777.34,3,3,3,9,Potential
29081,189,1,742.35,3,1,3,7,Potential
29082,213,1,742.35,2,1,3,6,At Risk
29083,125,1,3.99,4,1,1,6,At Risk
29084,212,1,742.35,2,1,3,6,At Risk
29085,196,2,777.34,3,3,3,9,Potential
29086,203,3,805.33,3,4,3,10,Loyal
29087,168,4,810.32,3,5,3,11,Loyal
29088,176,3,756.33,3,4,3,10,Loyal
29089,297,2,6.28,1,3,1,5,At Risk
29090,155,4,778.62,3,5,3,11,Loyal
29091,178,3,756.33,3,4,3,10,Loyal
29092,244,2,6.28,2,3,1,6,At Risk
29093,163,2,28.479999999999997,3,3,1,7,Potential
29094,171,2,796.34,3,3,3,9,Potential
29095,174,2,777.34,3,3,3,9,Potential
29096,175,2,574.98,3,3,3,9,Potential
29097,162,2,548.98,3,3,3,9,Potential
29098,180,3,628.97,3,4,3,10,Loyal
29099,129,2,548.98,4,3,3,10,Loyal
29100,61,4,102.96000000000001,5,5,3,13,Champions
29101,90,2,7.28,4,3,1,8,Potential
29102,303,1,2384.07,1,1,4,6,At Risk
29103,303,2,2419.06,1,3,4,8,Potential
29104,84,2,78.97999999999999,4,3,2,9,Potential
29105,290,2,6.28,1,3,1,5,At Risk
29106,948,1,3578.27,1,1,5,7,Potential
29107,285,2,162.99,2,3,3,8,Potential
29108,963,1,3578.27,1,1,5,7,Potential
29109,273,2,6.28,2,3,1,6,At Risk
29110,957,1,3578.27,1,1,5,7,Potential
29111,236,5,4389.59,2,5,5,12,Loyal
29112,263,2,6.28,2,3,1,6,At Risk
29113,280,4,2453.04,2,5,4,11,Loyal
29114,291,1,2384.07,1,1,4,6,At Risk
29115,291,4,2407.04,1,5,4,10,Loyal
29116,296,3,17.27,1,4,1,6,At Risk
29117,240,1,9.99,2,1,1,4,At Risk
29118,177,4,73.96000000000001,3,5,2,10,Loyal
29119,90,3,69.97,4,4,2,10,Loyal
29120,235,3,49.970000000000006,2,4,2,8,Potential
29121,141,3,69.97,3,4,2,9,Potential
29122,183,3,49.970000000000006,3,4,2,9,Potential
29123,95,3,23.97,4,4,1,9,Potential
29124,260,1,69.99,2,1,2,5,At Risk
29125,79,3,14.23,4,4,1,9,Potential
29126,973,1,3578.27,1,1,5,7,Potential
29127,311,2,28.979999999999997,1,3,1,5,At Risk
29128,242,3,4349.61,2,4,5,11,Loyal
29129,271,1,24.99,2,1,1,4,At Risk
29130,357,2,7.28,1,3,1,5,At Risk
29131,50,1,3.99,5,1,1,7,Potential
29132,951,1,3578.27,1,1,5,7,Potential
29133,35,3,88.97,5,4,2,11,Loyal
29134,115,2,6.28,4,3,1,8,Potential
29135,707,1,2181.5625,1,1,4,6,At Risk
29136,964,1,3578.27,1,1,5,7,Potential
29137,369,2,2419.06,1,3,4,8,Potential
29138,227,3,4374.61,2,4,5,11,Loyal
29139,968,1,3578.27,1,1,5,7,Potential
29140,938,1,3578.27,1,1,5,7,Potential
29141,936,1,3578.27,1,1,5,7,Potential
29142,938,1,3578.27,1,1,5,7,Potential
29143,942,1,3578.27,1,1,5,7,Potential
29144,920,1,3578.27,1,1,5,7,Potential
29145,925,1,3578.27,1,1,5,7,Potential
29146,936,1,3578.27,1,1,5,7,Potential
29147,917,1,3578.27,1,1,5,7,Potential
29148,923,1,3578.27,1,1,5,7,Potential
29149,683,1,2443.35,1,1,4,6,At Risk
29150,913,1,3578.27,1,1,5,7,Potential
29151,940,1,3578.27,1,1,5,7,Potential
29152,682,1,2181.5625,1,1,4,6,At Risk
29153,260,1,3.99,2,1,1,4,At Risk
29154,644,1,2181.5625,1,1,4,6,At Risk
29155,916,1,3578.27,1,1,5,7,Potential
29156,922,1,3578.27,1,1,5,7,Potential
29157,927,1,3578.27,1,1,5,7,Potential
29158,934,1,3578.27,1,1,5,7,Potential
29159,646,1,2443.35,1,1,4,6,At Risk
29160,204,2,11.940000000000001,3,3,1,7,Potential
29161,92,2,38.980000000000004,4,3,1,8,Potential
29162,254,2,53.980000000000004,2,3,2,7,Potential
29163,933,1,3578.27,1,1,5,7,Potential
29164,234,2,67.49,2,3,2,7,Potential
29165,337,4,2407.04,1,5,4,10,Loyal
29166,242,4,4334.599999999999,2,5,5,12,Loyal
29167,184,6,4364.84,3,5,5,13,Champions
29168,190,5,4343.59,3,5,5,13,Champions
29169,935,1,3578.27,1,1,5,7,Potential
29170,941,1,3578.27,1,1,5,7,Potential
29171,138,1,24.99,3,1,1,5,At Risk
29172,36,2,27.279999999999998,5,3,1,9,Potential
29173,277,2,27.279999999999998,2,3,1,6,At Risk
29174,194,4,4334.599999999999,3,5,5,13,Champions
29175,207,4,4334.599999999999,2,5,5,12,Loyal
29176,286,3,15.23,2,4,1,7,Potential
29177,276,2,28.979999999999997,2,3,1,6,At Risk
29178,280,4,2452.04,2,5,4,11,Loyal
29179,305,2,2393.06,1,3,4,8,Potential
29180,276,4,2452.04,2,5,4,11,Loyal
29181,128,3,553.97,4,4,3,11,Loyal
29182,152,1,539.99,3,1,3,7,Potential
29183,291,2,2393.06,1,3,4,8,Potential
29184,282,4,2420.34,2,5,4,11,Loyal
29185,135,3,563.77,3,4,3,10,Loyal
29186,134,2,603.49,3,3,3,9,Potential
29187,98,4,588.96,4,5,3,12,Loyal
29188,209,3,69.97,2,4,2,8,Potential
29189,165,3,23.97,3,4,1,8,Potential
29190,287,3,2447.05,2,4,4,10,Loyal
29191,288,2,2393.06,2,3,4,9,Potential
29192,281,2,2419.06,2,3,4,9,Potential
29193,50,3,49.970000000000006,5,4,2,11,Loyal
29194,289,2,2419.06,1,3,4,8,Potential
29195,298,2,2419.06,1,3,4,8,Potential
29196,295,2,2438.06,1,3,4,8,Potential
29197,78,2,78.97999999999999,4,3,2,9,Potential
29198,927,1,3578.27,1,1,5,7,Potential
29199,145,2,38.980000000000004,3,3,1,7,Potential
29200,189,2,6.28,3,3,1,7,Potential
29201,212,4,4334.599999999999,2,5,5,12,Loyal
29202,193,2,4320.62,3,3,5,11,Loyal
29203,208,4,4334.599999999999,2,5,5,12,Loyal
29204,206,2,4320.62,3,3,5,11,Loyal
29205,62,2,28.979999999999997,5,3,1,9,Potential
29206,286,3,148.98,2,4,3,9,Potential
29207,920,1,3578.27,1,1,5,7,Potential
29208,921,1,3578.27,1,1,5,7,Potential
29209,337,2,39.980000000000004,1,3,1,5,At Risk
29210,158,2,27.279999999999998,3,3,1,7,Potential
29211,55,3,31.27,5,4,1,10,Loyal
29212,110,4,190.27,4,5,3,12,Loyal
29213,136,2,68.49,3,3,2,8,Potential
29214,348,2,59.980000000000004,1,3,2,6,At Risk
29215,20,3,63.97,5,4,2,11,Recent Customer
29216,2,3,92.48,5,4,3,12,Recent Customer
29217,284,3,63.97,2,4,2,8,Potential
29218,152,3,37.97,3,4,1,8,Potential
29219,8,2,27.279999999999998,5,3,1,9,Recent Customer
29220,177,1,24.99,3,1,1,5,At Risk
29221,210,2,4320.62,2,3,5,10,Loyal
29222,165,3,4374.61,3,4,5,12,Loyal
29223,174,3,4355.61,3,4,5,12,Loyal
29224,330,2,27.279999999999998,1,3,1,5,At Risk
29225,167,2,4320.62,3,3,5,11,Loyal
29226,195,2,38.980000000000004,3,3,1,7,Potential
29227,78,3,63.97,4,4,2,10,Loyal
29228,345,1,24.99,1,1,1,3,At Risk
29229,144,2,39.980000000000004,3,3,1,7,Potential
29230,336,1,4.99,1,1,1,3,At Risk
29231,84,2,39.980000000000004,4,3,1,8,Potential
29232,303,4,173.47,1,5,3,9,Potential
29233,98,3,63.97,4,4,2,10,Loyal
29234,204,2,28.979999999999997,3,3,1,7,Potential
29235,166,2,27.279999999999998,3,3,1,7,Potential
29236,156,3,4329.61,3,4,5,12,Loyal
29237,170,3,4355.61,3,4,5,12,Loyal
29238,134,5,4398.099999999999,3,5,5,13,Champions
29239,129,5,4343.59,4,5,5,14,Champions
29240,40,3,68.97,5,4,2,11,Loyal
29241,307,1,24.99,1,1,1,3,At Risk
29242,142,3,4355.61,3,4,5,12,Loyal
29243,96,5,122.95,4,5,3,12,Loyal
29244,23,3,31.27,5,4,1,10,Recent Customer
29245,56,2,27.279999999999998,5,3,1,9,Potential
29246,121,4,88.46000000000001,4,5,2,11,Loyal
29247,348,3,2447.05,1,4,4,9,Potential
29248,348,2,27.279999999999998,1,3,1,5,At Risk
29249,346,1,24.99,1,1,1,3,At Risk
29250,279,3,37.97,2,4,1,7,Potential
29251,301,2,12.98,1,3,1,5,At Risk
29252,124,5,4389.59,4,5,5,14,Champions
29253,227,3,63.47,2,4,2,8,Potential
29254,927,1,3578.27,1,1,5,7,Potential
29255,140,5,4389.59,3,5,5,13,Champions
29256,316,2,2393.06,1,3,4,8,Potential
29257,102,3,165.28,4,4,3,11,Loyal
29258,124,3,4329.61,4,4,5,13,Champions
29259,116,2,13.98,4,3,1,8,Potential
29260,141,4,97.96000000000001,3,5,3,11,Loyal
29261,108,2,4320.62,4,3,5,12,Loyal
29262,5,3,63.47,5,4,2,11,Recent Customer
29263,62,2,38.980000000000004,5,3,1,9,Potential
29264,116,5,4384.59,4,5,5,14,Champions
29265,112,2,4320.62,4,3,5,12,Loyal
29266,299,2,39.980000000000004,1,3,1,5,At Risk
29267,189,1,4.99,3,1,1,5,At Risk
29268,344,2,38.980000000000004,1,3,1,5,At Risk
29269,116,1,3.99,4,1,1,6,At Risk
29270,157,2,11.940000000000001,3,3,1,7,Potential
29271,263,2,38.980000000000004,2,3,1,6,At Risk
29272,156,2,38.980000000000004,3,3,1,7,Potential
29273,156,3,63.47,3,4,2,9,Potential
29274,118,3,4479.62,4,4,5,13,Champions
29275,121,3,4329.61,4,4,5,13,Champions
29276,100,3,4329.61,4,4,5,13,Champions
29277,333,2,2419.06,1,3,4,8,Potential
29278,102,3,4355.61,4,4,5,13,Champions
29279,107,6,4397.58,4,5,5,14,Champions
29280,891,1,3578.27,1,1,5,7,Potential
29281,644,1,2443.35,1,1,4,6,At Risk
29282,30,3,23.97,5,4,1,10,Recent Customer
29283,242,1,53.99,2,1,2,5,At Risk
29284,49,1,49.99,5,1,2,8,Potential
29285,903,1,3578.27,1,1,5,7,Potential
29286,311,2,13.98,1,3,1,5,At Risk
29287,363,1,4.99,1,1,1,3,At Risk
29288,4,2,54.980000000000004,5,3,2,10,Recent Customer
29289,301,4,2433.04,1,5,4,10,Loyal
29290,351,1,4.99,1,1,1,3,At Risk
29291,122,2,564.48,4,3,3,10,Loyal
29292,297,2,2393.06,1,3,4,8,Potential
29293,290,1,2384.07,1,1,4,6,At Risk
29294,93,3,553.97,4,4,3,11,Loyal
29295,275,1,2384.07,2,1,4,7,Potential
29296,85,3,49.970000000000006,4,4,2,10,Loyal
29297,112,5,613.45,4,5,3,12,Loyal
29298,97,2,548.98,4,3,3,10,Loyal
29299,84,2,548.98,4,3,3,10,Loyal
29300,247,2,2419.06,2,3,4,9,Potential
29301,279,3,134.98,2,4,3,9,Potential
29302,268,3,22.93,2,4,1,7,Potential
29303,251,2,2419.06,2,3,4,9,Potential
29304,302,3,23.97,1,4,1,6,At Risk
29305,31,2,14.98,5,3,1,9,Potential
29306,258,1,2384.07,2,1,4,7,Potential
29307,365,2,14.98,1,3,1,5,At Risk
29308,267,2,2438.06,2,3,4,9,Potential
29309,253,2,2419.06,2,3,4,9,Potential
29310,257,2,2419.06,2,3,4,9,Potential
29311,67,4,603.96,5,5,3,13,Champions
29312,259,3,69.97,2,4,2,8,Potential
29313,83,1,539.99,4,1,3,8,Potential
29314,70,2,564.48,5,3,3,11,Loyal
29315,264,4,103.96000000000001,2,5,3,10,Loyal
29316,261,4,2433.04,2,5,4,11,Loyal
29317,249,2,2438.06,2,3,4,9,Potential
29318,265,1,2384.07,2,1,4,7,Potential
29319,272,3,2447.05,2,4,4,10,Loyal
29320,153,3,23.97,3,4,1,8,Potential
29321,249,3,49.970000000000006,2,4,2,8,Potential
29322,41,1,49.99,5,1,2,8,Potential
29323,169,2,78.97999999999999,3,3,2,8,Potential
29324,301,2,38.980000000000004,1,3,1,5,At Risk
29325,164,3,63.47,3,4,2,9,Potential
29326,903,1,3578.27,1,1,5,7,Potential
29327,204,1,53.99,3,1,2,6,At Risk
29328,166,1,49.99,3,1,2,6,At Risk
29329,75,1,53.99,4,1,2,7,Potential
29330,142,2,38.980000000000004,3,3,1,7,Potential
29331,163,3,47.97,3,4,2,9,Potential
29332,319,3,165.28,1,4,3,8,Potential
29333,327,2,54.980000000000004,1,3,2,6,At Risk
29334,899,1,3578.27,1,1,5,7,Potential
29335,898,1,3578.27,1,1,5,7,Potential
29336,647,1,2181.5625,1,1,4,6,At Risk
29337,259,1,49.99,2,1,2,5,At Risk
29338,189,2,39.980000000000004,3,3,1,7,Potential
29339,37,4,73.96000000000001,5,5,2,12,Loyal
29340,887,1,3578.27,1,1,5,7,Potential
29341,144,3,98.97,3,4,3,10,Loyal
29342,171,3,801.83,3,4,3,10,Loyal
29343,41,3,553.97,5,4,3,12,Loyal
29344,34,2,548.98,5,3,3,11,Loyal
29345,33,2,574.98,5,3,3,11,Loyal
29346,61,4,567.76,5,5,3,13,Champions
29347,337,3,47.97,1,4,2,7,Potential
29348,159,2,38.980000000000004,3,3,1,7,Potential
29349,188,2,38.980000000000004,3,3,1,7,Potential
29350,898,1,3578.27,1,1,5,7,Potential
29351,110,2,119.97999999999999,4,3,3,10,Loyal
29352,905,1,3578.27,1,1,5,7,Potential
29353,150,3,63.47,3,4,2,9,Potential
29354,890,1,3578.27,1,1,5,7,Potential
29355,394,4,567.76,1,5,3,9,Potential
29356,390,4,628.97,1,5,3,9,Potential
29357,118,3,2398.0499999999997,4,4,4,12,Loyal
29358,90,1,2384.07,4,1,4,9,Potential
29359,77,4,2453.04,4,5,4,13,Champions
29360,88,3,2418.05,4,4,4,12,Loyal
29361,571,1,2071.4196,1,1,4,6,At Risk
29362,79,2,777.34,4,3,3,10,Loyal
29363,86,2,777.34,4,3,3,10,Loyal
29364,555,1,2049.0982,1,1,4,6,At Risk
29365,89,4,778.62,4,5,3,12,Loyal
29366,70,2,2419.06,5,3,4,12,Loyal
29367,69,2,2419.06,5,3,4,12,Loyal
29368,84,4,2422.54,4,5,4,13,Champions
29369,47,4,2422.54,5,5,4,14,Champions
29370,120,4,97.96,4,5,3,12,Loyal
29371,90,2,777.34,4,3,3,10,Loyal
29372,221,2,39.99,2,3,2,7,Potential
29373,264,3,184.48,2,4,3,9,Potential
29374,58,1,742.35,5,1,3,9,Potential
29375,35,3,756.33,5,4,3,12,Loyal
29376,181,1,21.49,3,1,1,5,At Risk
29377,199,2,33.98,3,3,1,7,Potential
29378,79,2,39.99,4,3,2,9,Potential
29379,279,2,23.779999999999998,2,3,1,6,At Risk
29380,553,1,2071.4196,1,1,4,6,At Risk
29381,37,4,811.32,5,5,3,13,Champions
29382,244,1,2384.07,2,1,4,7,Potential
29383,150,2,23.779999999999998,3,3,1,7,Potential
29384,229,2,23.779999999999998,2,3,1,6,At Risk
29385,1106,1,3399.99,1,1,5,7,Potential
29386,321,3,27.77,1,4,1,6,At Risk
29387,231,1,21.49,2,1,1,4,At Risk
29388,360,5,2639.1796,1,5,4,10,Loyal
29389,322,2,2589.0882,1,3,4,8,Potential
29390,323,2,2589.0882,1,3,4,8,Potential
29391,349,3,3949.97,1,4,5,10,Loyal
29392,52,2,2393.06,5,3,4,12,Loyal
29393,365,2,23.779999999999998,1,3,1,5,At Risk
29394,313,3,36.269999999999996,1,4,1,6,At Risk
29395,55,2,13.98,5,3,1,9,Potential
29396,268,3,36.269999999999996,2,4,1,7,Potential
29397,539,1,2049.0982,1,1,4,6,At Risk
29398,355,3,3964.4699999999993,1,4,5,10,Loyal
29399,325,3,3936.4699999999993,1,4,5,10,Loyal
29400,319,5,3992.4599999999996,1,5,5,11,Loyal
29401,372,2,1223.84,1,3,4,8,Potential
29402,120,1,53.99,4,1,2,7,Potential
29403,301,6,3991.9399999999996,1,5,5,11,Loyal
29404,542,1,2049.0982,1,1,4,6,At Risk
29405,169,1,53.99,3,1,2,6,At Risk
29406,181,3,68.97,3,4,2,9,Potential
29407,216,4,2452.04,2,5,4,11,Loyal
29408,182,1,53.99,3,1,2,6,At Risk
29409,292,3,36.269999999999996,1,4,1,6,At Risk
29410,977,1,3399.99,1,1,5,7,Potential
29411,349,2,1223.84,1,3,4,8,Potential
29412,313,5,2671.8795999999998,1,5,4,10,Loyal
29413,46,1,53.99,5,1,2,8,Potential
29414,527,1,2071.4196,1,1,4,6,At Risk
29415,545,1,2049.0982,1,1,4,6,At Risk
29416,199,3,27.77,3,4,1,8,Potential
29417,203,4,195.27,3,5,3,11,Loyal
29418,38,3,83.97,5,4,2,11,Loyal
29419,114,1,53.99,4,1,2,7,Potential
29420,135,1,53.99,3,1,2,6,At Risk
29421,58,2,78.48,5,3,2,10,Loyal
29422,107,2,62.980000000000004,4,3,2,9,Potential
29423,68,1,21.49,5,1,1,7,Potential
29424,219,2,33.98,2,3,1,6,At Risk
29425,359,2,23.779999999999998,1,3,1,5,At Risk
29426,109,2,25.479999999999997,4,3,1,8,Potential
29427,257,1,21.49,2,1,1,4,At Risk
29428,358,4,47.96,1,5,2,8,Potential
29429,48,3,60.47,5,4,2,11,Loyal
29430,158,1,28.99,3,1,1,5,At Risk
29431,328,2,1249.84,1,3,4,8,Potential
29432,297,5,1307.31,1,5,4,10,Loyal
29433,299,3,1289.33,1,4,4,9,Potential
29434,301,4,77.96000000000001,1,5,2,8,Potential
29435,282,3,68.97,2,4,2,8,Potential
29436,274,1,28.99,2,1,1,4,At Risk
29437,124,2,25.479999999999997,4,3,1,8,Potential
29438,263,2,33.98,2,3,1,6,At Risk
29439,208,2,23.779999999999998,2,3,1,6,At Risk
29440,57,3,36.269999999999996,5,4,1,10,Loyal
29441,35,3,68.97,5,4,2,11,Loyal
29442,285,2,33.98,2,3,1,6,At Risk
29443,217,3,88.98,2,4,2,8,Potential
29444,113,2,25.479999999999997,4,3,1,8,Potential
29445,144,3,182.78,3,4,3,10,Loyal
29446,59,3,36.269999999999996,5,4,1,10,Loyal
29447,34,2,23.779999999999998,5,3,1,9,Potential
29448,1004,1,3399.99,1,1,5,7,Potential
29449,992,1,3399.99,1,1,5,7,Potential
29450,500,1,2049.0982,1,1,4,6,At Risk
29451,355,2,25.479999999999997,1,3,1,5,At Risk
29452,172,1,742.35,3,1,3,7,Potential
29453,148,1,742.35,3,1,3,7,Potential
29454,137,1,742.35,3,1,3,7,Potential
29455,124,2,751.34,4,3,3,10,Loyal
29456,143,4,765.32,3,5,3,11,Loyal
29457,139,3,756.33,3,4,3,10,Loyal
29458,137,4,811.32,3,5,3,11,Loyal
29459,132,3,805.33,4,4,3,11,Loyal
29460,145,2,751.34,3,3,3,9,Potential
29461,102,2,777.34,4,3,3,10,Loyal
29462,121,5,854.82,4,5,3,12,Loyal
29463,112,2,751.34,4,3,3,10,Loyal
29464,106,3,756.33,4,4,3,11,Loyal
29465,101,4,791.32,4,5,3,12,Loyal
29466,959,1,3374.99,1,1,5,7,Potential
29467,970,1,3374.99,1,1,5,7,Potential
29468,239,3,2428.05,2,4,4,10,Loyal
29469,227,2,2393.06,2,3,4,9,Potential
29470,55,3,60.47,5,4,2,11,Loyal
29471,8,2,23.779999999999998,5,3,1,9,Recent Customer
29472,150,3,88.98,3,4,2,9,Potential
29473,240,2,2419.06,2,3,4,9,Potential
29474,955,1,3374.99,1,1,5,7,Potential
29475,945,1,3399.99,1,1,5,7,Potential
29476,923,1,3399.99,1,1,5,7,Potential
29477,225,3,2428.05,2,4,4,10,Loyal
29478,217,3,2398.0499999999997,2,4,4,10,Loyal
29479,512,1,2049.0982,1,1,4,6,At Risk
29480,196,5,2442.0299999999997,3,5,4,12,Loyal
29481,900,1,3374.99,1,1,5,7,Potential
29482,498,1,2049.0982,1,1,4,6,At Risk
29483,507,1,2049.0982,1,1,4,6,At Risk
